"","Time","Amount","Balance"
"1",2016-06-27 19:02:53,3,3
"2",2016-06-27 19:22:39,-3,0
"3",2016-06-27 22:24:36,754.78,754.78
"4",2016-06-27 22:38:35,-754.78,0
"5",2016-06-27 22:38:35,3476.29,3476.29
"6",2016-06-27 22:59:57,1829.53,5305.82
"7",2016-06-27 23:10:51,-5305.82,0
"8",2016-06-27 23:52:39,2471.59,2471.59
"9",2016-06-28 00:07:34,583.31,3054.9
"10",2016-06-28 00:07:34,2652.34,5707.24
"11",2016-06-28 00:07:34,-2471.59,3235.65
"12",2016-06-28 00:43:17,2726.65,5962.3
"13",2016-06-28 00:43:17,-3235.65,2726.65
"14",2016-06-28 01:34:07,-2726.65,-9.09494701772928e-13
"15",2016-06-28 02:17:44,2069.77,2069.77
"16",2016-06-28 02:33:21,-2069.77,-9.09494701772928e-13
"17",2016-06-28 04:06:46,2043.91,2043.91
"18",2016-06-28 04:14:43,3575.57,5619.48
"19",2016-06-28 04:54:20,-5619.48,0
"20",2016-06-28 17:45:27,13699.33,13699.33
"21",2016-06-28 18:17:37,-3476.29,10223.04
"22",2016-06-28 18:44:17,-1829.53,8393.51
"23",2016-06-28 23:52:14,-583.31,7810.2
"24",2016-06-29 06:16:22,-2652.34,5157.86
"25",2016-06-29 07:08:28,-2043.91,3113.95
"26",2016-06-29 07:20:35,-3113.95,9.09494701772928e-13
"27",2016-06-29 08:37:26,10959.33,10959.33
"28",2016-06-29 09:34:49,12294.18,23253.51
"29",2016-06-29 09:41:11,-3575.57,19677.94
"30",2016-06-29 09:52:47,-13699.33,5978.61
"31",2016-06-29 11:33:15,-5978.61,2.72848410531878e-12
"32",2016-06-29 13:40:42,15695.05,15695.05
"33",2016-06-29 14:34:08,-10959.33,4735.72
"34",2016-06-29 15:16:02,-4735.72,2.72848410531878e-12
"35",2016-06-30 02:31:11,2735.94,2735.94
"36",2016-06-30 02:44:29,-2735.94,2.72848410531878e-12
"37",2016-06-30 07:23:15,2338.35,2338.35
"38",2016-06-30 07:39:27,-2338.35,2.72848410531878e-12
"39",2016-06-30 10:00:39,16933.6,16933.6
"40",2016-06-30 10:14:39,-12294.18,4639.42
"41",2016-06-30 10:33:01,-4639.42,1.81898940354586e-12
"42",2016-06-30 14:10:15,20798.15,20798.15
"43",2016-06-30 14:37:23,-15695.05,5103.1
"44",2016-06-30 15:22:14,11240.83,16343.93
"45",2016-06-30 15:22:14,497.07,16841
"46",2016-06-30 15:22:14,-5103.1,11737.9
"47",2016-06-30 15:38:27,5480.97,17218.87
"48",2016-06-30 15:38:27,10497.9,27716.77
"49",2016-06-30 15:38:27,-11737.9,15978.87
"50",2016-06-30 15:50:23,-15978.87,3.63797880709171e-12
"51",2016-06-30 21:06:42,7720.09,7720.09
"52",2016-06-30 21:37:13,-7720.09,3.63797880709171e-12
"53",2016-06-30 21:42:00,4915.73,4915.73
"54",2016-06-30 22:25:35,6208.77,11124.5
"55",2016-06-30 22:25:35,-4915.73,6208.77
"56",2016-06-30 22:38:57,-6208.77,3.63797880709171e-12
"57",2016-06-30 22:54:28,24747.29,24747.29
"58",2016-06-30 23:14:23,6667.43,31414.72
"59",2016-06-30 23:37:02,-16933.6,14481.12
"60",2016-07-01 00:05:52,-14481.12,5.45696821063757e-12
"61",2016-07-01 00:26:51,5539.15,5539.15000000001
"62",2016-07-01 00:50:25,-5539.15,5.45696821063757e-12
"63",2016-07-01 00:53:42,6639.62,6639.62000000001
"64",2016-07-01 01:14:09,3280.12,9919.74000000001
"65",2016-07-01 01:14:09,-6639.62,3280.12000000001
"66",2016-07-01 01:25:47,13032.05,16312.17
"67",2016-07-01 01:48:06,4654.43,20966.6
"68",2016-07-01 01:48:06,-16312.17,4654.43000000001
"69",2016-07-01 01:58:55,3304.89,7959.32000000001
"70",2016-07-01 02:18:42,-7959.32,5.45696821063757e-12
"71",2016-07-01 02:58:14,7972.22,7972.22000000001
"72",2016-07-01 03:19:01,-7972.22,5.45696821063757e-12
"73",2016-07-01 04:26:46,11001.97,11001.97
"74",2016-07-01 04:46:50,-11001.97,5.45696821063757e-12
"75",2016-07-01 06:39:06,4200.26,4200.26000000001
"76",2016-07-01 07:04:37,-4200.26,5.45696821063757e-12
"77",2016-07-01 07:19:07,10461.31,10461.31
"78",2016-07-01 07:59:38,-10461.31,5.45696821063757e-12
"79",2016-07-01 15:20:48,14356.82,14356.82
"80",2016-07-01 15:43:23,-14356.82,5.45696821063757e-12
"81",2016-07-01 20:45:24,9852.11,9852.11000000001
"82",2016-07-01 21:21:54,-9852.11,5.45696821063757e-12
"83",2016-07-02 10:16:43,3285.18,3285.18000000001
"84",2016-07-02 11:02:21,-3285.18,5.45696821063757e-12
"85",2016-07-02 12:37:08,12173.85,12173.85
"86",2016-07-02 13:12:43,-12173.85,5.45696821063757e-12
"87",2016-07-03 08:44:11,5825.43,5825.43000000001
"88",2016-07-03 09:14:39,-5825.43,5.45696821063757e-12
"89",2016-07-03 15:23:05,262.61,262.610000000005
"90",2016-07-03 15:39:17,-262.61,5.45696821063757e-12
"91",2016-07-03 16:56:01,16231.68,16231.68
"92",2016-07-03 17:19:19,-16231.68,5.45696821063757e-12
"93",2016-07-03 22:14:43,17619.75,17619.75
"94",2016-07-03 23:27:16,-11240.83,6378.92000000001
"95",2016-07-04 01:26:38,-497.07,5881.85000000001
"96",2016-07-04 03:26:51,-5480.97,400.880000000007
"97",2016-07-04 05:36:59,20003.34,20404.22
"98",2016-07-04 08:24:31,14864.96,35269.18
"99",2016-07-04 11:08:24,-24747.29,10521.89
"100",2016-07-04 11:44:48,-6667.43,3854.46000000001
"101",2016-07-04 12:05:12,-3280.12,574.340000000007
"102",2016-07-04 12:57:03,31889.86,32464.2
"103",2016-07-04 12:57:03,-574.34,31889.86
"104",2016-07-04 13:21:57,-3304.89,28584.97
"105",2016-07-04 14:05:23,-17619.75,10965.22
"106",2016-07-04 14:48:10,-10965.22,9.09494701772928e-12
"107",2016-07-04 16:18:01,17369.15,17369.15
"108",2016-07-04 16:54:13,-17369.15,7.27595761418343e-12
"109",2016-07-04 17:40:32,34869.62,34869.62
"110",2016-07-04 18:00:10,-20003.34,14866.28
"111",2016-07-04 18:54:54,-14864.96,1.32000000001062
"112",2016-07-04 19:29:10,4221.19,4222.51000000001
"113",2016-07-04 19:29:10,31653.82,35876.33
"114",2016-07-04 19:29:10,-1.32,35875.01
"115",2016-07-04 19:51:16,-31889.86,3985.15000000001
"116",2016-07-04 20:34:24,-3985.15,8.64019966684282e-12
"117",2016-07-05 00:05:46,7934.87,7934.87000000001
"118",2016-07-05 00:41:33,-7934.87,8.18545231595635e-12
"119",2016-07-05 01:54:48,9185.26,9185.26000000001
"120",2016-07-05 02:21:47,-9185.26,9.09494701772928e-12
"121",2016-07-05 10:05:24,11081.37,11081.37
"122",2016-07-05 10:13:27,8815.52,19896.89
"123",2016-07-05 10:31:53,15016.92,34913.81
"124",2016-07-05 10:31:53,-19896.89,15016.92
"125",2016-07-05 11:27:13,-15016.92,1.2732925824821e-11
"126",2016-07-05 13:32:40,19993.96,19993.96
"127",2016-07-05 14:19:44,-19993.96,1.45519152283669e-11
"128",2016-07-05 16:01:06,9642.23,9642.23000000001
"129",2016-07-05 16:20:28,-9642.23,1.45519152283669e-11
"130",2016-07-05 18:30:16,9024.03,9024.03000000002
"131",2016-07-05 18:52:42,-9024.03,1.45519152283669e-11
"132",2016-07-05 20:13:17,8654.74,8654.74000000001
"133",2016-07-05 20:33:20,-8654.74,1.45519152283669e-11
"134",2016-07-06 02:11:01,8155.32,8155.32000000001
"135",2016-07-06 03:42:06,-8155.32,1.45519152283669e-11
"136",2016-07-06 04:24:44,9340.8,9340.80000000001
"137",2016-07-06 05:04:01,-9340.8,1.45519152283669e-11
"138",2016-07-06 20:27:42,8761.65,8761.65000000001
"139",2016-07-06 21:10:05,-8761.65,1.45519152283669e-11
"140",2016-07-07 06:00:56,13997.25,13997.25
"141",2016-07-07 06:00:56,5295.21,19292.46
"142",2016-07-07 06:00:56,8222.8,27515.26
"143",2016-07-07 06:37:31,-20798.15,6717.11000000001
"144",2016-07-07 06:54:27,6091.16,12808.27
"145",2016-07-07 07:02:49,-10497.9,2310.37000000001
"146",2016-07-07 07:37:26,24218.43,26528.8
"147",2016-07-07 07:45:00,-13032.05,13496.75
"148",2016-07-07 08:21:27,-4654.43,8842.32000000001
"149",2016-07-07 08:41:20,6935.73,15778.05
"150",2016-07-07 08:41:20,13380,29158.05
"151",2016-07-07 08:46:59,-29158.05,1.09139364212751e-11
"152",2016-07-07 13:00:05,15446.45,15446.45
"153",2016-07-07 13:19:51,-15446.45,1.09139364212751e-11
"154",2016-07-07 15:35:37,14243.57,14243.57
"155",2016-07-07 15:56:38,-14243.57,1.09139364212751e-11
"156",2016-07-07 17:04:40,37101.21,37101.21
"157",2016-07-07 17:14:49,17870.4,54971.61
"158",2016-07-07 17:14:49,3766.31,58737.92
"159",2016-07-07 17:27:22,7360.24,66098.16
"160",2016-07-07 17:27:22,-34869.62,31228.54
"161",2016-07-07 17:39:05,-4221.19,27007.35
"162",2016-07-07 17:59:47,-27007.35,3.63797880709171e-12
"163",2016-07-07 21:04:21,16341.33,16341.33
"164",2016-07-07 21:44:22,38649.8,54991.13
"165",2016-07-07 21:44:22,21376.28,76367.41
"166",2016-07-07 21:52:06,-31653.82,44713.59
"167",2016-07-07 22:08:07,22525.68,67239.27
"168",2016-07-07 22:08:07,28730.96,95970.23
"169",2016-07-07 22:11:09,-11081.37,84888.86
"170",2016-07-07 22:37:45,5635.16,90524.02
"171",2016-07-07 22:42:11,-8815.52,81708.5
"172",2016-07-07 22:57:27,7162.43,88870.93
"173",2016-07-07 22:57:27,-13997.25,74873.68
"174",2016-07-07 23:21:47,7952.25,82825.93
"175",2016-07-07 23:28:35,-5295.21,77530.72
"176",2016-07-07 23:39:41,6910.51,84441.23
"177",2016-07-08 00:06:30,-8222.8,76218.43
"178",2016-07-08 00:27:49,10656.24,86874.67
"179",2016-07-08 01:01:36,6337.78,93212.45
"180",2016-07-08 05:38:02,-6091.16,87121.29
"181",2016-07-08 05:47:46,-24218.43,62902.86
"182",2016-07-08 06:12:59,-6935.73,55967.13
"183",2016-07-08 06:44:07,-37101.21,18865.92
"184",2016-07-08 06:44:07,-13380,5485.92000000001
"185",2016-07-08 06:54:23,-5485.92,5.45696821063757e-12
"186",2016-07-09 12:15:27,17406.81,17406.81
"187",2016-07-09 12:37:18,-17406.81,3.63797880709171e-12
"188",2016-07-09 15:09:57,17537.44,17537.44
"189",2016-07-09 15:25:54,-17537.44,3.63797880709171e-12
"190",2016-07-09 17:54:34,19245.48,19245.48
"191",2016-07-09 18:12:52,-17870.4,1375.08
"192",2016-07-09 18:15:15,-1375.08,1.81898940354586e-12
"193",2016-07-14 18:48:51,19417.21,19417.21
"194",2016-07-14 18:54:35,-19417.21,0
"195",2016-07-14 21:50:02,26590.3,26590.3
"196",2016-07-14 22:03:20,-26590.3,0
"197",2016-07-15 04:00:58,17716.27,17716.27
"198",2016-07-15 04:11:41,-17716.27,0
"199",2016-07-15 09:38:24,22057.19,22057.19
"200",2016-07-15 09:44:14,-22057.19,0
"201",2016-07-17 17:54:08,24682.71,24682.71
"202",2016-07-17 17:58:29,-24682.71,0
"203",2016-07-17 22:35:29,22653.89,22653.89
"204",2016-07-17 23:01:21,-22653.89,0
"205",2016-07-22 17:30:20,24697.92,24697.92
"206",2016-07-22 17:38:07,-24697.92,0
"207",2016-07-22 20:31:53,66756.98,66756.98
"208",2016-07-22 20:44:53,-66756.98,0
"209",2016-07-23 00:03:19,44458.64,44458.64
"210",2016-07-23 00:05:50,-44458.64,0
"211",2016-07-23 00:52:16,24450.8,24450.8
"212",2016-07-23 01:14:18,-24450.8,0
"213",2016-07-24 07:07:01,16108.54,16108.54
"214",2016-07-24 07:25:39,-16108.54,0
"215",2016-07-24 08:20:24,16319.91,16319.91
"216",2016-07-24 08:20:24,15850.31,32170.22
"217",2016-07-24 08:50:25,-32170.22,0
"218",2016-07-26 10:37:36,22533.49,22533.49
"219",2016-07-26 10:43:14,-22533.49,0
"220",2016-07-26 11:57:03,39479.98,39479.98
"221",2016-07-26 12:07:59,-39479.98,0
"222",2016-07-26 12:26:33,20685.65,20685.65
"223",2016-07-26 12:33:12,-20685.65,0
"224",2016-07-26 13:10:05,20878.67,20878.67
"225",2016-07-26 13:10:05,17382.02,38260.69
"226",2016-07-26 13:35:05,-38260.69,0
"227",2016-07-26 13:35:05,30529.33,30529.33
"228",2016-07-26 14:03:26,-30529.33,0
"229",2016-07-27 10:52:02,18801.65,18801.65
"230",2016-07-27 10:52:02,13857.21,32658.86
"231",2016-07-27 10:52:02,11434.56,44093.42
"232",2016-07-27 11:32:16,-44093.42,0
"233",2016-07-28 13:20:33,33081.78,33081.78
"234",2016-07-28 13:40:05,-33081.78,0
"235",2016-07-28 18:21:15,64009.9,64009.9
"236",2016-07-28 18:32:39,-64009.9,0
"237",2016-07-30 14:01:31,20220.52,20220.52
"238",2016-07-30 14:42:48,-20220.52,0
"239",2016-07-31 10:36:36,19465.26,19465.26
"240",2016-07-31 10:42:43,-19465.26,0
"241",2016-07-31 12:45:36,31664.03,31664.03
"242",2016-07-31 12:49:27,-31664.03,0
"243",2016-07-31 20:34:43,22531.98,22531.98
"244",2016-07-31 20:57:42,-22531.98,0
"245",2016-08-01 01:40:18,22537.78,22537.78
"246",2016-08-01 01:57:38,22485.58,45023.36
"247",2016-08-01 03:33:28,-45023.36,0
"248",2016-08-01 03:59:03,22316.27,22316.27
"249",2016-08-01 05:03:33,-22316.27,0
"250",2016-08-01 07:42:27,22945.42,22945.42
"251",2016-08-01 09:14:58,-22945.42,0
"252",2016-08-01 18:02:14,27175.29,27175.29
"253",2016-08-01 18:23:18,25441.04,52616.33
"254",2016-08-01 18:23:18,-27175.29,25441.04
"255",2016-08-01 18:35:58,-25441.04,0
"256",2016-08-01 19:42:19,99318.56,99318.56
"257",2016-08-01 19:52:48,-99318.56,0
"258",2016-08-01 20:54:41,25975.05,25975.05
"259",2016-08-01 22:07:15,-25975.05,0
"260",2016-08-01 22:51:40,22807.83,22807.83
"261",2016-08-01 23:00:07,-22807.83,0
"262",2016-08-02 01:02:24,23036.83,23036.83
"263",2016-08-02 02:01:52,-23036.83,0
"264",2016-08-02 02:58:35,16408.59,16408.59
"265",2016-08-02 03:25:46,-16408.59,0
"266",2016-08-02 03:51:31,24971.59,24971.59
"267",2016-08-02 04:19:03,29553.63,54525.22
"268",2016-08-02 04:52:01,48937.2,103462.42
"269",2016-08-02 05:27:44,26953.7,130416.12
"270",2016-08-02 05:27:44,19343.75,149759.87
"271",2016-08-02 05:27:44,-103462.42,46297.45
"272",2016-08-02 06:22:20,-46297.45,0
"273",2016-08-02 06:51:46,27852.13,27852.13
"274",2016-08-02 07:12:33,-27852.13,0
"275",2016-08-02 08:17:44,17619.05,17619.05
"276",2016-08-02 09:02:45,-17619.05,0
"277",2016-08-02 09:13:09,22822.28,22822.28
"278",2016-08-02 10:11:45,-22822.28,0
"279",2016-08-02 20:39:51,1043.39,1043.39
"280",2016-08-02 22:08:23,-1043.39,0
"281",2016-08-14 14:12:47,16857.62,16857.62
"282",2016-08-14 14:12:47,12934.51,29792.13
"283",2016-08-14 14:28:58,-29792.13,-3.63797880709171e-12
"284",2016-08-14 15:34:53,7529.85,7529.85
"285",2016-08-14 15:41:37,-7529.85,-3.63797880709171e-12
"286",2016-08-14 23:17:33,10240.23,10240.23
"287",2016-08-15 00:49:30,15471.65,25711.88
"288",2016-08-15 05:24:02,-25711.88,-3.63797880709171e-12
"289",2016-08-17 19:29:37,6386.53,6386.53
"290",2016-08-17 20:18:19,-6386.53,-3.63797880709171e-12
"291",2016-08-17 22:00:14,7789.08,7789.08
"292",2016-08-17 22:10:54,-7789.08,-3.63797880709171e-12
"293",2016-08-18 04:53:45,6786.13,6786.13
"294",2016-08-18 05:09:35,-6786.13,-3.63797880709171e-12
"295",2016-08-18 10:01:45,13121.29,13121.29
"296",2016-08-18 11:48:52,-13121.29,-3.63797880709171e-12
"297",2016-08-19 16:51:59,6843.65,6843.65
"298",2016-08-19 17:45:39,6398.27,13241.92
"299",2016-08-19 17:45:39,6952.3,20194.22
"300",2016-08-19 17:45:39,-6843.65,13350.57
"301",2016-08-19 18:27:33,-13350.57,-1.81898940354586e-12
"302",2016-08-20 12:04:14,8382.73,8382.73
"303",2016-08-20 12:47:42,-8382.73,-1.81898940354586e-12
"304",2016-08-28 14:54:58,7856.6,7856.6
"305",2016-08-28 15:44:32,-7856.6,-1.81898940354586e-12
"306",2016-08-29 00:27:34,6202.05,6202.05
"307",2016-08-29 00:27:34,6079.86,12281.91
"308",2016-08-29 00:46:36,-12281.91,-1.81898940354586e-12
"309",2016-08-29 01:49:17,7212.61,7212.61
"310",2016-08-29 02:07:56,-7212.61,-1.81898940354586e-12
"311",2016-08-29 02:47:36,7955.72,7955.72
"312",2016-08-29 02:47:36,6093.25,14048.97
"313",2016-08-29 02:53:04,-14048.97,-1.81898940354586e-12
"314",2016-08-29 09:26:17,7310.43,7310.43
"315",2016-08-29 11:01:36,-7310.43,-1.81898940354586e-12
"316",2016-09-01 04:00:58,6515.32,6515.32
"317",2016-09-01 04:29:16,-6515.32,-1.81898940354586e-12
"318",2016-09-01 07:41:54,6349.1,6349.1
"319",2016-09-01 07:46:52,-6349.1,-1.81898940354586e-12
"320",2016-09-01 08:30:08,6329.72,6329.72
"321",2016-09-01 08:57:17,-6329.72,-1.81898940354586e-12
"322",2016-09-02 19:25:26,8050.63,8050.63
"323",2016-09-02 19:54:44,-8050.63,-1.81898940354586e-12
"324",2016-09-03 08:57:59,9184.37,9184.37
"325",2016-09-03 08:57:59,7160.12,16344.49
"326",2016-09-03 11:44:53,-16344.49,-1.81898940354586e-12
"327",2016-09-03 16:40:03,13556.1,13556.1
"328",2016-09-03 16:40:03,6234.54,19790.64
"329",2016-09-03 17:44:13,-19790.64,0
"330",2016-09-03 23:44:58,11930.1,11930.1
"331",2016-09-03 23:44:58,11701.39,23631.49
"332",2016-09-03 23:44:58,9626.56,33258.05
"333",2016-09-03 23:44:58,9474.75,42732.8
"334",2016-09-03 23:44:58,9470.09,52202.89
"335",2016-09-03 23:44:58,6270.35,58473.24
"336",2016-09-04 00:47:42,-58473.24,0
"337",2016-09-04 03:42:52,6751.85,6751.85
"338",2016-09-04 04:40:01,-6751.85,0
"339",2016-09-04 05:50:18,11564.81,11564.81
"340",2016-09-04 06:04:13,-11564.81,0
"341",2016-09-04 06:51:02,7380.08,7380.08
"342",2016-09-04 08:09:51,-7380.08,0
"343",2016-09-04 10:42:07,7302.11,7302.11
"344",2016-09-04 11:19:08,-7302.11,0
"345",2016-09-04 18:38:58,9198.44,9198.44
"346",2016-09-04 18:38:58,6173.58,15372.02
"347",2016-09-04 19:13:10,-15372.02,0
"348",2016-09-04 22:26:43,6638.81,6638.81
"349",2016-09-04 22:47:50,-6638.81,0
"350",2016-09-05 00:00:18,9089.54,9089.54
"351",2016-09-05 00:01:40,7649.51,16739.05
"352",2016-09-05 00:17:48,-16739.05,3.63797880709171e-12
"353",2016-09-05 01:27:48,8442.56,8442.56
"354",2016-09-05 01:51:34,-8442.56,3.63797880709171e-12
"355",2016-09-05 05:41:05,7354.6,7354.6
"356",2016-09-05 06:06:05,-7354.6,3.63797880709171e-12
"357",2016-09-05 06:16:28,8059.67,8059.67
"358",2016-09-05 06:47:14,7738.02,15797.69
"359",2016-09-05 07:21:34,-15797.69,3.63797880709171e-12
"360",2016-09-05 09:26:52,6678.73,6678.73
"361",2016-09-05 09:57:38,-6678.73,3.63797880709171e-12
"362",2016-09-05 21:35:19,20003.9,20003.9
"363",2016-09-05 21:47:21,-20003.9,3.63797880709171e-12
"364",2016-09-06 01:27:39,8046.43,8046.43
"365",2016-09-06 01:42:30,30003.92,38050.35
"366",2016-09-06 01:56:42,-38050.35,7.27595761418343e-12
"367",2016-09-06 15:34:20,9211.6,9211.60000000001
"368",2016-09-06 15:39:23,-9211.6,7.27595761418343e-12
"369",2016-09-06 19:11:59,11883.57,11883.57
"370",2016-09-06 19:51:28,-11883.57,7.27595761418343e-12
"371",2016-09-08 09:20:42,22568.21,22568.21
"372",2016-09-08 09:46:52,8702.13,31270.34
"373",2016-09-08 10:50:41,-31270.34,3.63797880709171e-12
"374",2016-09-11 00:51:13,10395.66,10395.66
"375",2016-09-11 01:08:49,10013.39,20409.05
"376",2016-09-11 01:44:33,-20409.05,3.63797880709171e-12
"377",2016-09-12 00:04:45,10261.01,10261.01
"378",2016-09-12 01:17:58,12339.6,22600.61
"379",2016-09-12 01:17:58,-10261.01,12339.6
"380",2016-09-12 02:21:13,-12339.6,3.63797880709171e-12
"381",2016-09-12 13:22:12,8723.61,8723.61
"382",2016-09-12 13:46:31,-8723.61,3.63797880709171e-12
"383",2016-09-13 03:18:38,10510.63,10510.63
"384",2016-09-13 03:18:38,8836.99,19347.62
"385",2016-09-13 03:53:47,-19347.62,3.63797880709171e-12
"386",2016-09-14 11:14:16,18239.32,18239.32
"387",2016-09-14 11:39:34,-18239.32,3.63797880709171e-12
"388",2016-09-15 17:33:29,10290.92,10290.92
"389",2016-09-15 17:48:43,-10290.92,3.63797880709171e-12
"390",2016-09-15 20:09:33,8526.72,8526.72
"391",2016-09-15 20:38:29,-8526.72,3.63797880709171e-12
"392",2016-09-16 20:43:09,10602.68,10602.68
"393",2016-09-16 21:53:15,-10602.68,3.63797880709171e-12
"394",2016-09-18 17:35:22,12045.62,12045.62
"395",2016-09-18 19:31:56,-12045.62,3.63797880709171e-12
"396",2016-09-18 20:57:55,10323.8,10323.8
"397",2016-09-18 21:10:48,-10323.8,3.63797880709171e-12
"398",2016-09-20 10:40:04,9978.42,9978.42
"399",2016-09-20 11:17:20,-9978.42,3.63797880709171e-12
"400",2016-09-20 15:00:35,10846.28,10846.28
"401",2016-09-20 16:39:06,-10846.28,3.63797880709171e-12
"402",2016-09-20 23:22:49,8723.76,8723.76
"403",2016-09-20 23:22:49,13199.45,21923.21
"404",2016-09-20 23:51:18,-21923.21,7.27595761418343e-12
"405",2016-09-21 16:33:34,8751.79,8751.79000000001
"406",2016-09-21 17:03:59,-8751.79,7.27595761418343e-12
"407",2016-09-22 16:01:07,5605.04,5605.04000000001
"408",2016-09-22 16:01:07,17781.84,23386.88
"409",2016-09-22 16:24:59,-23386.88,7.27595761418343e-12
"410",2016-09-23 20:38:54,11080.67,11080.67
"411",2016-09-23 21:17:55,-11080.67,7.27595761418343e-12
"412",2016-09-25 13:11:13,81.91,81.9100000000073
"413",2016-09-29 11:51:09,-81.91,7.27595761418343e-12
"414",2016-09-29 21:09:27,1581.24,1581.24000000001
"415",2016-09-30 01:17:49,-1581.24,7.27595761418343e-12
"416",2016-09-30 18:48:17,901.69,901.690000000007
"417",2016-09-30 20:14:09,-901.69,7.27595761418343e-12
"418",2016-10-03 10:57:40,17634.27,17634.27
"419",2016-10-03 13:39:05,-17634.27,7.27595761418343e-12
"420",2016-10-03 20:53:11,3892.83,3892.83000000001
"421",2016-10-03 21:22:43,-3892.83,7.27595761418343e-12
"422",2016-10-04 08:41:53,8152,8152.00000000001
"423",2016-10-04 09:41:58,-8152,7.27595761418343e-12
"424",2016-10-05 13:57:44,8780.12,8780.12000000001
"425",2016-10-05 14:31:32,-8780.12,7.27595761418343e-12
"426",2016-10-08 07:17:45,10470.22,10470.22
"427",2016-10-08 08:01:35,-10470.22,7.27595761418343e-12
"428",2016-10-11 06:18:07,9841.73,9841.73000000001
"429",2016-10-11 06:18:07,9467.42,19309.15
"430",2016-10-11 06:32:45,-19309.15,7.27595761418343e-12
"431",2016-10-11 17:47:04,25388.87,25388.87
"432",2016-10-11 17:56:51,-25388.87,7.27595761418343e-12
"433",2016-10-11 20:01:00,15653.01,15653.01
"434",2016-10-11 20:01:00,12744.96,28397.97
"435",2016-10-11 20:01:00,11318.75,39716.72
"436",2016-10-11 20:15:26,-39716.72,7.27595761418343e-12
"437",2016-10-11 23:57:30,16428.43,16428.43
"438",2016-10-12 00:24:59,-16428.43,7.27595761418343e-12
"439",2016-10-12 08:57:06,4487.34,4487.34000000001
"440",2016-10-12 15:10:54,14965.23,19452.57
"441",2016-10-12 22:10:37,12251.7,31704.27
"442",2016-10-13 02:53:30,-31704.27,7.27595761418343e-12
"443",2016-10-13 02:53:30,6014.06,6014.06000000001
"444",2016-10-13 03:30:12,13236.15,19250.21
"445",2016-10-14 08:45:30,-19250.21,7.27595761418343e-12
"446",2016-10-14 20:50:19,14090.42,14090.42
"447",2016-10-14 22:02:02,-14090.42,7.27595761418343e-12
"448",2016-10-15 07:55:43,4143.3,4143.30000000001
"449",2016-10-15 09:31:08,-4143.3,7.27595761418343e-12
"450",2016-10-15 11:14:52,4207.96,4207.96000000001
"451",2016-10-15 11:34:47,-4207.96,7.27595761418343e-12
"452",2016-10-17 06:11:15,11370.69,11370.69
"453",2016-10-17 09:58:28,1089.87,12460.56
"454",2016-10-17 11:12:27,1000.36,13460.92
"455",2016-10-17 11:12:27,-12460.56,1000.36000000001
"456",2016-10-17 12:50:13,-1000.36,9.66338120633736e-12
"457",2016-10-18 22:43:38,4052.76,4052.76000000001
"458",2016-10-18 23:35:18,-4052.76,9.54969436861575e-12
"459",2016-10-19 01:29:12,14078,14078
"460",2016-10-19 02:24:23,-14078,9.09494701772928e-12
"461",2016-10-19 13:01:00,11793.77,11793.77
"462",2016-10-19 19:11:52,-11793.77,9.09494701772928e-12
"463",2016-10-21 00:05:39,8109.86,8109.86000000001
"464",2016-10-21 00:26:57,-8109.86,9.09494701772928e-12
"465",2016-10-21 03:38:03,6915.26,6915.26000000001
"466",2016-10-21 03:56:19,-6915.26,9.09494701772928e-12
"467",2016-10-21 15:59:48,7270.12,7270.12000000001
"468",2016-10-21 18:26:12,-7270.12,9.09494701772928e-12
"469",2016-10-22 01:50:32,7427.46,7427.46000000001
"470",2016-10-22 01:51:52,6751.22,14178.68
"471",2016-10-22 02:10:18,-14178.68,9.09494701772928e-12
"472",2016-10-22 07:24:49,7168.95,7168.95000000001
"473",2016-10-22 07:30:33,-7168.95,9.09494701772928e-12
"474",2016-10-22 15:36:09,4139.53,4139.53000000001
"475",2016-10-22 15:36:09,11485.22,15624.75
"476",2016-10-22 15:36:09,10005.97,25630.72
"477",2016-10-22 16:00:17,1021.54,26652.26
"478",2016-10-22 16:27:34,-26652.26,1.09139364212751e-11
"479",2016-10-22 16:27:34,17005.99,17005.99
"480",2016-10-22 16:49:23,-17005.99,1.09139364212751e-11
"481",2016-10-22 20:23:08,17006,17006
"482",2016-10-22 20:23:08,17506.03,34512.03
"483",2016-10-22 20:48:02,-34512.03,1.45519152283669e-11
"484",2016-10-22 21:03:58,18006.02,18006.02
"485",2016-10-22 21:27:13,-18006.02,1.45519152283669e-11
"486",2016-10-23 01:20:01,1783.08,1783.08000000001
"487",2016-10-23 01:20:01,10675.87,12458.95
"488",2016-10-23 01:20:01,8753.11,21212.06
"489",2016-10-23 01:54:56,-21212.06,1.45519152283669e-11
"490",2016-10-23 07:28:43,9039.18,9039.18000000001
"491",2016-10-23 07:46:53,-9039.18,1.45519152283669e-11
"492",2016-10-25 05:20:18,9794.18,9794.18000000001
"493",2016-10-25 05:40:57,-9794.18,1.45519152283669e-11
"494",2016-10-26 00:02:45,16991.62,16991.62
"495",2016-10-26 00:58:38,-16991.62,1.45519152283669e-11
"496",2016-10-26 04:52:46,9469.61,9469.61000000002
"497",2016-10-26 05:13:24,-9469.61,1.45519152283669e-11
"498",2016-10-26 12:32:00,17006.37,17006.37
"499",2016-10-26 12:32:00,7074.09,24080.46
"500",2016-10-26 13:11:01,-24080.46,1.45519152283669e-11
"501",2016-10-26 15:10:41,30006.39,30006.39
"502",2016-10-26 15:10:41,16220.02,46226.41
"503",2016-10-26 15:33:54,-46226.41,1.45519152283669e-11
"504",2016-10-26 17:56:08,5873.39,5873.39000000001
"505",2016-10-26 18:04:55,-5873.39,1.45519152283669e-11
"506",2016-10-27 02:06:27,6960.26,6960.26000000001
"507",2016-10-27 02:49:52,8756.87,15717.13
"508",2016-10-27 03:25:26,-15717.13,1.63709046319127e-11
"509",2016-10-27 13:36:16,30006.55,30006.55
"510",2016-10-27 13:36:16,4699.48,34706.03
"511",2016-10-27 13:51:26,-34706.03,1.45519152283669e-11
"512",2016-10-27 19:00:11,9727.75,9727.75000000001
"513",2016-10-27 19:45:16,-9727.75,1.45519152283669e-11
"514",2016-10-27 22:37:41,5029.6,5029.60000000001
"515",2016-10-27 23:02:05,-5029.6,1.45519152283669e-11
"516",2016-10-28 01:31:41,9216.25,9216.25000000001
"517",2016-10-28 01:34:40,-9216.25,1.45519152283669e-11
"518",2016-10-28 16:37:55,27128.59,27128.59
"519",2016-10-28 16:37:55,13783.64,40912.23
"520",2016-10-28 16:59:53,-40912.23,7.27595761418343e-12
"521",2016-10-28 21:49:34,8470.83,8470.83000000001
"522",2016-10-28 22:37:01,-8470.83,7.27595761418343e-12
"523",2016-10-29 00:04:20,17783.7,17783.7
"524",2016-10-29 00:24:29,-17783.7,7.27595761418343e-12
"525",2016-10-29 03:32:01,4579.98,4579.98000000001
"526",2016-10-29 05:34:50,-4579.98,7.27595761418343e-12
"527",2016-10-29 13:10:56,8133.89,8133.89000000001
"528",2016-10-29 13:42:22,8006.74,16140.63
"529",2016-10-29 13:52:52,-16140.63,9.09494701772928e-12
"530",2016-10-29 16:20:00,18894.76,18894.76
"531",2016-10-29 16:42:14,37783.78,56678.54
"532",2016-10-29 16:42:14,4843.44,61521.98
"533",2016-10-29 16:42:14,-18894.76,42627.22
"534",2016-10-29 17:24:07,-42627.22,1.45519152283669e-11
"535",2016-10-29 17:57:26,13006.81,13006.81
"536",2016-10-29 17:57:26,5600.42,18607.23
"537",2016-10-29 18:14:13,-18607.23,1.45519152283669e-11
"538",2016-10-29 20:33:06,6006.87,6006.87000000001
"539",2016-10-29 20:59:30,14435.32,20442.19
"540",2016-10-29 20:59:30,17341.89,37784.08
"541",2016-10-29 20:59:30,9317.12,47101.2
"542",2016-10-29 21:05:32,-47101.2,2.18278728425503e-11
"543",2016-10-30 02:10:25,17006.93,17006.93
"544",2016-10-30 02:10:25,4518.05,21524.98
"545",2016-10-30 03:12:50,24355.95,45880.93
"546",2016-10-30 03:54:35,-45880.93,2.18278728425503e-11
"547",2016-10-30 14:43:47,17783.96,17783.96
"548",2016-10-30 14:55:18,-17783.96,2.18278728425503e-11
"549",2016-10-30 16:19:45,12697.22,12697.22
"550",2016-10-30 16:36:26,-12697.22,2.18278728425503e-11
"551",2016-10-30 18:21:38,14867.23,14867.23
"552",2016-10-30 18:21:38,12635.97,27503.2
"553",2016-10-30 18:51:36,-27503.2,1.81898940354586e-11
"554",2016-10-30 21:47:25,37784.02,37784.02
"555",2016-10-30 21:52:09,17784.03,55568.05
"556",2016-10-30 21:52:09,13804.82,69372.87
"557",2016-10-30 23:21:57,-69372.87,2.91038304567337e-11
"558",2016-10-31 04:49:07,11923.53,11923.53
"559",2016-10-31 05:22:13,-11923.53,2.91038304567337e-11
"560",2016-10-31 05:50:59,12552.04,12552.04
"561",2016-10-31 06:03:13,-12552.04,2.91038304567337e-11
"562",2016-10-31 13:46:44,12177.42,12177.42
"563",2016-10-31 18:04:21,-12177.42,2.91038304567337e-11
"564",2016-11-01 07:43:15,15012.92,15012.92
"565",2016-11-01 09:14:06,14746.16,29759.08
"566",2016-11-01 09:14:06,12472.76,42231.84
"567",2016-11-01 09:14:06,11253,53484.84
"568",2016-11-01 09:36:00,-53484.84,3.63797880709171e-11
"569",2016-11-01 10:49:13,14122.76,14122.76
"570",2016-11-01 11:07:11,-14122.76,3.63797880709171e-11
"571",2016-11-01 12:00:03,18008.33,18008.33
"572",2016-11-01 12:15:55,-18008.33,3.63797880709171e-11
"573",2016-11-01 14:04:07,11268.54,11268.54
"574",2016-11-01 14:40:45,-11268.54,3.63797880709171e-11
"575",2016-11-01 15:43:59,11266.22,11266.22
"576",2016-11-01 16:07:02,-11266.22,3.63797880709171e-11
"577",2016-11-02 07:34:54,29261.79,29261.79
"578",2016-11-02 08:11:53,24719.4,53981.19
"579",2016-11-02 09:03:39,-53981.19,3.63797880709171e-11
"580",2016-11-02 16:17:38,11254.91,11254.91
"581",2016-11-02 16:40:08,-11254.91,3.63797880709171e-11
"582",2016-11-03 01:22:11,13703.72,13703.72
"583",2016-11-03 02:03:23,-13703.72,3.63797880709171e-11
"584",2016-11-03 11:51:57,15797.91,15797.91
"585",2016-11-03 11:51:57,12545.96,28343.87
"586",2016-11-03 12:07:50,-28343.87,3.63797880709171e-11
"587",2016-11-03 17:06:31,11902.27,11902.27
"588",2016-11-03 17:06:31,21576.27,33478.54
"589",2016-11-03 17:12:59,5007.3,38485.84
"590",2016-11-03 18:57:17,-38485.84,4.36557456851006e-11
"591",2016-11-04 00:56:53,32694.69,32694.69
"592",2016-11-04 01:22:04,-32694.69,4.36557456851006e-11
"593",2016-11-04 19:11:28,12027.63,12027.63
"594",2016-11-04 19:29:26,-12027.63,4.36557456851006e-11
"595",2016-11-04 19:45:24,14854.48,14854.48
"596",2016-11-04 20:23:50,-14854.48,4.36557456851006e-11
"597",2016-11-04 23:08:00,11946.33,11946.33
"598",2016-11-05 02:39:58,-11946.33,4.36557456851006e-11
"599",2016-11-05 15:29:28,11834.71,11834.71
"600",2016-11-05 16:26:20,-11834.71,4.36557456851006e-11
"601",2016-11-07 18:12:31,11523.48,11523.48
"602",2016-11-07 18:38:34,-11523.48,4.36557456851006e-11
"603",2016-11-07 20:51:02,11385.7,11385.7
"604",2016-11-07 20:54:39,-11385.7,4.36557456851006e-11
"605",2016-11-08 04:11:16,16044.64,16044.64
"606",2016-11-08 05:01:16,-16044.64,4.36557456851006e-11
"607",2016-11-08 13:35:21,14718.14,14718.14
"608",2016-11-08 13:54:17,-14718.14,4.36557456851006e-11
"609",2016-11-08 18:54:50,11761.89,11761.89
"610",2016-11-08 19:18:53,-11761.89,4.36557456851006e-11
"611",2016-11-09 07:42:26,14405.05,14405.05
"612",2016-11-09 10:12:16,12495.85,26900.9
"613",2016-11-09 10:35:40,12391.33,39292.23
"614",2016-11-09 10:35:40,-26900.9,12391.33
"615",2016-11-09 11:05:20,12595.68,24987.01
"616",2016-11-09 11:09:33,-24987.01,4.72937244921923e-11
"617",2016-11-09 12:51:33,3551.62,3551.62000000005
"618",2016-11-09 13:13:59,5672.18,9223.80000000005
"619",2016-11-09 13:52:55,2766.22,11990.02
"620",2016-11-09 14:08:52,-11990.02,4.54747350886464e-11
"621",2016-11-09 14:28:31,3452.08,3452.08000000005
"622",2016-11-09 14:28:31,7160.19,10612.27
"623",2016-11-09 14:54:31,-10612.27,4.36557456851006e-11
"624",2016-11-09 15:06:27,5601.99,5601.99000000004
"625",2016-11-09 15:06:27,21693.69,27295.68
"626",2016-11-09 15:43:07,5134.65,32430.33
"627",2016-11-09 15:43:07,-27295.68,5134.65000000005
"628",2016-11-09 15:57:24,-5134.65,4.54747350886464e-11
"629",2016-11-09 16:10:32,3259.68,3259.68000000005
"630",2016-11-09 17:09:58,2643.39,5903.07000000005
"631",2016-11-09 17:09:58,5398.09,11301.16
"632",2016-11-09 17:47:14,1940.08,13241.24
"633",2016-11-09 18:37:30,-13241.24,4.54747350886464e-11
"634",2016-11-09 20:48:51,3480.23,3480.23000000005
"635",2016-11-09 20:48:51,2675.98,6156.21000000005
"636",2016-11-09 21:22:40,1479.39,7635.60000000005
"637",2016-11-09 23:09:20,11539.94,19175.54
"638",2016-11-13 13:19:49,10163.14,29338.68
"639",2016-11-13 14:36:26,12888.57,42227.25
"640",2016-11-13 14:47:15,9886.82,52114.07
"641",2016-11-13 15:45:05,10315.23,62429.3
"642",2016-11-13 16:27:44,13145.41,75574.7100000001
"643",2016-11-13 16:27:44,12406.04,87980.7500000001
"644",2016-11-13 17:14:10,8663.59,96644.3400000001
"645",2016-11-13 19:10:25,8347.8,104992.14
"646",2016-11-14 01:53:49,8658.61,113650.75
"647",2016-11-14 09:14:56,-113650.75,5.82076609134674e-11
"648",2016-11-16 07:46:13,8605.48,8605.48000000006
"649",2016-11-16 09:29:41,-8605.48,5.82076609134674e-11
"650",2016-11-16 11:46:19,24619.35,24619.3500000001
"651",2016-11-16 12:36:58,17538.52,42157.8700000001
"652",2016-11-16 12:54:21,13882.87,56040.7400000001
"653",2016-11-16 13:01:36,12808.49,68849.2300000001
"654",2016-11-16 13:15:12,8392.45,77241.6800000001
"655",2016-11-16 13:15:12,17785.02,95026.7000000001
"656",2016-11-16 15:19:20,-95026.7,5.82076609134674e-11
"657",2016-11-17 01:30:04,12904.88,12904.8800000001
"658",2016-11-17 01:46:23,-12904.88,5.82076609134674e-11
"659",2016-11-17 02:44:21,9623.91,9623.91000000006
"660",2016-11-17 02:56:47,-9623.91,5.82076609134674e-11
"661",2016-11-17 03:32:47,24201.08,24201.0800000001
"662",2016-11-17 04:14:04,10588.14,34789.2200000001
"663",2016-11-17 04:14:04,15637.07,50426.2900000001
"664",2016-11-17 04:18:05,-50426.29,5.82076609134674e-11
"665",2016-11-17 05:09:43,11273.9,11273.9000000001
"666",2016-11-17 06:12:06,9973,21246.9000000001
"667",2016-11-17 07:27:20,16978.18,38225.0800000001
"668",2016-11-17 08:53:55,8282.13,46507.2100000001
"669",2016-11-17 08:53:55,-38225.08,8282.13000000006
"670",2016-11-17 09:20:43,13819.16,22101.2900000001
"671",2016-11-17 09:25:22,-22101.29,5.45696821063757e-11
"672",2016-11-17 10:01:40,8914.17,8914.17000000005
"673",2016-11-17 10:56:12,-8914.17,5.45696821063757e-11
"674",2016-11-17 15:05:47,9119.72,9119.72000000005
"675",2016-11-17 15:11:03,-9119.72,5.45696821063757e-11
"676",2016-11-17 19:46:07,8331.64,8331.64000000005
"677",2016-11-17 20:08:26,-8331.64,5.45696821063757e-11
"678",2016-11-18 07:27:04,8733.25,8733.25000000005
"679",2016-11-18 10:04:58,11735.43,20468.6800000001
"680",2016-11-18 10:33:04,-20468.68,5.45696821063757e-11
"681",2016-11-23 02:24:24,11277.25,11277.2500000001
"682",2016-11-23 02:35:09,11227.46,22504.7100000001
"683",2016-11-23 02:47:37,-11277.25,11227.4600000001
"684",2016-11-23 03:01:40,-11227.46,5.45696821063757e-11
"685",2016-11-23 07:06:58,7114.46,7114.46000000005
"686",2016-11-23 07:18:46,-7114.46,5.45696821063757e-11
"687",2016-11-23 09:49:20,11249.43,11249.4300000001
"688",2016-11-23 18:58:00,-11249.43,5.45696821063757e-11
"689",2016-11-23 22:22:49,11938.33,11938.3300000001
"690",2016-11-24 03:23:26,-11938.33,5.45696821063757e-11
"691",2016-11-24 16:51:12,1255.76,1255.76000000005
"692",2016-11-24 20:14:39,-1255.76,5.45696821063757e-11
"693",2016-11-25 16:24:00,22468.82,22468.8200000001
"694",2016-11-25 17:07:04,-22468.82,5.45696821063757e-11
"695",2016-11-27 09:29:21,3785.57,3785.57000000005
"696",2016-11-27 12:12:52,-3785.57,5.45696821063757e-11
"697",2016-11-27 12:42:57,32148.74,32148.7400000001
"698",2016-11-27 14:46:46,-32148.74,5.45696821063757e-11
"699",2016-11-28 09:30:07,33043.99,33043.99
"700",2016-11-28 09:59:42,-33043.99,5.0931703299284e-11
"701",2016-11-30 09:54:46,37395.25,37395.2500000001
"702",2016-11-30 10:26:10,-37395.25,5.0931703299284e-11
"703",2016-11-30 10:47:53,11936.79,11936.7900000001
"704",2016-11-30 13:10:09,-11936.79,5.0931703299284e-11
"705",2016-11-30 20:46:07,1434.39,1434.39000000005
"706",2016-11-30 21:40:16,-1434.39,5.0931703299284e-11
"707",2016-12-01 04:11:20,36364.34,36364.34
"708",2016-12-01 04:33:13,19929.63,56293.97
"709",2016-12-01 04:33:13,-36364.34,19929.63
"710",2016-12-01 04:51:43,11826.13,31755.76
"711",2016-12-01 05:19:17,12659.12,44414.88
"712",2016-12-01 07:44:54,12559.12,56974.0000000001
"713",2016-12-01 10:55:40,-44414.88,12559.1200000001
"714",2016-12-01 11:20:09,-12559.12,5.27506927028298e-11
"715",2016-12-01 17:21:57,12117.45,12117.4500000001
"716",2016-12-01 18:08:53,-12117.45,5.27506927028298e-11
"717",2016-12-01 19:02:30,11264.52,11264.5200000001
"718",2016-12-01 19:10:48,-11264.52,5.27506927028298e-11
"719",2016-12-01 21:45:28,12804.29,12804.2900000001
"720",2016-12-02 01:32:22,11778.1,24582.3900000001
"721",2016-12-02 01:40:00,26958.41,51540.8000000001
"722",2016-12-02 02:28:38,15878.73,67419.5300000001
"723",2016-12-02 02:28:38,19571.05,86990.5800000001
"724",2016-12-02 02:46:26,14674.72,101665.3
"725",2016-12-02 04:00:35,12617.42,114282.72
"726",2016-12-02 05:08:01,13220.36,127503.08
"727",2016-12-02 05:40:26,18672.23,146175.31
"728",2016-12-02 06:02:26,16130.05,162305.36
"729",2016-12-02 14:06:29,16060.88,178366.24
"730",2016-12-03 05:01:54,-51540.8,126825.44
"731",2016-12-03 05:28:24,-126825.44,4.36557456851006e-11
"732",2016-12-05 12:05:44,12602.41,12602.41
"733",2016-12-05 16:13:41,-12602.41,4.36557456851006e-11
"734",2016-12-05 21:59:07,18233.26,18233.26
"735",2016-12-05 22:06:08,-18233.26,4.36557456851006e-11
"736",2016-12-06 00:46:15,5009.3,5009.30000000004
"737",2016-12-06 02:18:57,7786.35,12795.65
"738",2016-12-06 06:23:44,7786.36,20582.01
"739",2016-12-06 07:23:02,7262.1,27844.11
"740",2016-12-06 07:26:15,17786.38,45630.49
"741",2016-12-06 08:46:07,4775.02,50405.5100000001
"742",2016-12-06 10:19:35,15119.69,65525.2000000001
"743",2016-12-06 12:54:49,-12795.65,52729.5500000001
"744",2016-12-06 16:58:38,-52729.55,5.0931703299284e-11
"745",2016-12-07 10:21:35,39242.08,39242.0800000001
"746",2016-12-07 11:14:28,-39242.08,5.0931703299284e-11
"747",2016-12-07 15:20:24,11276.21,11276.2100000001
"748",2016-12-07 15:34:18,-11276.21,5.0931703299284e-11
"749",2016-12-07 19:07:33,22297.92,22297.92
"750",2016-12-07 19:41:45,-22297.92,5.0931703299284e-11
"751",2016-12-07 20:00:12,11242.07,11242.0700000001
"752",2016-12-07 20:34:06,-11242.07,5.0931703299284e-11
"753",2016-12-08 00:45:16,11345.2,11345.2000000001
"754",2016-12-08 00:51:01,-11345.2,5.0931703299284e-11
"755",2016-12-08 06:06:20,11583.32,11583.3200000001
"756",2016-12-08 06:32:13,-11583.32,5.0931703299284e-11
"757",2016-12-08 13:22:59,4111.04,4111.04000000005
"758",2016-12-08 14:02:19,-4111.04,5.0931703299284e-11
"759",2016-12-08 17:01:27,5738.73,5738.73000000005
"760",2016-12-08 17:44:04,5421.64,11160.37
"761",2016-12-08 17:51:41,-5738.73,5421.64000000005
"762",2016-12-08 18:10:02,-5421.64,5.00222085975111e-11
"763",2016-12-09 19:34:43,616.05,616.05000000005
"764",2016-12-09 19:56:58,-616.05,5.00222085975111e-11
"765",2016-12-10 16:38:26,10009.75,10009.7500000001
"766",2016-12-10 19:03:55,-10009.75,5.0931703299284e-11
"767",2016-12-10 20:00:07,5009.74,5009.74000000005
"768",2016-12-10 20:25:02,-5009.74,5.0931703299284e-11
"769",2016-12-11 09:45:38,7786.76,7786.76000000005
"770",2016-12-11 10:50:06,-7786.76,5.0931703299284e-11
"771",2016-12-12 01:06:34,9552.08,9552.08000000005
"772",2016-12-12 02:02:45,6235.57,15787.6500000001
"773",2016-12-12 02:26:52,-15787.65,5.0931703299284e-11
"774",2016-12-12 02:54:54,4633.55,4633.55000000005
"775",2016-12-12 03:10:27,-4633.55,5.0931703299284e-11
"776",2016-12-12 10:14:12,10065.56,10065.5600000001
"777",2016-12-12 10:41:40,-10065.56,5.0931703299284e-11
"778",2016-12-12 11:51:34,7786.87,7786.87000000005
"779",2016-12-12 11:51:34,30009.88,37796.7500000001
"780",2016-12-12 12:23:26,12228.79,50025.5400000001
"781",2016-12-12 13:30:13,11410.21,61435.7500000001
"782",2016-12-12 14:46:40,1309.86,62745.6100000001
"783",2016-12-12 15:48:15,11699.39,74445.0000000001
"784",2016-12-12 15:48:15,11468.09,85913.0900000001
"785",2016-12-12 22:05:14,-50025.54,35887.5500000001
"786",2016-12-12 22:10:02,-35887.55,5.0931703299284e-11
"787",2016-12-13 02:09:22,23954.86,23954.8600000001
"788",2016-12-13 02:30:35,22217.3,46172.16
"789",2016-12-13 03:05:23,-46172.16,4.36557456851006e-11
"790",2016-12-13 18:11:34,12113.32,12113.32
"791",2016-12-13 18:48:07,-12113.32,4.36557456851006e-11
"792",2016-12-14 19:47:18,49789.64,49789.64
"793",2016-12-14 22:25:13,-49789.64,4.36557456851006e-11
"794",2016-12-15 04:26:47,11431.1,11431.1
"795",2016-12-15 04:50:27,-11431.1,4.36557456851006e-11
"796",2016-12-15 15:35:34,11382.87,11382.87
"797",2016-12-15 20:30:12,-11382.87,4.36557456851006e-11
"798",2016-12-16 06:35:57,13265.4,13265.4
"799",2016-12-16 06:35:57,14552.33,27817.73
"800",2016-12-16 10:23:35,-27817.73,4.36557456851006e-11
"801",2016-12-17 02:51:33,13149.72,13149.72
"802",2016-12-17 03:34:18,-13149.72,4.36557456851006e-11
"803",2016-12-17 09:48:00,12065.04,12065.04
"804",2016-12-17 11:16:51,-12065.04,4.36557456851006e-11
"805",2016-12-17 15:00:20,11234.48,11234.48
"806",2016-12-17 16:42:25,-11234.48,4.36557456851006e-11
"807",2016-12-17 18:24:45,11290.42,11290.42
"808",2016-12-17 19:03:55,-11290.42,4.36557456851006e-11
"809",2016-12-19 00:56:31,12398.04,12398.04
"810",2016-12-19 01:13:05,-12398.04,4.36557456851006e-11
"811",2016-12-19 19:55:55,8239.21,8239.21000000004
"812",2016-12-19 21:25:39,-8239.21,4.36557456851006e-11
"813",2016-12-21 16:21:13,13016.38,13016.38
"814",2016-12-21 16:40:36,22692.44,35708.82
"815",2016-12-21 17:19:40,-35708.82,4.36557456851006e-11
"816",2016-12-21 18:05:22,15866.53,15866.53
"817",2016-12-21 18:50:12,-15866.53,4.36557456851006e-11
"818",2016-12-22 09:41:13,27823.11,27823.11
"819",2016-12-22 10:05:31,22938.73,50761.84
"820",2016-12-22 10:42:54,-50761.84,4.36557456851006e-11
"821",2016-12-22 11:48:38,24680.73,24680.73
"822",2016-12-22 11:48:38,11861.94,36542.67
"823",2016-12-22 12:39:37,11446.58,47989.25
"824",2016-12-22 13:51:48,-47989.25,4.36557456851006e-11
"825",2016-12-22 14:35:48,10206.06,10206.06
"826",2016-12-22 14:54:40,7787.46,17993.52
"827",2016-12-22 14:54:40,-10206.06,7787.46000000004
"828",2016-12-22 15:34:38,17787.49,25574.95
"829",2016-12-22 15:34:38,4459.25,30034.2
"830",2016-12-22 15:34:38,-7787.46,22246.74
"831",2016-12-22 16:09:43,-22246.74,4.72937244921923e-11
"832",2016-12-22 16:12:20,5010.47,5010.47000000005
"833",2016-12-22 16:32:04,-5010.47,4.72937244921923e-11
"834",2016-12-22 17:29:44,7787.5,7787.50000000005
"835",2016-12-22 17:37:03,-7787.5,4.72937244921923e-11
"836",2016-12-22 20:27:13,14935.59,14935.59
"837",2016-12-22 20:47:57,7372.14,22307.73
"838",2016-12-22 23:03:51,-22307.73,4.72937244921923e-11
"839",2016-12-23 04:08:07,12213.91,12213.91
"840",2016-12-23 04:19:38,10893.23,23107.14
"841",2016-12-23 04:39:33,15921.14,39028.28
"842",2016-12-23 04:39:33,7067.7,46095.98
"843",2016-12-23 05:29:07,13787.58,59883.56
"844",2016-12-23 05:33:08,-23107.14,36776.42
"845",2016-12-23 06:05:11,18143.96,54920.38
"846",2016-12-23 06:05:11,-36776.42,18143.96
"847",2016-12-23 06:52:57,7863.93,26007.89
"848",2016-12-23 06:57:20,8756.17,34764.06
"849",2016-12-23 08:10:11,15539.39,50303.45
"850",2016-12-23 09:26:38,9938.29,60241.74
"851",2016-12-23 09:29:32,3912.35,64154.09
"852",2016-12-23 12:38:54,-50303.45,13850.64
"853",2016-12-23 13:50:38,-13850.64,4.36557456851006e-11
"854",2016-12-23 14:17:47,18016.49,18016.49
"855",2016-12-23 14:22:19,-18016.49,4.36557456851006e-11
"856",2016-12-23 16:00:47,10935.8,10935.8
"857",2016-12-23 16:28:46,-10935.8,4.36557456851006e-11
"858",2016-12-23 16:38:02,30010.7,30010.7
"859",2016-12-23 17:46:10,7787.71,37798.41
"860",2016-12-23 19:17:26,-30010.7,7787.71000000005
"861",2016-12-23 19:37:22,-7787.71,4.63842297904193e-11
"862",2016-12-23 19:47:05,5010.69,5010.69000000005
"863",2016-12-23 20:10:44,-5010.69,4.63842297904193e-11
"864",2016-12-23 20:37:44,7787.72,7787.72000000005
"865",2016-12-23 20:37:44,7787.73,15575.45
"866",2016-12-23 21:15:43,-15575.45,4.54747350886464e-11
"867",2016-12-23 21:43:15,7787.74,7787.74000000005
"868",2016-12-23 22:00:57,6379.41,14167.15
"869",2016-12-23 22:00:57,-7787.74,6379.41000000005
"870",2016-12-23 22:13:22,-6379.41,4.54747350886464e-11
"871",2016-12-24 08:55:26,17235.98,17235.98
"872",2016-12-24 09:31:16,8388.15,25624.13
"873",2016-12-24 09:37:40,7557.25,33181.38
"874",2016-12-24 09:57:39,13750.37,46931.7500000001
"875",2016-12-24 14:43:25,18252.01,65183.7600000001
"876",2016-12-24 16:22:12,9004.61,74188.3700000001
"877",2016-12-25 01:28:39,8186.07,82374.4400000001
"878",2016-12-25 03:57:33,-82374.44,5.82076609134674e-11
"879",2016-12-25 07:21:33,7848.93,7848.93000000006
"880",2016-12-25 08:05:40,-7848.93,5.82076609134674e-11
"881",2016-12-25 08:46:37,9338.49,9338.49000000006
"882",2016-12-25 09:24:17,16029.57,25368.0600000001
"883",2016-12-25 09:36:55,7846.2,33214.2600000001
"884",2016-12-25 09:44:15,9072.7,42286.9600000001
"885",2016-12-25 10:16:24,18466.53,60753.49
"886",2016-12-25 10:16:24,-42286.96,18466.53
"887",2016-12-25 10:37:19,7284.64,25751.17
"888",2016-12-25 10:37:19,-18466.53,7284.64000000005
"889",2016-12-25 10:59:32,-7284.64,5.00222085975111e-11
"890",2016-12-25 21:35:42,13364.2,13364.2000000001
"891",2016-12-25 22:12:57,-13364.2,5.0931703299284e-11
"892",2016-12-26 00:14:01,13031.27,13031.2700000001
"893",2016-12-26 00:48:46,8150.43,21181.7000000001
"894",2016-12-26 00:57:31,9299.33,30481.03
"895",2016-12-26 01:12:24,10365.34,40846.3700000001
"896",2016-12-26 01:12:24,-30481.03,10365.3400000001
"897",2016-12-26 01:21:35,11653.5,22018.8400000001
"898",2016-12-26 01:21:35,-10365.34,11653.5000000001
"899",2016-12-26 01:33:06,15836.06,27489.5600000001
"900",2016-12-26 03:57:50,-27489.56,5.45696821063757e-11
"901",2016-12-26 09:34:21,16826.33,16826.3300000001
"902",2016-12-26 09:34:21,30011.93,46838.2600000001
"903",2016-12-26 09:48:35,30011.94,76850.2000000001
"904",2016-12-26 11:37:56,-76850.2,5.82076609134674e-11
"905",2016-12-26 13:39:40,8104.28,8104.28000000006
"906",2016-12-26 13:54:40,-8104.28,5.82076609134674e-11
"907",2016-12-26 16:45:49,12870.89,12870.8900000001
"908",2016-12-26 19:39:33,-12870.89,5.82076609134674e-11
"909",2016-12-26 19:51:17,8011.07,8011.07000000006
"910",2016-12-26 21:38:42,7335.42,15346.4900000001
"911",2016-12-26 22:34:30,12160.94,27507.4300000001
"912",2016-12-27 00:11:27,6734.37,34241.8000000001
"913",2016-12-27 01:14:57,10412.89,44654.6900000001
"914",2016-12-27 02:01:32,-44654.69,5.82076609134674e-11
"915",2016-12-27 10:41:29,9387.24,9387.24000000006
"916",2016-12-27 10:48:17,-9387.24,5.82076609134674e-11
"917",2016-12-27 12:03:43,8834.54,8834.54000000006
"918",2016-12-27 12:32:38,14387.24,23221.7800000001
"919",2016-12-27 12:32:38,30012.05,53233.8300000001
"920",2016-12-27 12:32:38,-8834.54,44399.2900000001
"921",2016-12-27 12:42:53,30012.06,74411.3500000001
"922",2016-12-27 13:32:26,37789.07,112200.42
"923",2016-12-27 14:17:52,18336.24,130536.66
"924",2016-12-27 14:37:29,9569.31,140105.97
"925",2016-12-27 14:47:39,8081.94,148187.91
"926",2016-12-27 15:22:03,7604.96,155792.87
"927",2016-12-27 15:32:01,4417.05,160209.92
"928",2016-12-27 15:40:36,3923.33,164133.25
"929",2016-12-27 16:24:29,-74411.35,89721.9000000001
"930",2016-12-27 16:48:47,-89721.9,5.82076609134674e-11
"931",2016-12-27 17:32:34,6305.81,6305.81000000006
"932",2016-12-27 17:58:19,4385.14,10690.9500000001
"933",2016-12-27 18:27:04,7720.2,18411.1500000001
"934",2016-12-27 18:32:59,-18411.15,5.82076609134674e-11
"935",2016-12-27 19:04:55,12869.47,12869.4700000001
"936",2016-12-27 19:13:58,-12869.47,5.82076609134674e-11
"937",2016-12-27 19:34:17,6704.73,6704.73000000006
"938",2016-12-27 19:58:34,17213.67,23918.4000000001
"939",2016-12-27 19:58:34,9724.55,33642.9500000001
"940",2016-12-27 19:58:34,9280.95,42923.9000000001
"941",2016-12-27 20:22:14,-42923.9,5.0931703299284e-11
"942",2016-12-27 22:14:07,13777.79,13777.7900000001
"943",2016-12-27 22:59:46,-13777.79,5.0931703299284e-11
"944",2016-12-28 00:24:39,11370.21,11370.2100000001
"945",2016-12-28 00:24:39,19047.25,30417.4600000001
"946",2016-12-28 00:31:27,-30417.46,5.0931703299284e-11
"947",2016-12-28 02:57:49,12503.88,12503.8800000001
"948",2016-12-28 03:08:57,-12503.88,5.0931703299284e-11
"949",2016-12-28 04:16:05,12511.15,12511.1500000001
"950",2016-12-28 04:40:03,-12511.15,5.0931703299284e-11
"951",2016-12-28 05:20:13,9114.52,9114.52000000005
"952",2016-12-28 05:40:42,29733.99,38848.5100000001
"953",2016-12-28 05:40:42,-9114.52,29733.9900000001
"954",2016-12-28 06:26:14,11290.68,41024.6700000001
"955",2016-12-28 06:26:14,14922.91,55947.5800000001
"956",2016-12-28 06:26:14,-29733.99,26213.5900000001
"957",2016-12-28 06:48:14,-26213.59,5.82076609134674e-11
"958",2016-12-28 06:51:12,16650.68,16650.6800000001
"959",2016-12-28 09:02:53,14400.68,31051.3600000001
"960",2016-12-28 09:05:19,-16650.68,14400.6800000001
"961",2016-12-28 09:15:00,-14400.68,5.82076609134674e-11
"962",2016-12-28 11:48:04,798.33,798.330000000058
"963",2016-12-28 14:56:04,-798.33,5.82076609134674e-11
"964",2016-12-28 16:01:45,12449.38,12449.3800000001
"965",2016-12-28 16:01:45,13178.74,25628.1200000001
"966",2016-12-28 16:24:35,13789.45,39417.5700000001
"967",2016-12-28 16:24:35,17207.02,56624.5900000001
"968",2016-12-28 17:05:34,19471.31,76095.9000000001
"969",2016-12-28 17:12:08,-56624.59,19471.3100000001
"970",2016-12-28 17:30:27,-19471.31,5.45696821063757e-11
"971",2016-12-28 21:07:14,30219.52,30219.5200000001
"972",2016-12-28 21:39:06,-30219.52,5.45696821063757e-11
"973",2016-12-29 00:38:28,15098.62,15098.6200000001
"974",2016-12-29 00:44:01,13718.16,28816.7800000001
"975",2016-12-29 01:04:31,17789.59,46606.3700000001
"976",2016-12-29 01:28:08,5521.23,52127.6
"977",2016-12-29 01:47:48,1436.2,53563.8
"978",2016-12-29 01:47:48,-52127.6,1436.20000000005
"979",2016-12-29 03:31:07,18931.04,20367.24
"980",2016-12-29 03:43:50,4033.38,24400.62
"981",2016-12-29 03:43:50,-1436.2,22964.42
"982",2016-12-29 04:06:31,-22964.42,5.0931703299284e-11
"983",2016-12-29 06:27:49,7789.64,7789.64000000005
"984",2016-12-29 06:55:38,-7789.64,5.0931703299284e-11
"985",2016-12-29 06:55:38,3789.65,3789.65000000005
"986",2016-12-29 07:24:32,8955.77,12745.4200000001
"987",2016-12-29 07:57:22,29150.91,41896.3300000001
"988",2016-12-29 07:57:22,17789.68,59686.0100000001
"989",2016-12-29 07:59:15,-12745.42,46940.5900000001
"990",2016-12-29 08:16:47,-46940.59,5.82076609134674e-11
"991",2016-12-29 08:20:52,6702.81,6702.81000000006
"992",2016-12-29 08:30:10,10090.26,16793.0700000001
"993",2016-12-29 08:31:00,-6702.81,10090.2600000001
"994",2016-12-29 09:05:17,3925.92,14016.1800000001
"995",2016-12-29 10:32:17,-14016.18,5.63886715099216e-11
"996",2016-12-29 10:41:02,1308.74,1308.74000000006
"997",2016-12-29 13:56:06,38463.12,39771.8600000001
"998",2016-12-29 13:56:06,-1308.74,38463.1200000001
"999",2016-12-29 14:04:58,15349.74,53812.8600000001
"1000",2016-12-29 14:04:58,-38463.12,15349.7400000001
"1001",2016-12-29 14:23:09,-15349.74,5.63886715099216e-11
"1002",2016-12-29 17:01:22,13711.06,13711.0600000001
"1003",2016-12-29 17:01:22,13926.85,27637.9100000001
"1004",2016-12-29 17:01:22,11497.49,39135.4000000001
"1005",2016-12-29 19:57:45,-39135.4,5.0931703299284e-11
"1006",2016-12-29 21:50:09,12624.74,12624.7400000001
"1007",2016-12-29 21:55:05,-12624.74,5.0931703299284e-11
"1008",2016-12-29 22:48:24,14810.25,14810.2500000001
"1009",2016-12-29 23:55:03,19822.09,34632.3400000001
"1010",2016-12-29 23:57:40,-34632.34,5.82076609134674e-11
"1011",2016-12-30 02:38:45,20566.68,20566.6800000001
"1012",2016-12-30 02:58:49,-20566.68,5.82076609134674e-11
"1013",2016-12-30 05:23:34,3947.93,3947.93000000006
"1014",2016-12-30 05:43:21,-3947.93,5.82076609134674e-11
"1015",2016-12-30 08:00:58,1265.87,1265.87000000006
"1016",2016-12-30 08:26:29,-1265.87,5.82076609134674e-11
"1017",2016-12-30 09:18:48,13790.12,13790.1200000001
"1018",2016-12-30 09:37:47,7790.14,21580.2600000001
"1019",2016-12-30 09:37:47,13790.13,35370.3900000001
"1020",2016-12-30 09:37:47,20367.39,55737.7800000001
"1021",2016-12-30 10:07:25,39594.4,95332.1800000001
"1022",2016-12-30 10:26:13,34484.91,129817.09
"1023",2016-12-30 10:26:13,37790.19,167607.28
"1024",2016-12-30 10:46:54,-167607.28,5.82076609134674e-11
"1025",2016-12-30 12:23:16,30978.12,30978.1200000001
"1026",2016-12-30 13:03:55,18210.53,49188.6500000001
"1027",2016-12-30 13:33:43,18587.76,67776.41
"1028",2016-12-30 14:02:34,32303.88,100080.29
"1029",2016-12-30 14:34:17,4365.19,104445.48
"1030",2016-12-30 14:34:17,37790.3,142235.78
"1031",2016-12-30 14:34:17,25731.34,167967.12
"1032",2016-12-30 14:45:38,-67776.41,100190.71
"1033",2016-12-30 15:00:31,-100190.71,4.36557456851006e-11
"1034",2016-12-30 17:10:24,11284.84,11284.84
"1035",2016-12-30 17:34:16,14838.08,26122.92
"1036",2016-12-30 19:09:54,-26122.92,4.36557456851006e-11
"1037",2016-12-31 00:35:03,12710,12710
"1038",2016-12-31 01:47:59,-12710,4.36557456851006e-11
"1039",2016-12-31 02:21:17,9186.15,9186.15000000004
"1040",2016-12-31 02:28:24,-9186.15,4.36557456851006e-11
"1041",2016-12-31 06:57:44,11464.89,11464.89
"1042",2016-12-31 07:36:28,12488.75,23953.64
"1043",2016-12-31 08:26:12,-23953.64,4.36557456851006e-11
"1044",2016-12-31 09:28:37,11466.02,11466.02
"1045",2016-12-31 09:39:28,24192.15,35658.17
"1046",2016-12-31 12:31:51,-35658.17,4.36557456851006e-11
"1047",2016-12-31 13:15:30,13754.65,13754.65
"1048",2016-12-31 13:38:28,-13754.65,4.36557456851006e-11
"1049",2016-12-31 23:44:04,22382.69,22382.69
"1050",2017-01-01 04:07:16,14815.63,37198.32
"1051",2017-01-01 04:07:16,-22382.69,14815.63
"1052",2017-01-01 04:30:32,14263.95,29079.58
"1053",2017-01-01 04:30:32,-14815.63,14263.95
"1054",2017-01-01 06:24:36,-14263.95,4.54747350886464e-11
"1055",2017-01-01 11:28:17,37790.48,37790.48
"1056",2017-01-01 11:28:17,21310.6,59101.08
"1057",2017-01-01 11:43:35,-59101.08,4.36557456851006e-11
"1058",2017-01-01 15:12:10,11320.94,11320.94
"1059",2017-01-01 15:50:10,-11320.94,4.36557456851006e-11
"1060",2017-01-01 16:05:37,14042.87,14042.87
"1061",2017-01-01 16:33:01,11431.55,25474.42
"1062",2017-01-01 16:33:01,23500.45,48974.87
"1063",2017-01-01 17:25:42,21544.68,70519.55
"1064",2017-01-01 17:28:48,-48974.87,21544.68
"1065",2017-01-01 17:44:02,-21544.68,4.36557456851006e-11
"1066",2017-01-01 20:08:18,14119.4,14119.4
"1067",2017-01-01 21:53:02,12174.36,26293.76
"1068",2017-01-01 23:53:15,17182.74,43476.5
"1069",2017-01-02 02:52:19,15787.09,59263.59
"1070",2017-01-02 03:36:13,12213.4,71476.99
"1071",2017-01-02 04:31:24,27521.68,98998.67
"1072",2017-01-02 04:43:31,20587.82,119586.49
"1073",2017-01-02 09:41:52,13283.02,132869.51
"1074",2017-01-02 10:52:43,19095.8,151965.31
"1075",2017-01-02 12:13:09,12737.77,164703.08
"1076",2017-01-02 12:40:58,15352.67,180055.75
"1077",2017-01-02 13:40:58,13616.17,193671.92
"1078",2017-01-02 15:57:16,12814.68,206486.6
"1079",2017-01-02 16:37:52,24539.13,231025.73
"1080",2017-01-02 17:47:38,11340.7,242366.43
"1081",2017-01-02 18:43:19,17130.99,259497.42
"1082",2017-01-02 18:47:22,9628.43,269125.85
"1083",2017-01-02 20:23:31,13790.83,282916.68
"1084",2017-01-02 20:50:56,13790.84,296707.52
"1085",2017-01-03 02:14:51,-296707.52,5.82076609134674e-11
"1086",2017-01-03 05:12:14,8678.61,8678.61000000006
"1087",2017-01-03 05:38:04,-8678.61,5.82076609134674e-11
"1088",2017-01-03 06:42:55,12442.06,12442.0600000001
"1089",2017-01-03 07:41:04,12943.41,25385.4700000001
"1090",2017-01-03 07:43:36,-12442.06,12943.4100000001
"1091",2017-01-03 08:50:02,-12943.41,6.00266503170133e-11
"1092",2017-01-03 11:02:29,17519.73,17519.7300000001
"1093",2017-01-03 11:10:21,-17519.73,6.18456397205591e-11
"1094",2017-01-03 12:22:55,6931.18,6931.18000000006
"1095",2017-01-03 12:41:16,6781.49,13712.6700000001
"1096",2017-01-03 13:12:26,-6931.18,6781.49000000006
"1097",2017-01-03 13:33:17,-6781.49,6.18456397205591e-11
"1098",2017-01-03 14:00:00,10617.14,10617.1400000001
"1099",2017-01-03 14:00:00,17790.94,28408.0800000001
"1100",2017-01-03 14:58:02,11906.92,40315.0000000001
"1101",2017-01-03 14:58:30,-28408.08,11906.9200000001
"1102",2017-01-03 15:09:09,9973.95,21880.8700000001
"1103",2017-01-03 15:12:48,-21880.87,5.82076609134674e-11
"1104",2017-01-03 15:34:58,8692.52,8692.52000000006
"1105",2017-01-03 15:43:38,8283.57,16976.0900000001
"1106",2017-01-03 15:43:38,18901.99,35878.0800000001
"1107",2017-01-03 15:52:29,-35878.08,5.82076609134674e-11
"1108",2017-01-03 16:51:25,37791,37791.0000000001
"1109",2017-01-03 17:09:09,-37791,5.82076609134674e-11
"1110",2017-01-03 17:14:19,10351.89,10351.8900000001
"1111",2017-01-03 17:37:09,18902.02,29253.9100000001
"1112",2017-01-03 18:02:09,-29253.91,5.82076609134674e-11
"1113",2017-01-03 20:49:28,7791.03,7791.03000000006
"1114",2017-01-03 21:26:07,21079.54,28870.5700000001
"1115",2017-01-03 21:43:52,37791.05,66661.6200000001
"1116",2017-01-03 21:43:52,17791.06,84452.6800000001
"1117",2017-01-03 22:32:25,-7791.03,76661.6500000001
"1118",2017-01-03 22:40:12,18902.07,95563.7200000001
"1119",2017-01-03 22:45:33,30014.08,125577.8
"1120",2017-01-03 22:45:33,-95563.72,30014.0800000001
"1121",2017-01-03 22:46:55,-30014.08,5.82076609134674e-11
"1122",2017-01-03 23:36:51,17791.09,17791.0900000001
"1123",2017-01-03 23:36:51,37791.1,55582.1900000001
"1124",2017-01-03 23:54:16,-55582.19,5.82076609134674e-11
"1125",2017-01-04 02:06:25,17026.73,17026.7300000001
"1126",2017-01-04 03:12:26,-17026.73,5.82076609134674e-11
"1127",2017-01-04 03:34:50,8902.14,8902.14000000006
"1128",2017-01-04 03:50:25,-8902.14,5.82076609134674e-11
"1129",2017-01-04 04:16:20,5014.15,5014.15000000006
"1130",2017-01-04 07:00:00,31926.54,36940.6900000001
"1131",2017-01-04 07:16:36,-5014.15,31926.5400000001
"1132",2017-01-04 07:27:32,17902.17,49828.7100000001
"1133",2017-01-04 08:11:33,-49828.71,5.82076609134674e-11
"1134",2017-01-04 09:27:37,17338.45,17338.4500000001
"1135",2017-01-04 10:26:29,7040.21,24378.6600000001
"1136",2017-01-04 10:26:29,13014.2,37392.8600000001
"1137",2017-01-04 10:58:33,30014.21,67407.0700000001
"1138",2017-01-04 11:07:38,-30014.21,37392.8600000001
"1139",2017-01-04 11:50:36,17791.24,55184.1000000001
"1140",2017-01-04 12:15:19,18902.25,74086.3500000001
"1141",2017-01-04 12:15:19,7791.26,81877.6100000001
"1142",2017-01-04 12:56:35,37791.27,119668.88
"1143",2017-01-04 13:36:33,13766.11,133434.99
"1144",2017-01-04 13:36:33,37791.29,171226.28
"1145",2017-01-04 14:44:12,17791.3,189017.58
"1146",2017-01-04 15:15:12,17791.31,206808.89
"1147",2017-01-04 15:48:31,12600.15,219409.04
"1148",2017-01-04 15:50:42,-37392.86,182016.18
"1149",2017-01-04 17:13:15,37791.33,219807.51
"1150",2017-01-04 17:13:15,37791.34,257598.85
"1151",2017-01-04 17:26:10,37791.36,295390.21
"1152",2017-01-04 17:43:23,18784.25,314174.46
"1153",2017-01-04 18:09:27,21787.89,335962.35
"1154",2017-01-04 18:09:27,37791.39,373753.74
"1155",2017-01-04 18:33:16,17791.4,391545.14
"1156",2017-01-04 19:24:52,18902.42,410447.56
"1157",2017-01-04 19:24:52,17791.41,428238.97
"1158",2017-01-04 19:24:52,18902.43,447141.4
"1159",2017-01-04 19:43:03,17791.45,464932.85
"1160",2017-01-04 20:01:28,37791.46,502724.31
"1161",2017-01-04 20:01:28,37791.48,540515.79
"1162",2017-01-04 20:45:12,11222.29,551738.08
"1163",2017-01-04 20:51:28,37791.5,589529.58
"1164",2017-01-04 21:01:16,37791.51,627321.09
"1165",2017-01-04 22:37:34,37791.53,665112.62
"1166",2017-01-04 22:37:34,17791.54,682904.16
"1167",2017-01-04 23:01:06,37791.55,720695.71
"1168",2017-01-04 23:11:27,17791.56,738487.27
"1169",2017-01-04 23:19:05,37791.57,776278.84
"1170",2017-01-04 23:19:05,17791.58,794070.42
"1171",2017-01-04 23:21:34,-44484.75,749585.67
"1172",2017-01-04 23:34:32,30014.59,779600.26
"1173",2017-01-04 23:49:47,-779600.26,2.3283064365387e-10
"1174",2017-01-05 00:06:39,30014.61,30014.6100000002
"1175",2017-01-05 00:06:39,30014.6,60029.2100000002
"1176",2017-01-05 00:30:59,-60029.21,2.3283064365387e-10
"1177",2017-01-05 04:49:38,5014.65,5014.65000000023
"1178",2017-01-05 05:29:07,-5014.65,2.3283064365387e-10
"1179",2017-01-05 07:58:12,37791.64,37791.6400000002
"1180",2017-01-05 08:57:44,-37791.64,2.3283064365387e-10
"1181",2017-01-05 12:33:43,37747.52,37747.5200000002
"1182",2017-01-05 12:39:28,-37747.52,2.3283064365387e-10
"1183",2017-01-05 22:45:19,23483.24,23483.2400000002
"1184",2017-01-06 00:27:39,36029.42,59512.6600000002
"1185",2017-01-06 04:19:47,-23483.24,36029.4200000002
"1186",2017-01-06 08:49:54,37792.64,73822.0600000002
"1187",2017-01-06 08:49:54,20974.38,94796.4400000002
"1188",2017-01-06 08:49:54,17792.66,112589.1
"1189",2017-01-06 10:07:39,30015.69,142604.79
"1190",2017-01-06 10:07:39,14540.82,157145.61
"1191",2017-01-06 10:07:39,11400.03,168545.64
"1192",2017-01-06 10:29:06,37792.72,206338.36
"1193",2017-01-06 10:29:06,17857.63,224195.99
"1194",2017-01-06 14:07:08,38903.75,263099.74
"1195",2017-01-06 16:51:52,20776.27,283876.01
"1196",2017-01-06 17:44:20,21399.89,305275.9
"1197",2017-01-06 19:14:53,20638.58,325914.48
"1198",2017-01-06 19:41:15,29965.32,355879.8
"1199",2017-01-06 19:41:15,9452.69,365332.49
"1200",2017-01-06 21:02:43,37792.83,403125.32
"1201",2017-01-06 21:02:43,19988.74,423114.06
"1202",2017-01-06 22:02:12,17179.74,440293.8
"1203",2017-01-07 00:09:30,7016.87,447310.67
"1204",2017-01-07 00:09:30,7977.32,455287.99
"1205",2017-01-07 01:06:03,15428.63,470716.62
"1206",2017-01-07 02:42:20,-470716.62,2.91038304567337e-10
"1207",2017-01-07 08:46:59,20059.83,20059.8300000003
"1208",2017-01-07 09:08:37,-20059.83,2.91038304567337e-10
"1209",2017-01-07 09:08:37,20787.67,20787.6700000003
"1210",2017-01-07 09:13:56,-20787.67,2.91038304567337e-10
"1211",2017-01-07 09:53:39,61069.86,61069.8600000003
"1212",2017-01-07 09:53:39,78904.01,139973.87
"1213",2017-01-07 10:48:13,-139973.87,2.91038304567337e-10
"1214",2017-01-08 03:04:54,55880.2,55880.2000000003
"1215",2017-01-08 03:15:29,-55880.2,2.91038304567337e-10
"1216",2017-01-08 05:19:46,65189.42,65189.4200000003
"1217",2017-01-08 05:19:46,38904.07,104093.49
"1218",2017-01-08 05:26:49,-104093.49,2.7648638933897e-10
"1219",2017-01-08 06:09:47,18616.91,18616.9100000003
"1220",2017-01-08 06:44:21,-18616.91,2.7648638933897e-10
"1221",2017-01-08 07:08:10,38904.1,38904.1000000003
"1222",2017-01-08 07:08:10,38904.09,77808.1900000003
"1223",2017-01-08 07:25:44,-77808.19,2.61934474110603e-10
"1224",2017-01-11 11:28:39,21136.43,21136.4300000003
"1225",2017-01-11 11:41:03,-21136.43,2.61934474110603e-10
"1226",2017-01-11 11:41:03,16663.59,16663.5900000003
"1227",2017-01-11 12:06:36,-16663.59,2.61934474110603e-10
"1228",2017-01-11 12:51:14,41022.23,41022.2300000003
"1229",2017-01-11 13:35:57,-41022.23,2.61934474110603e-10
"1230",2017-01-11 15:47:02,64674.63,64674.6300000003
"1231",2017-01-11 15:47:02,-41022.23,23652.4000000003
"1232",2017-01-11 16:05:53,-23652.4,2.5465851649642e-10
"1233",2017-01-11 18:12:03,29964.35,29964.3500000003
"1234",2017-01-11 18:27:22,-29964.35,2.5465851649642e-10
"1235",2017-01-11 20:10:56,13793.43,13793.4300000003
"1236",2017-01-11 20:10:56,11276.11,25069.5400000003
"1237",2017-01-11 20:10:56,9422.25,34491.7900000003
"1238",2017-01-11 20:10:56,7040.08,41531.8700000003
"1239",2017-01-11 20:28:59,-41531.87,2.5465851649642e-10
"1240",2017-01-11 21:56:25,5471.49,5471.49000000025
"1241",2017-01-11 22:00:03,-5471.49,2.5465851649642e-10
"1242",2017-01-12 06:19:51,26435.06,26435.0600000003
"1243",2017-01-12 06:22:59,11316.49,37751.5500000003
"1244",2017-01-12 06:22:59,6174.74,43926.2900000003
"1245",2017-01-12 06:22:59,18904.58,62830.8700000003
"1246",2017-01-12 06:38:51,-62830.87,2.5465851649642e-10
"1247",2017-01-12 10:05:11,11714.06,11714.0600000003
"1248",2017-01-12 10:17:13,-11714.06,2.5465851649642e-10
"1249",2017-01-12 11:05:52,17052.98,17052.9800000003
"1250",2017-01-12 11:11:25,-17052.98,2.5465851649642e-10
"1251",2017-01-12 13:43:15,16043.2,16043.2000000003
"1252",2017-01-12 14:01:57,-16043.2,2.5465851649642e-10
"1253",2017-01-12 16:22:06,22276.36,22276.3600000003
"1254",2017-01-12 16:22:06,16070.67,38347.0300000003
"1255",2017-01-12 16:39:45,-38347.03,2.5465851649642e-10
"1256",2017-01-13 07:51:49,16719.07,16719.0700000003
"1257",2017-01-13 08:07:55,-16719.07,2.5465851649642e-10
"1258",2017-01-13 10:27:58,24487.08,24487.0800000003
"1259",2017-01-13 10:32:18,-24487.08,2.5465851649642e-10
"1260",2017-01-13 10:53:44,1999.59,1999.59000000025
"1261",2017-01-13 11:08:56,-1999.59,2.5465851649642e-10
"1262",2017-01-13 13:04:17,23853.43,23853.4300000003
"1263",2017-01-13 13:04:17,13817.05,37670.4800000003
"1264",2017-01-13 13:09:51,-37670.48,2.5465851649642e-10
"1265",2017-01-13 15:50:01,6100.35,6100.35000000026
"1266",2017-01-13 15:50:01,5662.75,11763.1000000003
"1267",2017-01-13 16:33:09,-11763.1,2.5465851649642e-10
"1268",2017-01-13 16:54:43,14464.39,14464.3900000003
"1269",2017-01-13 16:54:43,11336.93,25801.3200000003
"1270",2017-01-13 16:54:43,10561.79,36363.1100000003
"1271",2017-01-13 17:13:14,-36363.11,2.5465851649642e-10
"1272",2017-01-13 18:27:07,8241.54,8241.54000000026
"1273",2017-01-13 19:14:10,-8241.54,2.5465851649642e-10
"1274",2017-01-13 20:27:44,8420.44,8420.44000000026
"1275",2017-01-13 20:27:44,7810.19,16230.6300000003
"1276",2017-01-13 20:27:44,5465.85,21696.4800000003
"1277",2017-01-13 20:39:40,-21696.48,2.58296495303512e-10
"1278",2017-01-13 23:05:48,13016.94,13016.9400000003
"1279",2017-01-13 23:05:48,22253.26,35270.2000000003
"1280",2017-01-13 23:05:48,6637.34,41907.5400000003
"1281",2017-01-13 23:08:55,-41907.54,2.5465851649642e-10
"1282",2017-01-14 00:17:16,32712.42,32712.4200000003
"1283",2017-01-14 00:17:16,6120.39,38832.8100000003
"1284",2017-01-14 00:39:28,-38832.81,2.5465851649642e-10
"1285",2017-01-14 01:52:32,16005.76,16005.7600000003
"1286",2017-01-14 01:52:32,10640.03,26645.7900000003
"1287",2017-01-14 01:52:32,8647.45,35293.2400000003
"1288",2017-01-14 01:52:32,6341.42,41634.6600000003
"1289",2017-01-14 01:58:47,-41634.66,2.47382558882236e-10
"1290",2017-01-14 07:11:43,9561.99,9561.99000000025
"1291",2017-01-14 07:33:11,-9561.99,2.47382558882236e-10
"1292",2017-01-15 23:28:46,10199.12,10199.1200000002
"1293",2017-01-15 23:28:46,18905.35,29104.4700000002
"1294",2017-01-15 23:28:46,6940.66,36045.1300000003
"1295",2017-01-15 23:45:31,-36045.13,2.5465851649642e-10
"1296",2017-01-16 02:45:06,25676.44,25676.4400000003
"1297",2017-01-16 02:45:06,9960.67,35637.1100000003
"1298",2017-01-16 02:45:06,5480.12,41117.2300000003
"1299",2017-01-16 02:50:32,-41117.23,2.5465851649642e-10
"1300",2017-01-16 04:53:21,7335.51,7335.51000000025
"1301",2017-01-16 04:59:26,-7335.51,2.5465851649642e-10
"1302",2017-01-16 07:29:21,5634.41,5634.41000000025
"1303",2017-01-16 07:42:49,8626.04,14260.4500000003
"1304",2017-01-16 07:42:49,-5634.41,8626.04000000026
"1305",2017-01-16 07:42:49,-5634.41,2991.63000000026
"1306",2017-01-16 07:52:22,-2991.63,2.55568011198193e-10
"1307",2017-01-16 08:49:31,7589.04,7589.04000000026
"1308",2017-01-16 09:02:34,-7589.04,2.55568011198193e-10
"1309",2017-01-16 09:45:27,9119.33,9119.33000000026
"1310",2017-01-16 09:45:27,6306.04,15425.3700000003
"1311",2017-01-16 09:57:42,-15425.37,2.56477505899966e-10
"1312",2017-01-17 04:06:51,37368.07,37368.0700000003
"1313",2017-01-17 04:06:51,13794.49,51162.5600000003
"1314",2017-01-17 04:06:51,5755.72,56918.2800000003
"1315",2017-01-17 04:06:51,6056.08,62974.3600000003
"1316",2017-01-17 05:35:10,-62974.36,2.5465851649642e-10
"1317",2017-01-17 05:51:03,36277.04,36277.0400000003
"1318",2017-01-17 08:52:59,-36277.04,2.5465851649642e-10
"1319",2017-01-17 09:29:14,6168.17,6168.17000000025
"1320",2017-01-17 09:29:14,30017.56,36185.7300000003
"1321",2017-01-17 09:29:14,30017.58,66203.3100000003
"1322",2017-01-17 09:29:14,13402.22,79605.5300000003
"1323",2017-01-17 09:51:42,-79605.53,2.61934474110603e-10
"1324",2017-01-17 13:18:41,33785.47,33785.4700000003
"1325",2017-01-17 13:18:41,18905.62,52691.0900000003
"1326",2017-01-17 13:23:21,-52691.09,2.61934474110603e-10
"1327",2017-01-17 14:30:58,8996.66,8996.66000000026
"1328",2017-01-17 14:38:09,6665.52,15662.1800000003
"1329",2017-01-17 14:38:09,-8996.66,6665.52000000026
"1330",2017-01-17 15:05:44,-6665.52,2.61934474110603e-10
"1331",2017-01-17 16:41:14,7181.09,7181.09000000026
"1332",2017-01-17 16:56:25,-7181.09,2.61934474110603e-10
"1333",2017-01-17 17:13:40,14764.53,14764.5300000003
"1334",2017-01-17 17:29:24,-14764.53,2.61934474110603e-10
"1335",2017-01-17 17:29:24,20400.95,20400.9500000003
"1336",2017-01-17 17:56:50,19116.07,39517.0200000003
"1337",2017-01-17 17:56:50,-20400.95,19116.0700000003
"1338",2017-01-17 18:19:23,-19116.07,2.65572452917695e-10
"1339",2017-01-17 18:29:50,8617.85,8617.85000000027
"1340",2017-01-17 18:43:47,-8617.85,2.65572452917695e-10
"1341",2017-01-17 18:43:47,755.84,755.840000000266
"1342",2017-01-17 18:55:13,16093.06,16848.9000000003
"1343",2017-01-17 18:55:13,-755.84,16093.0600000003
"1344",2017-01-17 19:04:58,-16093.06,2.63753463514149e-10
"1345",2017-01-17 19:08:41,10554.53,10554.5300000003
"1346",2017-01-17 19:19:40,-10554.53,2.63753463514149e-10
"1347",2017-01-17 19:45:19,29269.03,29269.0300000003
"1348",2017-01-17 19:53:53,-29269.03,2.61934474110603e-10
"1349",2017-01-17 20:13:58,18726.47,18726.4700000003
"1350",2017-01-17 20:13:58,24553.78,43280.2500000003
"1351",2017-01-17 20:18:16,-43280.25,2.61934474110603e-10
"1352",2017-01-17 21:12:10,15329.86,15329.8600000003
"1353",2017-01-17 21:24:06,-15329.86,2.61934474110603e-10
"1354",2017-01-17 21:50:02,11703.7,11703.7000000003
"1355",2017-01-17 22:02:08,-11703.7,2.61934474110603e-10
"1356",2017-01-17 22:29:52,21753.72,21753.7200000003
"1357",2017-01-17 22:45:09,12801.47,34555.1900000003
"1358",2017-01-17 22:45:09,-21753.72,12801.4700000003
"1359",2017-01-17 23:09:15,-12801.47,2.63753463514149e-10
"1360",2017-01-17 23:32:44,7796.71,7796.71000000026
"1361",2017-01-17 23:55:42,-7796.71,2.63753463514149e-10
"1362",2017-01-17 23:56:32,2500.21,2500.21000000026
"1363",2017-01-17 23:59:07,-2500.21,2.63753463514149e-10
"1364",2017-01-18 00:47:05,7739.27,7739.27000000026
"1365",2017-01-18 00:53:47,-7739.27,2.63753463514149e-10
"1366",2017-01-18 00:58:45,6445.31,6445.31000000026
"1367",2017-01-18 01:06:52,-6445.31,2.63753463514149e-10
"1368",2017-01-18 01:45:00,6658.2,6658.20000000026
"1369",2017-01-18 02:05:52,-6658.2,2.63753463514149e-10
"1370",2017-01-18 06:40:24,14809.54,14809.5400000003
"1371",2017-01-18 07:16:29,-14809.54,2.63753463514149e-10
"1372",2017-01-18 13:48:59,16358.93,16358.9300000003
"1373",2017-01-18 14:56:16,2257.25,18616.1800000003
"1374",2017-01-18 16:27:46,5695.17,24311.3500000003
"1375",2017-01-18 17:39:26,9367.49,33678.8400000003
"1376",2017-01-18 20:43:45,16052.12,49730.9600000003
"1377",2017-01-18 23:30:58,7855.27,57586.2300000003
"1378",2017-01-19 00:03:56,17818.05,75404.2800000003
"1379",2017-01-19 00:09:42,8072.49,83476.7700000003
"1380",2017-01-19 00:50:29,17732.15,101208.92
"1381",2017-01-19 02:43:20,17100.01,118308.93
"1382",2017-01-19 06:46:38,-118308.93,2.7648638933897e-10
"1383",2017-01-19 08:31:39,17843.95,17843.9500000003
"1384",2017-01-19 08:59:45,16076.05,33920.0000000003
"1385",2017-01-19 09:05:35,-17843.95,16076.0500000003
"1386",2017-01-19 09:12:20,-16076.05,2.7648638933897e-10
"1387",2017-01-19 12:17:43,18368.69,18368.6900000003
"1388",2017-01-19 12:40:41,-18368.69,2.7648638933897e-10
"1389",2017-01-19 14:01:00,17337.34,17337.3400000003
"1390",2017-01-19 14:09:55,-17337.34,2.7648638933897e-10
"1391",2017-01-19 15:13:35,15913.14,15913.1400000003
"1392",2017-01-19 15:17:33,-15913.14,2.7648638933897e-10
"1393",2017-01-19 17:35:15,22518.2,22518.2000000003
"1394",2017-01-19 17:35:15,16128.83,38647.0300000003
"1395",2017-01-19 18:07:57,19798.04,58445.0700000003
"1396",2017-01-19 18:07:57,-38647.03,19798.0400000003
"1397",2017-01-19 18:41:02,-19798.04,2.7648638933897e-10
"1398",2017-01-19 19:01:06,15970.89,15970.8900000003
"1399",2017-01-19 19:43:10,-15970.89,2.7648638933897e-10
"1400",2017-01-19 21:45:26,16478.57,16478.5700000003
"1401",2017-01-19 21:45:26,19588.07,36066.6400000003
"1402",2017-01-19 22:17:59,21439.88,57506.5200000003
"1403",2017-01-19 22:17:59,17612.76,75119.2800000003
"1404",2017-01-19 22:17:59,-36066.64,39052.6400000003
"1405",2017-01-19 23:25:50,-39052.64,2.7648638933897e-10
"1406",2017-01-19 23:25:50,16532.22,16532.2200000003
"1407",2017-01-20 00:06:42,-16532.22,2.7648638933897e-10
"1408",2017-01-20 02:10:06,15630.2,15630.2000000003
"1409",2017-01-20 02:13:40,-15630.2,2.7648638933897e-10
"1410",2017-01-20 04:54:55,15911.58,15911.5800000003
"1411",2017-01-20 05:38:37,-15911.58,2.7648638933897e-10
"1412",2017-01-20 08:43:30,17362.79,17362.7900000003
"1413",2017-01-20 08:50:48,-17362.79,2.7648638933897e-10
"1414",2017-01-20 17:39:41,18180.26,18180.2600000003
"1415",2017-01-20 21:23:25,-18180.26,2.7648638933897e-10
"1416",2017-01-20 22:04:44,16167.65,16167.6500000003
"1417",2017-01-21 02:36:51,21838.38,38006.0300000003
"1418",2017-01-21 02:36:51,17319.66,55325.6900000003
"1419",2017-01-21 03:31:20,-55325.69,2.7648638933897e-10
"1420",2017-01-21 03:40:07,22050.04,22050.0400000003
"1421",2017-01-21 04:12:57,20572.79,42622.8300000003
"1422",2017-01-21 04:12:57,21799.02,64421.8500000003
"1423",2017-01-21 04:12:57,-22050.04,42371.8100000003
"1424",2017-01-21 04:12:57,27856.23,70228.0400000003
"1425",2017-01-21 04:12:57,38906.31,109134.35
"1426",2017-01-21 04:33:02,-109134.35,2.7648638933897e-10
"1427",2017-01-21 05:03:03,23852.71,23852.7100000003
"1428",2017-01-21 05:06:27,-23852.71,2.7648638933897e-10
"1429",2017-01-21 05:48:24,39764.59,39764.5900000003
"1430",2017-01-21 05:48:24,18136.57,57901.1600000003
"1431",2017-01-21 06:16:31,-57901.16,2.69210431724787e-10
"1432",2017-01-21 08:15:06,17469.63,17469.6300000003
"1433",2017-01-21 08:31:12,-17469.63,2.69210431724787e-10
"1434",2017-01-21 11:06:15,18867.97,18867.9700000003
"1435",2017-01-21 11:19:34,21714.35,40582.3200000003
"1436",2017-01-21 11:21:39,-18867.97,21714.3500000003
"1437",2017-01-21 11:27:15,-21714.35,2.69210431724787e-10
"1438",2017-01-21 13:30:43,24402.01,24402.0100000003
"1439",2017-01-21 13:34:50,-24402.01,2.69210431724787e-10
"1440",2017-01-21 14:03:12,17381.69,17381.6900000003
"1441",2017-01-21 14:12:30,-17381.69,2.69210431724787e-10
"1442",2017-01-21 14:51:00,17669.73,17669.7300000003
"1443",2017-01-21 14:51:00,20377.52,38047.2500000003
"1444",2017-01-21 15:03:22,-38047.25,2.69210431724787e-10
"1445",2017-01-21 15:53:39,18482.09,18482.0900000003
"1446",2017-01-21 16:01:51,-18482.09,2.69210431724787e-10
"1447",2017-01-21 16:38:01,17816.77,17816.7700000003
"1448",2017-01-21 16:43:56,-17816.77,2.69210431724787e-10
"1449",2017-01-22 09:57:24,18019.13,18019.1300000003
"1450",2017-01-22 10:10:20,-18019.13,2.69210431724787e-10
"1451",2017-01-23 15:14:17,25415.69,25415.6900000003
"1452",2017-01-23 15:14:17,21711.44,47127.1300000003
"1453",2017-01-23 15:28:03,33370.08,80497.2100000003
"1454",2017-01-23 15:35:11,-80497.21,2.61934474110603e-10
"1455",2017-01-23 15:50:59,23243.32,23243.3200000003
"1456",2017-01-23 15:50:59,28864.22,52107.5400000003
"1457",2017-01-23 15:50:59,18635.5,70743.0400000003
"1458",2017-01-23 15:50:59,37795.62,108538.66
"1459",2017-01-23 15:59:14,-108538.66,2.61934474110603e-10
"1460",2017-01-23 22:59:50,20900.98,20900.9800000003
"1461",2017-01-23 23:21:25,-20900.98,2.61934474110603e-10
"1462",2017-01-23 23:45:22,18797.24,18797.2400000003
"1463",2017-01-24 00:14:15,-18797.24,2.61934474110603e-10
"1464",2017-01-24 04:18:52,11288.09,11288.0900000003
"1465",2017-01-24 04:22:32,16016.48,27304.5700000003
"1466",2017-01-24 04:22:32,-11288.09,16016.4800000003
"1467",2017-01-24 04:45:25,-16016.48,2.61934474110603e-10
"1468",2017-01-24 05:50:02,15544.29,15544.2900000003
"1469",2017-01-24 05:54:09,-15544.29,2.61934474110603e-10
"1470",2017-01-24 09:16:32,12360.2,12360.2000000003
"1471",2017-01-24 09:31:26,-12360.2,2.61934474110603e-10
"1472",2017-01-24 09:34:03,9539.21,9539.21000000026
"1473",2017-01-24 09:34:03,22929.58,32468.7900000003
"1474",2017-01-24 09:34:03,14381.9,46850.6900000003
"1475",2017-01-24 09:34:03,1395.68,48246.3700000003
"1476",2017-01-24 09:51:01,-48246.37,2.61934474110603e-10
"1477",2017-01-24 10:13:41,14338.94,14338.9400000003
"1478",2017-01-24 10:29:31,-14338.94,2.61934474110603e-10
"1479",2017-01-24 15:48:52,1393.49,1393.49000000026
"1480",2017-01-24 15:53:50,-1393.49,2.61934474110603e-10
"1481",2017-01-24 17:18:07,10393.6,10393.6000000003
"1482",2017-01-24 17:22:25,-10393.6,2.61934474110603e-10
"1483",2017-01-24 17:46:10,11180.07,11180.0700000003
"1484",2017-01-24 17:51:51,-11180.07,2.61934474110603e-10
"1485",2017-01-24 21:23:49,30019,30019.0000000003
"1486",2017-01-24 21:31:37,-30019,2.61934474110603e-10
"1487",2017-01-24 21:38:39,718.3,718.300000000262
"1488",2017-01-24 21:51:20,-718.3,2.61934474110603e-10
"1489",2017-01-25 06:36:48,13862.49,13862.4900000003
"1490",2017-01-25 06:36:48,10244.01,24106.5000000003
"1491",2017-01-25 06:36:48,8404.93,32511.4300000003
"1492",2017-01-25 07:43:09,-32511.43,2.61934474110603e-10
"1493",2017-01-25 14:12:40,9499.06,9499.06000000026
"1494",2017-01-25 14:21:24,-9499.06,2.61934474110603e-10
"1495",2017-01-25 20:12:11,895.17,895.170000000262
"1496",2017-01-25 20:16:55,-895.17,2.61934474110603e-10
"1497",2017-01-26 02:47:53,22619.48,22619.4800000003
"1498",2017-01-26 02:54:23,-22619.48,2.61934474110603e-10
"1499",2017-01-28 02:01:03,81138.93,81138.9300000003
"1500",2017-01-28 02:09:53,-81138.93,2.61934474110603e-10
"1501",2017-01-28 08:00:14,22339.06,22339.0600000003
"1502",2017-01-28 08:32:03,-22339.06,2.61934474110603e-10
"1503",2017-01-31 08:12:23,25619.91,25619.9100000003
"1504",2017-01-31 08:18:22,-25619.91,2.61934474110603e-10
"1505",2017-01-31 09:02:12,22774.91,22774.9100000003
"1506",2017-01-31 09:07:00,-22774.91,2.61934474110603e-10
"1507",2017-01-31 11:23:40,22870.29,22870.2900000003
"1508",2017-01-31 11:47:29,-22870.29,2.61934474110603e-10
"1509",2017-01-31 12:18:56,23607.08,23607.0800000003
"1510",2017-01-31 12:38:52,-23607.08,2.61934474110603e-10
"1511",2017-01-31 12:45:21,24061.81,24061.8100000003
"1512",2017-01-31 12:51:50,-24061.81,2.61934474110603e-10
"1513",2017-01-31 12:56:11,32075.74,32075.7400000003
"1514",2017-01-31 13:26:07,-32075.74,2.61934474110603e-10
"1515",2017-01-31 15:12:13,26145.91,26145.9100000003
"1516",2017-01-31 15:17:27,-26145.91,2.61934474110603e-10
"1517",2017-01-31 23:38:32,56426.61,56426.6100000003
"1518",2017-02-01 10:51:37,26282.3,82708.9100000003
"1519",2017-02-01 10:51:37,27179.54,109888.45
"1520",2017-02-01 11:10:40,-56426.61,53461.8400000003
"1521",2017-02-01 13:26:36,22341.4,75803.2400000003
"1522",2017-02-01 14:59:30,26552.94,102356.18
"1523",2017-02-01 15:04:40,33121.42,135477.6
"1524",2017-02-01 15:31:43,23487.73,158965.33
"1525",2017-02-01 20:13:38,-158965.33,2.91038304567337e-10
"1526",2017-02-02 05:21:18,23386.38,23386.3800000003
"1527",2017-02-02 05:24:48,-23386.38,2.91038304567337e-10
"1528",2017-02-02 11:06:56,23081.75,23081.7500000003
"1529",2017-02-02 11:21:29,-23081.75,2.91038304567337e-10
"1530",2017-02-02 15:24:22,26766.97,26766.9700000003
"1531",2017-02-02 15:32:57,-26766.97,2.91038304567337e-10
"1532",2017-02-02 15:32:57,18158.18,18158.1800000003
"1533",2017-02-02 15:34:39,-18158.18,2.91038304567337e-10
"1534",2017-02-02 17:45:44,23356.71,23356.7100000003
"1535",2017-02-02 18:02:52,12008.9,35365.6100000003
"1536",2017-02-02 18:02:52,13843.89,49209.5000000003
"1537",2017-02-02 18:15:27,12666.78,61876.2800000003
"1538",2017-02-02 19:07:36,13815.73,75692.0100000003
"1539",2017-02-02 19:07:36,-61876.28,13815.7300000003
"1540",2017-02-02 19:11:43,11622.54,25438.2700000003
"1541",2017-02-02 19:37:06,13917.04,39355.3100000003
"1542",2017-02-02 19:58:59,-25438.27,13917.0400000003
"1543",2017-02-02 20:12:21,-13917.04,2.87400325760245e-10
"1544",2017-02-02 21:07:30,20086.92,20086.9200000003
"1545",2017-02-02 21:30:24,-20086.92,2.87400325760245e-10
"1546",2017-02-02 22:54:50,11544.51,11544.5100000003
"1547",2017-02-02 23:00:35,-11544.51,2.87400325760245e-10
"1548",2017-02-03 06:58:01,33153.66,33153.6600000003
"1549",2017-02-03 07:48:44,-33153.66,2.91038304567337e-10
"1550",2017-02-03 07:48:44,22995.12,22995.1200000003
"1551",2017-02-03 08:09:00,28159.87,51154.9900000003
"1552",2017-02-03 08:09:00,-22995.12,28159.8700000003
"1553",2017-02-03 08:14:47,-28159.87,2.91038304567337e-10
"1554",2017-02-03 15:03:20,24579.67,24579.6700000003
"1555",2017-02-03 15:03:20,23607.49,48187.1600000003
"1556",2017-02-03 15:17:00,-48187.16,2.91038304567337e-10
"1557",2017-02-03 15:19:02,24935.89,24935.8900000003
"1558",2017-02-03 15:32:31,-24935.89,2.91038304567337e-10
"1559",2017-02-03 16:34:00,26123.48,26123.4800000003
"1560",2017-02-03 17:04:09,-26123.48,2.91038304567337e-10
"1561",2017-02-03 18:01:49,27037.17,27037.1700000003
"1562",2017-02-03 18:04:59,-27037.17,2.91038304567337e-10
"1563",2017-02-03 21:34:16,23895.53,23895.5300000003
"1564",2017-02-03 21:47:48,-23895.53,2.91038304567337e-10
"1565",2017-02-04 00:20:32,22802.92,22802.9200000003
"1566",2017-02-04 00:25:55,-22802.92,2.91038304567337e-10
"1567",2017-02-04 01:15:04,23910.41,23910.4100000003
"1568",2017-02-04 01:23:06,-23910.41,2.91038304567337e-10
"1569",2017-02-04 02:52:03,23297.73,23297.7300000003
"1570",2017-02-04 03:05:57,-23297.73,2.91038304567337e-10
"1571",2017-02-04 04:13:36,23772.64,23772.6400000003
"1572",2017-02-04 04:19:10,-23772.64,2.91038304567337e-10
"1573",2017-02-04 12:29:40,23195.14,23195.1400000003
"1574",2017-02-04 12:33:36,-23195.14,2.91038304567337e-10
"1575",2017-02-04 17:03:10,31736.94,31736.9400000003
"1576",2017-02-04 17:17:32,-31736.94,2.91038304567337e-10
"1577",2017-02-04 17:55:08,48844.23,48844.2300000003
"1578",2017-02-04 18:19:28,24659.85,73504.0800000003
"1579",2017-02-04 18:19:28,-48844.23,24659.8500000003
"1580",2017-02-04 18:53:04,-24659.85,2.91038304567337e-10
"1581",2017-02-05 17:46:13,827.99,827.990000000291
"1582",2017-02-05 18:34:35,9391.72,10219.7100000003
"1583",2017-02-05 18:34:35,-827.99,9391.72000000029
"1584",2017-02-05 18:51:34,-9391.72,2.91038304567337e-10
"1585",2017-02-05 18:51:34,7816.52,7816.52000000029
"1586",2017-02-05 18:51:34,32567.8,40384.3200000003
"1587",2017-02-05 18:51:34,9251.81,49636.1300000003
"1588",2017-02-05 19:07:56,-49636.13,2.91038304567337e-10
"1589",2017-02-05 20:49:01,10411.88,10411.8800000003
"1590",2017-02-05 20:49:01,8791.69,19203.5700000003
"1591",2017-02-05 20:52:13,-19203.57,2.91038304567337e-10
"1592",2017-02-06 05:27:01,8192.7,8192.70000000029
"1593",2017-02-06 05:44:55,9080.75,17273.4500000003
"1594",2017-02-06 05:44:55,-8192.7,9080.75000000029
"1595",2017-02-06 06:06:31,7901.1,16981.8500000003
"1596",2017-02-06 06:06:31,-9080.75,7901.10000000029
"1597",2017-02-06 06:36:21,14927.64,22828.7400000003
"1598",2017-02-06 06:36:21,-7901.1,14927.6400000003
"1599",2017-02-06 06:51:29,-14927.64,2.89219315163791e-10
"1600",2017-02-06 07:08:04,8482.3,8482.30000000029
"1601",2017-02-06 07:13:55,-8482.3,2.89219315163791e-10
"1602",2017-02-06 11:27:20,8532.22,8532.22000000029
"1603",2017-02-06 11:37:06,-8532.22,2.89219315163791e-10
"1604",2017-02-06 12:31:14,8071.39,8071.39000000029
"1605",2017-02-06 13:32:49,-8071.39,2.89219315163791e-10
"1606",2017-02-06 14:42:52,12581.38,12581.3800000003
"1607",2017-02-06 15:26:53,7847.35,20428.7300000003
"1608",2017-02-06 16:27:02,12155.79,32584.5200000003
"1609",2017-02-06 16:27:02,-12581.38,20003.1400000003
"1610",2017-02-06 16:27:02,-12581.38,7421.76000000029
"1611",2017-02-06 16:39:37,-7421.76,2.91038304567337e-10
"1612",2017-02-06 17:07:54,12829.53,12829.5300000003
"1613",2017-02-06 17:11:46,-12829.53,2.91038304567337e-10
"1614",2017-02-07 04:59:23,16585.66,16585.6600000003
"1615",2017-02-07 05:08:55,7917.34,24503.0000000003
"1616",2017-02-07 05:17:03,8423.21,32926.2100000003
"1617",2017-02-07 05:17:03,8687.06,41613.2700000003
"1618",2017-02-07 05:17:03,-24503,17110.2700000003
"1619",2017-02-07 05:25:07,-17110.27,2.87400325760245e-10
"1620",2017-02-07 05:48:25,13169.33,13169.3300000003
"1621",2017-02-07 05:52:13,-13169.33,2.87400325760245e-10
"1622",2017-02-07 06:32:12,9031.81,9031.81000000029
"1623",2017-02-07 06:50:34,-9031.81,2.87400325760245e-10
"1624",2017-02-07 07:18:46,20923.49,20923.4900000003
"1625",2017-02-07 07:36:10,-20923.49,2.87400325760245e-10
"1626",2017-02-07 08:09:03,19362.8,19362.8000000003
"1627",2017-02-07 08:12:45,-19362.8,2.87400325760245e-10
"1628",2017-02-07 09:10:41,26858.3,26858.3000000003
"1629",2017-02-07 09:15:34,-26858.3,2.87400325760245e-10
"1630",2017-02-07 13:31:34,24007.44,24007.4400000003
"1631",2017-02-07 15:41:54,23475.02,47482.4600000003
"1632",2017-02-07 15:50:36,-24007.44,23475.0200000003
"1633",2017-02-07 16:08:19,-23475.02,2.83762346953154e-10
"1634",2017-02-07 21:37:41,6571.22,6571.22000000028
"1635",2017-02-07 21:44:13,-6571.22,2.83762346953154e-10
"1636",2017-02-07 22:21:32,21247.91,21247.9100000003
"1637",2017-02-07 22:23:42,-21247.91,2.83762346953154e-10
"1638",2017-02-07 23:01:21,26358.71,26358.7100000003
"1639",2017-02-07 23:15:40,-26358.71,2.83762346953154e-10
"1640",2017-02-08 00:20:50,23217.43,23217.4300000003
"1641",2017-02-08 00:26:13,-23217.43,2.83762346953154e-10
"1642",2017-02-08 01:25:29,28574.58,28574.5800000003
"1643",2017-02-08 01:28:14,-28574.58,2.83762346953154e-10
"1644",2017-02-08 07:25:38,8202.21,8202.21000000028
"1645",2017-02-08 08:16:28,-8202.21,2.83762346953154e-10
"1646",2017-02-08 09:48:50,22474.45,22474.4500000003
"1647",2017-02-08 09:55:58,-22474.45,2.83762346953154e-10
"1648",2017-02-08 16:28:25,7935.31,7935.31000000028
"1649",2017-02-08 16:28:25,9879.37,17814.6800000003
"1650",2017-02-08 16:35:52,-17814.68,2.83762346953154e-10
"1651",2017-02-08 18:40:21,30021.16,30021.1600000003
"1652",2017-02-08 18:40:21,8757.85,38779.0100000003
"1653",2017-02-08 18:42:50,12705.67,51484.6800000003
"1654",2017-02-08 18:42:50,-38779.01,12705.6700000003
"1655",2017-02-08 18:45:54,8184.04,20889.7100000003
"1656",2017-02-08 18:45:54,-12705.67,8184.04000000028
"1657",2017-02-08 19:05:10,11845.16,20029.2000000003
"1658",2017-02-08 19:19:39,10168.55,30197.7500000003
"1659",2017-02-08 19:19:39,-8184.04,22013.7100000003
"1660",2017-02-08 19:19:39,-20029.2,1984.51000000028
"1661",2017-02-08 19:27:48,-1984.51,2.78532752417959e-10
"1662",2017-02-08 19:57:20,11755.23,11755.2300000003
"1663",2017-02-08 20:38:06,10453.04,22208.2700000003
"1664",2017-02-08 20:38:06,13229.99,35438.2600000003
"1665",2017-02-08 20:38:06,-11755.23,23683.0300000003
"1666",2017-02-08 20:38:06,-11755.23,11927.8000000003
"1667",2017-02-08 20:38:06,-11755.23,172.57000000028
"1668",2017-02-08 20:44:59,-172.57,2.79840151051758e-10
"1669",2017-02-08 21:26:42,7937.3,7937.30000000028
"1670",2017-02-08 21:35:36,-7937.3,2.80124368146062e-10
"1671",2017-02-09 02:22:40,9893.55,9893.55000000028
"1672",2017-02-09 02:33:37,-9893.55,2.80124368146062e-10
"1673",2017-02-09 03:10:06,11177.2,11177.2000000003
"1674",2017-02-09 03:15:06,-11177.2,2.80124368146062e-10
"1675",2017-02-09 03:21:21,13628.24,13628.2400000003
"1676",2017-02-09 03:24:07,42196.58,55824.8200000003
"1677",2017-02-09 03:24:07,-13628.24,42196.5800000003
"1678",2017-02-09 03:29:13,-42196.58,2.83762346953154e-10
"1679",2017-02-09 03:30:01,26144.22,26144.2200000003
"1680",2017-02-09 03:35:54,23327,49471.2200000003
"1681",2017-02-09 03:35:54,-26144.22,23327.0000000003
"1682",2017-02-09 03:40:16,-23327,2.83762346953154e-10
"1683",2017-02-09 05:33:07,22719.78,22719.7800000003
"1684",2017-02-09 05:59:10,-22719.78,2.83762346953154e-10
"1685",2017-02-09 06:51:58,22768.26,22768.2600000003
"1686",2017-02-09 07:21:56,-22768.26,2.83762346953154e-10
"1687",2017-02-09 12:16:04,23323.69,23323.6900000003
"1688",2017-02-09 12:35:46,-23323.69,2.83762346953154e-10
"1689",2017-02-09 20:52:51,38596.3,38596.3000000003
"1690",2017-02-09 20:52:51,23551.38,62147.6800000003
"1691",2017-02-09 21:01:41,-62147.68,2.83762346953154e-10
"1692",2017-02-09 21:01:41,28365.12,28365.1200000003
"1693",2017-02-09 21:05:27,-28365.12,2.83762346953154e-10
"1694",2017-02-09 21:05:27,33549.95,33549.9500000003
"1695",2017-02-09 21:22:17,23683.75,57233.7000000003
"1696",2017-02-09 21:22:17,-33549.95,23683.7500000003
"1697",2017-02-09 21:39:22,22758.47,46442.2200000003
"1698",2017-02-09 21:39:22,-23683.75,22758.4700000003
"1699",2017-02-09 21:43:44,-22758.47,2.83762346953154e-10
"1700",2017-02-09 22:20:50,34071.54,34071.5400000003
"1701",2017-02-09 22:20:50,28789.11,62860.6500000003
"1702",2017-02-09 22:20:50,77798.57,140659.22
"1703",2017-02-09 22:43:32,-140659.22,2.91038304567337e-10
"1704",2017-02-10 10:44:28,27522.52,27522.5200000003
"1705",2017-02-10 10:44:28,23394.18,50916.7000000003
"1706",2017-02-10 10:44:28,28138.02,79054.7200000003
"1707",2017-02-10 11:35:57,-79054.72,2.91038304567337e-10
"1708",2017-02-12 02:14:54,26751.45,26751.4500000003
"1709",2017-02-12 02:46:02,-26751.45,2.91038304567337e-10
"1710",2017-02-12 03:00:31,25032.28,25032.2800000003
"1711",2017-02-12 03:10:35,-25032.28,2.91038304567337e-10
"1712",2017-02-14 07:33:25,27343.02,27343.0200000003
"1713",2017-02-14 07:36:28,-27343.02,2.91038304567337e-10
"1714",2017-02-14 08:34:16,27727.94,27727.9400000003
"1715",2017-02-14 08:38:55,28358.09,56086.0300000003
"1716",2017-02-14 08:38:55,-27727.94,28358.0900000003
"1717",2017-02-14 08:44:29,-28358.09,2.91038304567337e-10
"1718",2017-02-14 13:23:23,26326.33,26326.3300000003
"1719",2017-02-14 13:32:29,-26326.33,2.91038304567337e-10
"1720",2017-02-14 15:09:28,23442.25,23442.2500000003
"1721",2017-02-14 15:24:17,-23442.25,2.91038304567337e-10
"1722",2017-02-15 07:15:01,29385.86,29385.8600000003
"1723",2017-02-15 07:23:21,-29385.86,2.91038304567337e-10
"1724",2017-02-15 09:14:12,24294.83,24294.8300000003
"1725",2017-02-15 09:43:53,-24294.83,2.91038304567337e-10
"1726",2017-02-15 14:47:01,22374.39,22374.3900000003
"1727",2017-02-15 15:01:08,-22374.39,2.91038304567337e-10
"1728",2017-02-16 22:23:25,24137.97,24137.9700000003
"1729",2017-02-16 22:36:48,-24137.97,2.91038304567337e-10
"1730",2017-02-17 17:08:27,23181.24,23181.2400000003
"1731",2017-02-17 17:16:08,-23181.24,2.91038304567337e-10
"1732",2017-02-17 18:46:36,24923.01,24923.0100000003
"1733",2017-02-17 19:00:03,-24923.01,2.91038304567337e-10
"1734",2017-02-17 20:05:43,23536.73,23536.7300000003
"1735",2017-02-17 20:16:08,-23536.73,2.91038304567337e-10
"1736",2017-02-17 21:07:38,30780.02,30780.0200000003
"1737",2017-02-17 21:12:18,-30780.02,2.91038304567337e-10
"1738",2017-02-17 23:46:17,24138.89,24138.8900000003
"1739",2017-02-17 23:52:45,-24138.89,2.91038304567337e-10
"1740",2017-02-18 01:35:24,24418.27,24418.2700000003
"1741",2017-02-18 01:55:54,-24418.27,2.91038304567337e-10
"1742",2017-02-18 04:00:03,28810.71,28810.7100000003
"1743",2017-02-18 05:07:20,-28810.71,2.91038304567337e-10
"1744",2017-02-18 05:07:20,38873.67,38873.6700000003
"1745",2017-02-18 05:16:34,-38873.67,2.91038304567337e-10
"1746",2017-02-20 23:45:56,24080.1,24080.1000000003
"1747",2017-02-20 23:45:56,39788.93,63869.0300000003
"1748",2017-02-21 00:11:22,22960.18,86829.2100000003
"1749",2017-02-21 00:11:22,26159.22,112988.43
"1750",2017-02-21 00:11:22,-63869.03,49119.4000000003
"1751",2017-02-21 00:31:28,37921.71,87041.1100000003
"1752",2017-02-21 00:31:28,-49119.4,37921.7100000003
"1753",2017-02-21 00:36:03,-37921.71,2.7648638933897e-10
"1754",2017-02-21 04:39:27,83294.11,83294.1100000003
"1755",2017-02-21 04:45:22,83437.02,166731.13
"1756",2017-02-21 04:45:22,-83294.11,83437.0200000003
"1757",2017-02-21 05:36:04,-83437.02,2.91038304567337e-10
"1758",2017-02-21 06:17:14,38152.8,38152.8000000003
"1759",2017-02-21 06:17:14,43922.6,82075.4000000003
"1760",2017-02-21 06:24:51,-82075.4,2.91038304567337e-10
"1761",2017-02-21 09:06:56,29324.16,29324.1600000003
"1762",2017-02-21 09:14:22,-29324.16,2.91038304567337e-10
"1763",2017-02-21 12:44:41,60750.21,60750.2100000003
"1764",2017-02-21 12:51:54,-60750.21,2.91038304567337e-10
"1765",2017-02-21 16:25:42,30130.08,30130.0800000003
"1766",2017-02-21 16:47:15,25235.01,55365.0900000003
"1767",2017-02-21 16:49:32,-30130.08,25235.0100000003
"1768",2017-02-21 18:08:18,-25235.01,2.87400325760245e-10
"1769",2017-02-21 18:08:18,42072.29,42072.2900000003
"1770",2017-02-21 18:13:13,-42072.29,2.83762346953154e-10
"1771",2017-02-23 18:31:19,40235.05,40235.0500000003
"1772",2017-02-23 18:49:46,-40235.05,2.83762346953154e-10
"1773",2017-02-23 22:35:22,22430.25,22430.2500000003
"1774",2017-02-23 22:48:36,-22430.25,2.83762346953154e-10
"1775",2017-02-23 23:36:40,29597.01,29597.0100000003
"1776",2017-02-24 00:12:31,-29597.01,2.83762346953154e-10
"1777",2017-02-24 00:28:44,23260.81,23260.8100000003
"1778",2017-02-24 02:13:41,26871.17,50131.9800000003
"1779",2017-02-24 02:13:41,28564.38,78696.3600000003
"1780",2017-02-24 02:13:41,-23260.81,55435.5500000003
"1781",2017-02-24 02:13:41,-23260.81,32174.7400000003
"1782",2017-02-24 02:13:41,-23260.81,8913.93000000029
"1783",2017-02-24 02:18:44,-8913.93,2.91038304567337e-10
"1784",2017-02-24 02:39:17,24774.61,24774.6100000003
"1785",2017-02-24 02:55:10,-24774.61,2.91038304567337e-10
"1786",2017-02-24 03:20:37,29991.48,29991.4800000003
"1787",2017-02-24 03:24:52,-29991.48,2.91038304567337e-10
"1788",2017-02-24 04:10:08,22888.05,22888.0500000003
"1789",2017-02-24 04:11:35,49096.66,71984.7100000003
"1790",2017-02-24 04:18:15,-71984.71,2.91038304567337e-10
"1791",2017-02-24 04:27:35,23779.12,23779.1200000003
"1792",2017-02-24 04:39:42,-23779.12,2.91038304567337e-10
"1793",2017-02-24 06:28:02,23634.76,23634.7600000003
"1794",2017-02-24 06:38:04,-23634.76,2.91038304567337e-10
"1795",2017-02-24 07:58:15,22905.84,22905.8400000003
"1796",2017-02-24 08:00:58,-22905.84,2.91038304567337e-10
"1797",2017-02-24 20:30:54,23325.91,23325.9100000003
"1798",2017-02-24 21:18:04,-23325.91,2.91038304567337e-10
"1799",2017-02-24 23:48:18,26951.04,26951.0400000003
"1800",2017-02-24 23:48:18,41974.62,68925.6600000003
"1801",2017-02-24 23:48:18,77799.74,146725.4
"1802",2017-02-24 23:53:14,-146725.4,3.20142135024071e-10
"1803",2017-02-28 03:53:11,23882.79,23882.7900000003
"1804",2017-02-28 03:53:11,26803.75,50686.5400000003
"1805",2017-02-28 03:53:11,77799.81,128486.35
"1806",2017-02-28 03:53:11,88910.82,217397.17
"1807",2017-02-28 09:04:52,-217397.17,3.20142135024071e-10
"1808",2017-02-28 13:02:55,26069.75,26069.7500000003
"1809",2017-02-28 13:03:12,24011.19,50080.9400000003
"1810",2017-02-28 19:56:30,26786.89,76867.8300000003
"1811",2017-02-28 19:56:30,25508.51,102376.34
"1812",2017-02-28 19:56:30,33796.97,136173.31
"1813",2017-02-28 19:56:30,88910.88,225084.19
"1814",2017-02-28 22:03:40,26952.75,252036.94
"1815",2017-03-01 00:00:11,23545.15,275582.09
"1816",2017-03-01 00:54:34,-217397.17,58184.9200000003
"1817",2017-03-01 01:31:37,29963.07,88147.9900000003
"1818",2017-03-01 01:31:37,28991.39,117139.38
"1819",2017-03-01 02:54:45,-117139.38,3.05590219795704e-10
"1820",2017-03-01 03:14:26,33240.11,33240.1100000003
"1821",2017-03-01 03:24:08,-33240.11,3.05590219795704e-10
"1822",2017-03-01 04:30:57,23015.77,23015.7700000003
"1823",2017-03-01 06:25:54,-23015.77,3.05590219795704e-10
"1824",2017-03-01 12:37:27,22898.95,22898.9500000003
"1825",2017-03-01 12:37:27,41421.76,64320.7100000003
"1826",2017-03-01 13:03:25,-50080.94,14239.7700000003
"1827",2017-03-01 14:10:29,29722.87,43962.6400000003
"1828",2017-03-01 14:43:35,-14239.77,29722.8700000003
"1829",2017-03-01 14:43:35,-14239.77,15483.1000000003
"1830",2017-03-01 14:43:35,-14239.77,1243.3300000003
"1831",2017-03-01 14:59:21,29982.12,31225.4500000003
"1832",2017-03-01 14:59:21,-14239.77,16985.6800000003
"1833",2017-03-01 14:59:21,-14239.77,2745.9100000003
"1834",2017-03-01 15:42:15,28893.64,31639.5500000003
"1835",2017-03-01 16:24:34,-1243.33,30396.2200000003
"1836",2017-03-01 16:24:34,-2745.91,27650.3100000003
"1837",2017-03-01 16:24:34,-2745.91,24904.4000000003
"1838",2017-03-01 16:40:19,-2745.91,22158.4900000003
"1839",2017-03-01 16:40:19,-2745.91,19412.5800000003
"1840",2017-03-01 20:10:04,25801.1,45213.6800000003
"1841",2017-03-01 20:10:04,24254.35,69468.0300000003
"1842",2017-03-01 20:10:04,28544.87,98012.9000000003
"1843",2017-03-01 20:10:04,-31639.55,66373.3500000003
"1844",2017-03-01 20:10:04,-31639.55,34733.8000000003
"1845",2017-03-01 20:25:20,77800.05,112533.85
"1846",2017-03-01 20:25:20,-31639.55,80894.3000000003
"1847",2017-03-01 20:25:20,-31639.55,49254.7500000003
"1848",2017-03-01 21:05:58,-31639.55,17615.2000000003
"1849",2017-03-01 21:29:18,58226.13,75841.3300000003
"1850",2017-03-01 21:42:07,-24904.4,50936.9300000003
"1851",2017-03-01 22:11:37,43003.99,93940.9200000003
"1852",2017-03-01 22:18:00,-50080.94,43859.9800000003
"1853",2017-03-01 22:20:13,-24904.4,18955.5800000003
"1854",2017-03-02 01:32:09,21268.28,40223.8600000003
"1855",2017-03-02 03:21:43,-19412.58,20811.2800000003
"1856",2017-03-02 03:21:43,-19412.58,1398.70000000027
"1857",2017-03-02 04:53:43,-1398.7,2.66254573944025e-10
"1858",2017-03-02 09:51:16,11873.58,11873.5800000003
"1859",2017-03-02 09:51:16,14919.78,26793.3600000003
"1860",2017-03-02 10:19:04,-26793.36,2.65572452917695e-10
"1861",2017-03-02 12:33:33,8831.67,8831.67000000027
"1862",2017-03-02 12:43:26,-8831.67,2.65572452917695e-10
"1863",2017-03-02 13:28:34,13875.8,13875.8000000003
"1864",2017-03-02 13:30:49,-13875.8,2.65572452917695e-10
"1865",2017-03-02 13:34:57,10549.34,10549.3400000003
"1866",2017-03-02 13:41:07,-10549.34,2.65572452917695e-10
"1867",2017-03-02 13:54:21,8564.17,8564.17000000027
"1868",2017-03-02 14:02:34,-8564.17,2.65572452917695e-10
"1869",2017-03-02 14:09:35,30023.17,30023.1700000003
"1870",2017-03-02 14:29:36,-30023.17,2.65572452917695e-10
"1871",2017-03-02 15:06:38,30023.18,30023.1800000003
"1872",2017-03-02 15:53:05,-30023.18,2.65572452917695e-10
"1873",2017-03-02 16:31:50,8911.2,8911.20000000027
"1874",2017-03-02 16:38:20,-8911.2,2.65572452917695e-10
"1875",2017-03-02 16:38:20,18911.19,18911.1900000003
"1876",2017-03-02 16:38:20,30023.21,48934.4000000003
"1877",2017-03-02 16:45:39,-48934.4,2.61934474110603e-10
"1878",2017-03-02 16:54:23,30023.22,30023.2200000003
"1879",2017-03-02 17:35:06,30023.23,60046.4500000003
"1880",2017-03-02 17:40:22,-30023.22,30023.2300000003
"1881",2017-03-02 17:40:22,-30023.22,0.0100000002566958
"1882",2017-03-02 17:46:01,30023.24,30023.2500000003
"1883",2017-03-02 17:51:50,-30023.25,2.58296495303512e-10
"1884",2017-03-02 18:01:32,22143.95,22143.9500000003
"1885",2017-03-02 18:01:32,21351.81,43495.7600000003
"1886",2017-03-02 18:01:32,30023.27,73519.0300000003
"1887",2017-03-02 18:14:44,-73519.03,2.61934474110603e-10
"1888",2017-03-02 19:32:54,24315.02,24315.0200000003
"1889",2017-03-02 19:32:54,30341.03,54656.0500000003
"1890",2017-03-02 19:32:54,22618.04,77274.0900000003
"1891",2017-03-02 19:32:54,30023.32,107297.41
"1892",2017-03-02 20:02:19,22886.03,130183.44
"1893",2017-03-02 20:02:19,-107297.41,22886.0300000003
"1894",2017-03-02 20:10:54,-22886.03,2.61934474110603e-10
"1895",2017-03-02 20:53:06,23785.15,23785.1500000003
"1896",2017-03-02 20:53:06,77800.35,101585.5
"1897",2017-03-02 21:13:48,-101585.5,2.61934474110603e-10
"1898",2017-03-02 21:36:58,23157.98,23157.9800000003
"1899",2017-03-02 21:36:58,39672.2,62830.1800000003
"1900",2017-03-02 21:41:29,77800.38,140630.56
"1901",2017-03-02 21:41:29,-101585.5,39045.0600000003
"1902",2017-03-02 21:47:33,34994.42,74039.4800000003
"1903",2017-03-02 21:47:33,-39045.06,34994.4200000003
"1904",2017-03-02 22:05:03,-34994.42,2.61934474110603e-10
"1905",2017-03-02 22:05:03,49145.6,49145.6000000003
"1906",2017-03-02 22:05:03,23590.05,72735.6500000003
"1907",2017-03-02 22:09:52,-72735.65,2.61934474110603e-10
"1908",2017-03-02 22:34:24,31804.06,31804.0600000003
"1909",2017-03-02 22:34:24,77800.44,109604.5
"1910",2017-03-02 22:34:24,25678.42,135282.92
"1911",2017-03-02 22:40:41,-135282.92,2.61934474110603e-10
"1912",2017-03-03 01:41:32,24001.13,24001.1300000003
"1913",2017-03-03 01:41:32,26931.9,50933.0300000003
"1914",2017-03-03 01:56:38,-50933.03,2.61934474110603e-10
"1915",2017-03-03 02:30:18,31316.02,31316.0200000003
"1916",2017-03-03 02:30:18,27928.37,59244.3900000003
"1917",2017-03-03 02:44:36,48090.1,107334.49
"1918",2017-03-03 02:44:36,-59244.39,48090.1000000003
"1919",2017-03-03 02:51:26,-48090.1,2.5465851649642e-10
"1920",2017-03-03 03:50:55,28577.13,28577.1300000003
"1921",2017-03-03 04:04:31,-28577.13,2.5465851649642e-10
"1922",2017-03-03 06:32:21,43959.03,43959.0300000003
"1923",2017-03-03 06:55:05,-43959.03,2.5465851649642e-10
"1924",2017-03-03 08:22:57,27601.54,27601.5400000003
"1925",2017-03-03 08:22:57,23295.5,50897.0400000003
"1926",2017-03-03 08:42:59,-50897.04,2.5465851649642e-10
"1927",2017-03-03 09:18:32,32078.43,32078.4300000003
"1928",2017-03-03 09:26:19,26099.17,58177.6000000003
"1929",2017-03-03 09:26:19,-32078.43,26099.1700000003
"1930",2017-03-03 10:10:39,23604.91,49704.0800000002
"1931",2017-03-03 10:10:39,-26099.17,23604.9100000003
"1932",2017-03-03 10:20:14,-23604.91,2.51020537689328e-10
"1933",2017-03-03 10:32:08,28103.47,28103.4700000003
"1934",2017-03-03 10:35:34,-28103.47,2.51020537689328e-10
"1935",2017-03-03 14:58:52,37433.92,37433.9200000002
"1936",2017-03-03 14:58:52,47972.35,85406.2700000003
"1937",2017-03-03 15:29:13,59142.83,144549.1
"1938",2017-03-03 15:29:13,41512.66,186061.76
"1939",2017-03-03 15:29:13,-85406.27,100655.49
"1940",2017-03-03 15:29:13,-85406.27,15249.2200000003
"1941",2017-03-03 15:35:56,-15249.22,2.63753463514149e-10
"1942",2017-03-03 16:07:01,49520.72,49520.7200000003
"1943",2017-03-03 16:27:45,34027.36,83548.0800000003
"1944",2017-03-03 16:27:45,-49520.72,34027.3600000003
"1945",2017-03-03 16:31:44,-34027.36,2.61934474110603e-10
"1946",2017-03-03 16:45:59,59107.25,59107.2500000003
"1947",2017-03-03 16:53:53,-59107.25,2.61934474110603e-10
"1948",2017-03-03 18:08:31,36477.33,36477.3300000003
"1949",2017-03-03 18:08:31,63437.62,99914.9500000003
"1950",2017-03-03 18:10:52,-99914.95,2.7648638933897e-10
"1951",2017-03-03 20:05:28,13025.07,13025.0700000003
"1952",2017-03-03 20:07:54,-13025.07,2.7648638933897e-10
"1953",2017-03-03 20:23:17,49501.26,49501.2600000003
"1954",2017-03-03 20:23:17,77802.06,127303.32
"1955",2017-03-03 20:37:01,-127303.32,2.61934474110603e-10
"1956",2017-03-03 21:24:56,43051.2,43051.2000000003
"1957",2017-03-03 21:34:39,-43051.2,2.61934474110603e-10
"1958",2017-03-03 22:09:33,33976.85,33976.8500000003
"1959",2017-03-03 22:27:53,-33976.85,2.61934474110603e-10
"1960",2017-03-03 22:55:21,22519.7,22519.7000000003
"1961",2017-03-03 23:15:38,-22519.7,2.61934474110603e-10
"1962",2017-03-04 00:47:47,36082.24,36082.2400000003
"1963",2017-03-04 00:56:06,-36082.24,2.61934474110603e-10
"1964",2017-03-04 01:03:08,13259.2,13259.2000000003
"1965",2017-03-04 01:10:47,-13259.2,2.61934474110603e-10
"1966",2017-03-04 02:00:24,16230.5,16230.5000000003
"1967",2017-03-04 02:13:38,-16230.5,2.61934474110603e-10
"1968",2017-03-04 07:19:34,28614.4,28614.4000000003
"1969",2017-03-04 08:10:37,-28614.4,2.61934474110603e-10
"1970",2017-03-04 09:55:04,37397.08,37397.0800000003
"1971",2017-03-04 09:57:34,-37397.08,2.61934474110603e-10
"1972",2017-03-04 10:49:35,34122.14,34122.1400000003
"1973",2017-03-04 10:54:45,-34122.14,2.61934474110603e-10
"1974",2017-03-04 12:08:34,44839.04,44839.0400000003
"1975",2017-03-04 12:12:45,-44839.04,2.61934474110603e-10
"1976",2017-03-04 13:14:41,34397.49,34397.4900000003
"1977",2017-03-04 13:18:04,-34397.49,2.61934474110603e-10
"1978",2017-03-04 15:22:36,32049.05,32049.0500000003
"1979",2017-03-04 15:40:06,-32049.05,2.61934474110603e-10
"1980",2017-03-04 16:39:00,55598.14,55598.1400000003
"1981",2017-03-04 16:39:00,36270.47,91868.6100000003
"1982",2017-03-04 16:44:41,-91868.61,2.61934474110603e-10
"1983",2017-03-05 00:14:22,33917.57,33917.5700000003
"1984",2017-03-05 00:20:24,-33917.57,2.61934474110603e-10
"1985",2017-03-05 00:28:07,34334.77,34334.7700000003
"1986",2017-03-05 01:05:36,-34334.77,2.61934474110603e-10
"1987",2017-03-05 09:23:44,42963.38,42963.3800000003
"1988",2017-03-05 09:23:44,88219.08,131182.46
"1989",2017-03-05 09:27:44,-131182.46,2.61934474110603e-10
"1990",2017-03-05 10:34:35,36543.45,36543.4500000003
"1991",2017-03-05 10:40:21,-36543.45,2.61934474110603e-10
"1992",2017-03-05 19:20:12,37850.26,37850.2600000003
"1993",2017-03-05 19:20:12,35492.43,73342.6900000003
"1994",2017-03-05 19:22:48,-73342.69,2.61934474110603e-10
"1995",2017-03-05 20:05:14,48192.83,48192.8300000003
"1996",2017-03-05 20:10:20,-48192.83,2.61934474110603e-10
"1997",2017-03-06 01:29:11,32666.1,32666.1000000003
"1998",2017-03-06 01:54:07,-32666.1,2.61934474110603e-10
"1999",2017-03-06 03:50:08,29256.48,29256.4800000003
"2000",2017-03-06 04:09:17,-29256.48,2.61934474110603e-10
"2001",2017-03-06 08:10:48,31257.43,31257.4300000003
"2002",2017-03-06 08:17:16,-31257.43,2.61934474110603e-10
"2003",2017-03-06 21:39:26,32646.67,32646.6700000003
"2004",2017-03-06 21:49:54,-32646.67,2.61934474110603e-10
"2005",2017-03-06 23:26:19,31611.4,31611.4000000003
"2006",2017-03-06 23:30:49,-31611.4,2.61934474110603e-10
"2007",2017-03-07 01:58:31,30549.95,30549.9500000003
"2008",2017-03-07 02:15:42,-30549.95,2.61934474110603e-10
"2009",2017-03-07 07:11:16,29372.91,29372.9100000003
"2010",2017-03-07 07:11:16,30720.59,60093.5000000003
"2011",2017-03-07 07:37:55,-60093.5,2.61934474110603e-10
"2012",2017-03-07 08:13:13,30730.07,30730.0700000003
"2013",2017-03-07 08:36:07,-30730.07,2.61934474110603e-10
"2014",2017-03-07 08:55:02,32694.16,32694.1600000003
"2015",2017-03-07 09:04:43,-32694.16,2.61934474110603e-10
"2016",2017-03-07 09:36:38,59531.34,59531.3400000003
"2017",2017-03-07 09:46:25,35097.9,94629.2400000003
"2018",2017-03-07 09:46:25,29558.08,124187.32
"2019",2017-03-07 09:46:25,-59531.34,64655.9800000003
"2020",2017-03-07 10:04:53,-64655.98,2.5465851649642e-10
"2021",2017-03-07 13:09:33,123534.48,123534.48
"2022",2017-03-07 13:31:43,-123534.48,2.47382558882236e-10
"2023",2017-03-07 15:08:32,50027.66,50027.6600000003
"2024",2017-03-07 15:08:32,29182.04,79209.7000000002
"2025",2017-03-07 15:17:23,-79209.7,2.47382558882236e-10
"2026",2017-03-07 16:07:59,30569.17,30569.1700000002
"2027",2017-03-07 16:32:43,33563.04,64132.2100000002
"2028",2017-03-07 16:32:43,-30569.17,33563.0400000002
"2029",2017-03-07 16:32:43,44291.96,77855.0000000002
"2030",2017-03-07 16:32:43,-30569.17,47285.8300000002
"2031",2017-03-07 16:40:51,-47285.83,2.47382558882236e-10
"2032",2017-03-07 17:19:13,32750.26,32750.2600000002
"2033",2017-03-07 17:25:11,30912.99,63663.2500000002
"2034",2017-03-07 17:25:11,-32750.26,30912.9900000002
"2035",2017-03-07 17:29:53,-30912.99,2.47382558882236e-10
"2036",2017-03-07 17:36:37,53884.8,53884.8000000003
"2037",2017-03-07 17:41:06,-53884.8,2.47382558882236e-10
"2038",2017-03-07 19:13:56,30609.77,30609.7700000002
"2039",2017-03-07 19:35:10,-30609.77,2.47382558882236e-10
"2040",2017-03-07 19:42:39,31831.97,31831.9700000002
"2041",2017-03-07 19:53:05,31396.49,63228.4600000003
"2042",2017-03-07 19:53:05,-31831.97,31396.4900000003
"2043",2017-03-07 20:18:15,-31396.49,2.51020537689328e-10
"2044",2017-03-07 21:10:51,29442.08,29442.0800000003
"2045",2017-03-07 21:40:46,57076.93,86519.0100000003
"2046",2017-03-07 21:40:46,-29442.08,57076.9300000003
"2047",2017-03-07 21:48:09,52945.98,110022.91
"2048",2017-03-07 21:48:09,-57076.93,52945.9800000003
"2049",2017-03-07 21:55:54,-52945.98,2.61934474110603e-10
"2050",2017-03-07 22:33:34,31964.97,31964.9700000003
"2051",2017-03-07 22:36:47,-31964.97,2.61934474110603e-10
"2052",2017-03-07 23:26:11,32922.65,32922.6500000003
"2053",2017-03-07 23:33:59,-32922.65,2.61934474110603e-10
"2054",2017-03-07 23:47:19,29822.51,29822.5100000003
"2055",2017-03-07 23:59:30,-29822.51,2.61934474110603e-10
"2056",2017-03-08 07:55:05,29204.48,29204.4800000003
"2057",2017-03-08 08:01:20,30585.97,59790.4500000003
"2058",2017-03-08 08:21:31,30985.53,90775.9800000003
"2059",2017-03-08 08:21:31,52340.16,143116.14
"2060",2017-03-08 08:39:45,34160.91,177277.05
"2061",2017-03-08 08:39:45,33857.68,211134.73
"2062",2017-03-08 08:54:39,-59790.45,151344.28
"2063",2017-03-08 08:54:39,-29204.48,122139.8
"2064",2017-03-08 08:54:39,-59790.45,62349.3500000003
"2065",2017-03-08 09:01:35,-62349.35,2.69210431724787e-10
"2066",2017-03-08 10:19:33,88916.14,88916.1400000003
"2067",2017-03-08 10:38:03,15028.51,103944.65
"2068",2017-03-08 10:38:03,-88916.14,15028.5100000003
"2069",2017-03-08 11:30:22,100755.24,115783.75
"2070",2017-03-08 11:30:22,-15028.51,100755.24
"2071",2017-03-08 11:35:09,-100755.24,2.7648638933897e-10
"2072",2017-03-08 12:15:18,70028.55,70028.5500000003
"2073",2017-03-08 12:15:18,29816.97,99845.5200000003
"2074",2017-03-08 12:24:57,-99845.52,2.7648638933897e-10
"2075",2017-03-08 13:16:45,74276.16,74276.1600000003
"2076",2017-03-08 13:23:09,-74276.16,2.7648638933897e-10
"2077",2017-03-08 15:25:38,33333.04,33333.0400000003
"2078",2017-03-08 15:25:38,70028.58,103361.62
"2079",2017-03-08 15:44:28,-103361.62,2.91038304567337e-10
"2080",2017-03-08 19:10:52,88917.8,88917.8000000003
"2081",2017-03-08 19:10:52,72143.56,161061.36
"2082",2017-03-08 19:10:52,52340.16,213401.52
"2083",2017-03-08 19:10:52,33857.68,247259.2
"2084",2017-03-08 19:21:17,70029.81,317289.01
"2085",2017-03-08 19:21:17,-247259.2,70029.8100000002
"2086",2017-03-08 19:30:42,-70029.81,2.3283064365387e-10
"2087",2017-03-09 01:06:31,42473.48,42473.4800000002
"2088",2017-03-09 01:06:31,38128.72,80602.2000000002
"2089",2017-03-09 01:11:31,-80602.2,2.47382558882236e-10
"2090",2017-03-09 03:10:00,18029.89,18029.8900000002
"2091",2017-03-09 03:34:02,17029.88,35059.7700000003
"2092",2017-03-09 03:34:02,-18029.89,17029.8800000003
"2093",2017-03-09 03:44:49,-17029.88,2.51020537689328e-10
"2094",2017-03-09 08:51:24,8029.93,8029.93000000025
"2095",2017-03-09 08:51:24,7029.92,15059.8500000003
"2096",2017-03-09 08:51:24,70029.86,85089.7100000003
"2097",2017-03-09 08:51:24,75029.87,160119.58
"2098",2017-03-09 08:51:24,29204.48,189324.06
"2099",2017-03-09 08:51:24,32585.43,221909.49
"2100",2017-03-09 08:51:24,32585.43,254494.92
"2101",2017-03-09 08:51:24,13029.94,267524.86
"2102",2017-03-09 09:00:17,-267524.86,2.3283064365387e-10
"2103",2017-03-09 17:24:28,10029.91,10029.9100000002
"2104",2017-03-09 17:34:41,-10029.91,2.3283064365387e-10
"2105",2017-03-09 18:06:52,10029.9,10029.9000000002
"2106",2017-03-09 18:15:30,-10029.9,2.3283064365387e-10
"2107",2017-03-09 21:06:10,80029.95,80029.9500000002
"2108",2017-03-09 21:21:21,70029.96,150059.91
"2109",2017-03-09 21:21:21,-80029.95,70029.9600000002
"2110",2017-03-09 21:38:16,-70029.96,2.3283064365387e-10
"2111",2017-03-10 13:28:38,33071.45,33071.4500000002
"2112",2017-03-10 13:34:22,-33071.45,2.3283064365387e-10
"2113",2017-03-10 17:53:06,38064.3,38064.3000000002
"2114",2017-03-10 18:01:28,46854.67,84918.9700000002
"2115",2017-03-10 18:01:28,-38064.3,46854.6700000002
"2116",2017-03-10 18:05:15,-46854.67,2.3283064365387e-10
"2117",2017-03-10 18:35:29,41816.87,41816.8700000002
"2118",2017-03-10 19:10:13,32520.93,74337.8000000002
"2119",2017-03-10 19:11:24,-41816.87,32520.9300000002
"2120",2017-03-10 19:27:14,41458.85,73979.7800000002
"2121",2017-03-10 19:27:14,-32520.93,41458.8500000002
"2122",2017-03-10 19:27:14,-32520.93,8937.92000000023
"2123",2017-03-10 19:32:29,57011.74,65949.6600000002
"2124",2017-03-10 19:32:29,-8937.92,57011.7400000002
"2125",2017-03-10 19:35:50,-57011.74,2.40106601268053e-10
"2126",2017-03-10 19:58:17,30030.06,30030.0600000002
"2127",2017-03-10 19:58:17,12001.04,42031.1000000002
"2128",2017-03-10 19:58:17,2128.34,44159.4400000002
"2129",2017-03-10 20:09:00,-44159.44,2.3283064365387e-10
"2130",2017-03-10 20:09:00,38918.07,38918.0700000002
"2131",2017-03-10 20:09:00,30030.08,68948.1500000002
"2132",2017-03-10 20:17:11,-68948.15,2.3283064365387e-10
"2133",2017-03-10 21:14:51,22133.28,22133.2800000002
"2134",2017-03-10 21:14:51,32619.62,54752.9000000002
"2135",2017-03-10 21:30:22,-54752.9,2.25554686039686e-10
"2136",2017-03-10 22:22:57,6016.24,6016.24000000023
"2137",2017-03-10 22:37:36,-6016.24,2.25554686039686e-10
"2138",2017-03-11 03:03:21,26249.67,26249.6700000002
"2139",2017-03-11 03:03:21,30870.03,57119.7000000002
"2140",2017-03-11 03:36:03,-57119.7,2.25554686039686e-10
"2141",2017-03-11 09:58:07,8656.65,8656.65000000023
"2142",2017-03-11 10:45:47,-8656.65,2.25554686039686e-10
"2143",2017-03-11 14:05:24,31572.03,31572.0300000002
"2144",2017-03-11 14:05:24,24965.86,56537.8900000002
"2145",2017-03-11 14:09:08,-56537.89,2.25554686039686e-10
"2146",2017-03-11 15:13:27,25544.23,25544.2300000002
"2147",2017-03-11 15:30:42,41784.38,67328.6100000002
"2148",2017-03-11 15:30:42,-25544.23,41784.3800000002
"2149",2017-03-11 15:42:40,-41784.38,2.25554686039686e-10
"2150",2017-03-12 13:53:56,8708.45,8708.45000000023
"2151",2017-03-12 14:07:58,13835.48,22543.9300000002
"2152",2017-03-12 14:07:58,-8708.45,13835.4800000002
"2153",2017-03-12 14:10:37,-13835.48,2.25554686039686e-10
"2154",2017-03-12 16:19:16,11237.55,11237.5500000002
"2155",2017-03-12 16:31:23,23511.08,34748.6300000002
"2156",2017-03-12 16:31:23,-11237.55,23511.0800000002
"2157",2017-03-12 17:06:06,8600.79,32111.8700000002
"2158",2017-03-12 17:06:06,-23511.08,8600.79000000022
"2159",2017-03-12 17:57:40,-8600.79,2.21916707232594e-10
"2160",2017-03-12 18:11:10,30175.15,30175.1500000002
"2161",2017-03-12 18:54:44,51033.41,81208.5600000002
"2162",2017-03-12 19:30:21,28326.45,109535.01
"2163",2017-03-12 19:42:30,-109535.01,2.3283064365387e-10
"2164",2017-03-13 00:06:59,32825.67,32825.6700000002
"2165",2017-03-13 00:26:33,-32825.67,2.3283064365387e-10
"2166",2017-03-13 00:49:41,34371.16,34371.1600000002
"2167",2017-03-13 00:52:51,57952.24,92323.4000000002
"2168",2017-03-13 00:52:51,-34371.16,57952.2400000002
"2169",2017-03-13 01:09:49,22442.71,80394.9500000002
"2170",2017-03-13 01:09:49,-57952.24,22442.7100000002
"2171",2017-03-13 01:27:12,-22442.71,2.18278728425503e-10
"2172",2017-03-13 04:22:05,30505.04,30505.0400000002
"2173",2017-03-13 04:30:51,-30505.04,2.18278728425503e-10
"2174",2017-03-13 06:16:28,74268.14,74268.1400000002
"2175",2017-03-13 06:28:03,-74268.14,2.18278728425503e-10
"2176",2017-03-13 06:53:03,30030.52,30030.5200000002
"2177",2017-03-13 06:59:09,-30030.52,2.18278728425503e-10
"2178",2017-03-13 07:01:28,30030.54,30030.5400000002
"2179",2017-03-13 07:10:25,-30030.54,2.18278728425503e-10
"2180",2017-03-13 07:26:13,12709.3,12709.3000000002
"2181",2017-03-13 07:26:13,30030.56,42739.8600000002
"2182",2017-03-13 07:36:32,-42739.86,2.18278728425503e-10
"2183",2017-03-13 08:00:41,8038.03,8038.03000000022
"2184",2017-03-13 08:11:55,-8038.03,2.18278728425503e-10
"2185",2017-03-13 09:13:38,30030.6,30030.6000000002
"2186",2017-03-13 09:13:38,11512.84,41543.4400000002
"2187",2017-03-13 09:53:17,-41543.44,2.18278728425503e-10
"2188",2017-03-13 10:48:25,37807.62,37807.6200000002
"2189",2017-03-13 10:48:25,7807.59,45615.2100000002
"2190",2017-03-13 11:18:51,-45615.21,2.25554686039686e-10
"2191",2017-03-13 12:01:08,30030.61,30030.6100000002
"2192",2017-03-13 12:15:22,9883.2,39913.8100000002
"2193",2017-03-13 12:15:22,50030.64,89944.4500000002
"2194",2017-03-13 12:15:22,30030.61,119975.06
"2195",2017-03-13 12:15:22,15030.65,135005.71
"2196",2017-03-13 12:15:22,-30030.61,104975.1
"2197",2017-03-13 12:33:44,-104975.1,2.18278728425503e-10
"2198",2017-03-13 13:53:22,30030.61,30030.6100000002
"2199",2017-03-13 14:44:48,-30030.61,2.18278728425503e-10
"2200",2017-03-13 15:04:17,29439.91,29439.9100000002
"2201",2017-03-13 15:13:32,23135.16,52575.0700000002
"2202",2017-03-13 15:13:32,-29439.91,23135.1600000002
"2203",2017-03-13 16:00:16,-23135.16,2.18278728425503e-10
"2204",2017-03-13 18:19:55,22842.54,22842.5400000002
"2205",2017-03-13 18:30:33,-22842.54,2.18278728425503e-10
"2206",2017-03-13 18:52:31,70030.83,70030.8300000002
"2207",2017-03-13 18:52:31,46873.31,116904.14
"2208",2017-03-13 18:57:36,-116904.14,2.18278728425503e-10
"2209",2017-03-13 19:24:46,24422.6,24422.6000000002
"2210",2017-03-13 19:24:46,43971.6,68394.2000000002
"2211",2017-03-13 19:43:21,77807.86,146202.06
"2212",2017-03-13 19:43:21,-68394.2,77807.8600000002
"2213",2017-03-13 19:55:15,23297.32,101105.18
"2214",2017-03-13 19:55:15,-77807.86,23297.3200000002
"2215",2017-03-13 20:03:29,22410.41,45707.7300000002
"2216",2017-03-13 20:03:29,-23297.32,22410.4100000002
"2217",2017-03-13 20:09:50,25625.1,48035.5100000002
"2218",2017-03-13 20:09:50,-22410.41,25625.1000000002
"2219",2017-03-13 20:27:20,-25625.1,2.29192664846778e-10
"2220",2017-03-13 21:01:23,25810.2,25810.2000000002
"2221",2017-03-13 21:01:23,23976.53,49786.7300000002
"2222",2017-03-13 21:08:50,-49786.73,2.25554686039686e-10
"2223",2017-03-13 21:14:00,30864.24,30864.2400000002
"2224",2017-03-13 21:15:34,-30864.24,2.25554686039686e-10
"2225",2017-03-14 00:46:25,27076.97,27076.9700000002
"2226",2017-03-14 00:56:56,-27076.97,2.25554686039686e-10
"2227",2017-03-14 01:15:24,26945.41,26945.4100000002
"2228",2017-03-14 01:15:24,30031.57,56976.9800000002
"2229",2017-03-14 01:19:14,-56976.98,2.25554686039686e-10
"2230",2017-03-14 01:53:24,33457.84,33457.8400000002
"2231",2017-03-14 01:59:52,-33457.84,2.25554686039686e-10
"2232",2017-03-14 02:22:49,23360.04,23360.0400000002
"2233",2017-03-14 02:31:06,-23360.04,2.25554686039686e-10
"2234",2017-03-14 05:43:19,7809.31,7809.31000000023
"2235",2017-03-14 05:43:19,7809.3,15618.6100000002
"2236",2017-03-14 05:43:19,7809.27,23427.8800000002
"2237",2017-03-14 06:02:38,-23427.88,2.25554686039686e-10
"2238",2017-03-14 06:02:38,7809.23,7809.23000000023
"2239",2017-03-14 06:02:38,13809.24,21618.4700000002
"2240",2017-03-14 06:16:38,-21618.47,2.25554686039686e-10
"2241",2017-03-14 10:38:13,25336.98,25336.9800000002
"2242",2017-03-14 10:42:53,29970.44,55307.4200000002
"2243",2017-03-14 10:42:53,-25336.98,29970.4400000002
"2244",2017-03-14 11:32:42,35008.77,64979.2100000002
"2245",2017-03-14 11:32:42,-29970.44,35008.7700000002
"2246",2017-03-14 11:32:42,-29970.44,5038.33000000022
"2247",2017-03-14 11:32:42,59662.91,64701.2400000002
"2248",2017-03-14 11:54:58,-64701.24,2.25554686039686e-10
"2249",2017-03-14 12:24:26,35593.82,35593.8200000002
"2250",2017-03-14 12:43:56,-35593.82,2.25554686039686e-10
"2251",2017-03-14 12:48:49,23873.98,23873.9800000002
"2252",2017-03-14 12:57:26,-23873.98,2.25554686039686e-10
"2253",2017-03-14 21:55:36,23814.71,23814.7100000002
"2254",2017-03-14 21:55:36,23737.97,47552.6800000002
"2255",2017-03-14 22:04:46,-47552.68,2.25554686039686e-10
"2256",2017-03-15 11:40:46,25404.51,25404.5100000002
"2257",2017-03-15 11:46:37,-25404.51,2.25554686039686e-10
"2258",2017-03-15 12:09:11,30452.49,30452.4900000002
"2259",2017-03-15 12:48:27,31226.86,61679.3500000002
"2260",2017-03-15 12:48:27,-30452.49,31226.8600000002
"2261",2017-03-15 12:48:27,-30452.49,774.370000000221
"2262",2017-03-15 13:10:10,-774.37,2.208935256931e-10
"2263",2017-03-15 13:10:10,36399.96,36399.9600000002
"2264",2017-03-15 13:10:10,45049.15,81449.1100000002
"2265",2017-03-15 13:40:48,27445.72,108894.83
"2266",2017-03-15 13:40:48,44647.44,153542.27
"2267",2017-03-15 13:40:48,-774.37,152767.9
"2268",2017-03-15 13:40:48,-81449.11,71318.7900000002
"2269",2017-03-15 13:45:41,-71318.79,2.3283064365387e-10
"2270",2017-03-15 13:52:05,38441.92,38441.9200000002
"2271",2017-03-15 13:52:05,16882.95,55324.8700000002
"2272",2017-03-15 13:52:05,25119.35,80444.2200000002
"2273",2017-03-15 13:56:41,-80444.22,2.3283064365387e-10
"2274",2017-03-15 14:08:35,30033.36,30033.3600000002
"2275",2017-03-15 14:31:36,20783.2,50816.5600000002
"2276",2017-03-15 14:31:36,8788.38,59604.9400000002
"2277",2017-03-15 14:31:36,-30033.36,29571.5800000002
"2278",2017-03-15 14:38:52,-29571.58,2.25554686039686e-10
"2279",2017-03-15 14:38:52,12215.8,12215.8000000002
"2280",2017-03-15 15:03:26,15113.76,27329.5600000002
"2281",2017-03-15 15:03:26,-12215.8,15113.7600000002
"2282",2017-03-15 15:18:32,30033.41,45147.1700000002
"2283",2017-03-15 15:18:32,-15113.76,30033.4100000002
"2284",2017-03-15 15:41:02,8376.23,38409.6400000002
"2285",2017-03-15 15:41:02,-30033.41,8376.23000000022
"2286",2017-03-15 15:55:20,9096.55,17472.7800000002
"2287",2017-03-15 15:55:20,22082.01,39554.7900000002
"2288",2017-03-15 15:55:20,-8376.23,31178.5600000002
"2289",2017-03-15 15:59:50,30033.45,61212.0100000002
"2290",2017-03-15 15:59:50,-31178.56,30033.4500000002
"2291",2017-03-15 16:05:07,-30033.45,2.11002770811319e-10
"2292",2017-03-15 16:29:08,9033.57,9033.57000000021
"2293",2017-03-15 16:29:08,30033.47,39067.0400000002
"2294",2017-03-15 16:33:02,-39067.04,2.11002770811319e-10
"2295",2017-03-15 17:10:15,9562.36,9562.36000000021
"2296",2017-03-15 17:10:15,9733.31,19295.6700000002
"2297",2017-03-15 17:10:15,9649.73,28945.4000000002
"2298",2017-03-15 17:10:15,12459.48,41404.8800000002
"2299",2017-03-15 17:54:55,11985.57,53390.4500000002
"2300",2017-03-15 17:54:55,12760.47,66150.9200000002
"2301",2017-03-15 18:26:10,8236.06,74386.9800000002
"2302",2017-03-15 18:26:48,13269.1,87656.0800000002
"2303",2017-03-15 18:55:41,10555.14,98211.2200000002
"2304",2017-03-15 18:55:41,13426.41,111637.63
"2305",2017-03-15 18:55:41,24518.1,136155.73
"2306",2017-03-15 18:59:14,-136155.73,2.03726813197136e-10
"2307",2017-03-15 22:42:19,33411.1,33411.1000000002
"2308",2017-03-15 22:42:19,44131.76,77542.8600000002
"2309",2017-03-15 23:44:12,-77542.86,2.03726813197136e-10
"2310",2017-03-16 02:40:52,39018.78,39018.7800000002
"2311",2017-03-16 02:40:52,32841.94,71860.7200000002
"2312",2017-03-16 02:40:52,44483.47,116344.19
"2313",2017-03-16 02:45:36,-116344.19,2.03726813197136e-10
"2314",2017-03-16 05:41:33,7810.87,7810.8700000002
"2315",2017-03-16 05:44:01,-7810.87,2.03726813197136e-10
"2316",2017-03-16 05:44:01,8921.86,8921.8600000002
"2317",2017-03-16 05:58:26,-8921.86,2.03726813197136e-10
"2318",2017-03-16 05:58:26,7810.88,7810.8800000002
"2319",2017-03-16 06:08:04,-7810.88,2.03726813197136e-10
"2320",2017-03-16 06:30:23,31114.29,31114.2900000002
"2321",2017-03-16 06:35:20,-31114.29,2.03726813197136e-10
"2322",2017-03-16 07:12:51,42529.05,42529.0500000002
"2323",2017-03-16 07:27:41,18921.91,61450.9600000002
"2324",2017-03-16 07:27:41,44534.63,105985.59
"2325",2017-03-16 07:27:41,42529.05,148514.64
"2326",2017-03-16 07:27:41,30033.9,178548.54
"2327",2017-03-16 07:27:41,31114.29,209662.83
"2328",2017-03-16 08:37:43,40962.76,250625.59
"2329",2017-03-16 08:37:43,80033.93,330659.52
"2330",2017-03-16 13:25:06,97775.8,428435.32
"2331",2017-03-16 13:45:48,21797.83,450233.15
"2332",2017-03-16 13:45:48,42691.08,492924.23
"2333",2017-03-16 13:51:33,32307.45,525231.68
"2334",2017-03-16 14:05:57,13842.81,539074.49
"2335",2017-03-16 14:05:57,54388.63,593463.12
"2336",2017-03-16 14:05:57,38673.68,632136.8
"2337",2017-03-16 14:32:06,46950.28,679087.08
"2338",2017-03-16 14:32:06,11959.92,691047
"2339",2017-03-16 14:46:40,31955.48,723002.48
"2340",2017-03-16 14:46:40,30249,753251.48
"2341",2017-03-16 14:46:40,8647.07,761898.55
"2342",2017-03-16 14:46:40,10647.57,772546.12
"2343",2017-03-16 14:58:14,50341.58,822887.7
"2344",2017-03-16 14:58:14,18999.54,841887.24
"2345",2017-03-16 15:13:27,41201.33,883088.57
"2346",2017-03-16 15:13:27,29830.56,912919.13
"2347",2017-03-16 15:31:39,26899.23,939818.36
"2348",2017-03-16 15:31:39,9403.53,949221.89
"2349",2017-03-16 15:31:39,9468.37,958690.26
"2350",2017-03-16 15:31:39,26324.96,985015.22
"2351",2017-03-16 16:01:35,8018.07,993033.29
"2352",2017-03-16 16:01:35,13336.88,1006370.17
"2353",2017-03-16 16:01:35,19250.43,1025620.6
"2354",2017-03-16 16:01:35,35973.02,1061593.62
"2355",2017-03-16 16:01:35,8253.51,1069847.13
"2356",2017-03-16 17:05:04,31107.52,1100954.65
"2357",2017-03-16 17:05:04,39561.76,1140516.41
"2358",2017-03-16 17:05:04,21974.1,1162490.51
"2359",2017-03-16 17:12:18,17671.65,1180162.16
"2360",2017-03-16 17:12:18,18700.65,1198862.81
"2361",2017-03-16 17:12:18,26877.51,1225740.32
"2362",2017-03-16 17:15:49,10478.26,1236218.58
"2363",2017-03-16 17:25:38,15734.24,1251952.82
"2364",2017-03-16 17:38:07,23038.81,1274991.63
"2365",2017-03-16 18:31:25,24172.6,1299164.23
"2366",2017-03-16 18:31:25,17646.26,1316810.49
"2367",2017-03-16 18:46:34,30176.55,1346987.04
"2368",2017-03-16 18:46:34,41668.58,1388655.62
"2369",2017-03-16 18:57:09,35251.07,1423906.69
"2370",2017-03-16 18:57:09,12619.23,1436525.92
"2371",2017-03-16 18:57:09,26707.14,1463233.06
"2372",2017-03-16 19:08:34,40034.54,1503267.6
"2373",2017-03-16 19:08:34,-1388655.62,114611.98
"2374",2017-03-16 19:55:04,31815.11,146427.09
"2375",2017-03-16 19:55:04,52046.32,198473.41
"2376",2017-03-16 20:20:17,7812.01,206285.42
"2377",2017-03-16 20:20:17,88923.02,295208.44
"2378",2017-03-16 20:57:19,-114611.98,180596.46
"2379",2017-03-16 21:02:39,-114611.98,65984.4800000003
"2380",2017-03-16 21:13:10,52396.49,118380.97
"2381",2017-03-16 21:23:23,90035.05,208416.02
"2382",2017-03-16 21:23:23,99035.06,307451.08
"2383",2017-03-16 21:23:23,33955.04,341406.12
"2384",2017-03-16 21:23:23,-114611.98,226794.14
"2385",2017-03-16 21:23:23,-114611.98,112182.16
"2386",2017-03-16 21:48:11,78927.56,191109.72
"2387",2017-03-16 21:48:11,49715.76,240825.48
"2388",2017-03-16 21:56:19,44808.76,285634.24
"2389",2017-03-16 21:56:19,5107.83,290742.07
"2390",2017-03-16 22:28:33,98035.11,388777.18
"2391",2017-03-16 22:31:38,-388777.18,2.91038304567337e-10
"2392",2017-03-16 23:23:02,40284.74,40284.7400000003
"2393",2017-03-16 23:23:02,98035.13,138319.87
"2394",2017-03-16 23:25:57,-138319.87,2.91038304567337e-10
"2395",2017-03-16 23:51:35,45573.29,45573.2900000003
"2396",2017-03-17 00:22:10,58984.7,104557.99
"2397",2017-03-17 00:22:10,56208.45,160766.44
"2398",2017-03-17 00:22:10,77812.17,238578.61
"2399",2017-03-17 00:24:16,-45573.29,193005.32
"2400",2017-03-17 00:26:19,-193005.32,2.61934474110603e-10
"2401",2017-03-17 00:45:09,49782.93,49782.9300000003
"2402",2017-03-17 00:53:54,-49782.93,2.61934474110603e-10
"2403",2017-03-17 01:01:44,67488.59,67488.5900000003
"2404",2017-03-17 01:01:44,55221.93,122710.52
"2405",2017-03-17 01:10:57,38505.94,161216.46
"2406",2017-03-17 01:10:57,-122710.52,38505.9400000002
"2407",2017-03-17 01:29:28,20285.35,58791.2900000002
"2408",2017-03-17 01:29:28,37901.21,96692.5000000002
"2409",2017-03-17 01:29:28,79189.1,175881.6
"2410",2017-03-17 01:29:28,-38505.94,137375.66
"2411",2017-03-17 01:42:06,25701.53,163077.19
"2412",2017-03-17 01:42:06,-137375.66,25701.5300000003
"2413",2017-03-17 01:47:39,-25701.53,2.61934474110603e-10
"2414",2017-03-17 07:35:27,95665.49,95665.4900000003
"2415",2017-03-17 07:35:27,52069.85,147735.34
"2416",2017-03-17 07:38:38,-147735.34,2.61934474110603e-10
"2417",2017-03-17 07:41:50,38906.92,38906.9200000003
"2418",2017-03-17 07:54:10,-38906.92,2.61934474110603e-10
"2419",2017-03-17 08:20:13,36570.85,36570.8500000003
"2420",2017-03-17 08:20:13,99405.3,135976.15
"2421",2017-03-17 08:27:29,54775.96,190752.11
"2422",2017-03-17 08:27:29,-135976.15,54775.9600000003
"2423",2017-03-17 08:31:52,-54775.96,2.5465851649642e-10
"2424",2017-03-17 08:49:57,93965.71,93965.7100000003
"2425",2017-03-17 08:49:57,35090.86,129056.57
"2426",2017-03-17 09:02:44,-129056.57,2.47382558882236e-10
"2427",2017-03-17 09:33:02,50346.07,50346.0700000002
"2428",2017-03-17 09:35:36,39843.06,90189.1300000002
"2429",2017-03-17 09:35:36,-50346.07,39843.0600000002
"2430",2017-03-17 09:36:52,-39843.06,2.40106601268053e-10
"2431",2017-03-17 10:14:20,31545.03,31545.0300000002
"2432",2017-03-17 10:14:20,39957.25,71502.2800000002
"2433",2017-03-17 10:14:20,16062.62,87564.9000000002
"2434",2017-03-17 10:49:43,-87564.9,2.3283064365387e-10
"2435",2017-03-17 12:15:01,27492.61,27492.6100000002
"2436",2017-03-17 12:15:01,63899.78,91392.3900000002
"2437",2017-03-17 12:15:01,16741.18,108133.57
"2438",2017-03-17 12:15:01,22440.47,130574.04
"2439",2017-03-17 12:26:03,-130574.04,2.47382558882236e-10
"2440",2017-03-17 13:09:34,99815.98,99815.9800000002
"2441",2017-03-17 13:09:34,48777.99,148593.97
"2442",2017-03-17 13:11:16,-148593.97,2.3283064365387e-10
"2443",2017-03-17 13:21:10,31218.01,31218.0100000002
"2444",2017-03-17 13:21:10,99816,131034.01
"2445",2017-03-17 13:24:26,-131034.01,2.3283064365387e-10
"2446",2017-03-17 13:39:56,99816.02,99816.0200000002
"2447",2017-03-17 13:39:56,5328.03,105144.05
"2448",2017-03-17 13:45:14,99816.04,204960.09
"2449",2017-03-17 13:45:14,-105144.05,99816.0400000002
"2450",2017-03-17 14:18:41,35463.22,135279.26
"2451",2017-03-17 14:18:41,8391.05,143670.31
"2452",2017-03-17 14:18:41,35128.78,178799.09
"2453",2017-03-17 14:18:41,16915.39,195714.48
"2454",2017-03-17 14:18:41,31552.07,227266.55
"2455",2017-03-17 14:32:25,19739.7,247006.25
"2456",2017-03-17 14:32:25,41764.93,288771.18
"2457",2017-03-17 14:32:25,22599.38,311370.56
"2458",2017-03-17 14:42:59,21061.36,332431.92
"2459",2017-03-17 14:42:59,-99816.04,232615.88
"2460",2017-03-17 15:07:35,31785.39,264401.27
"2461",2017-03-17 15:07:35,29306.01,293707.28
"2462",2017-03-17 15:14:25,32037.59,325744.87
"2463",2017-03-17 15:14:25,-232615.88,93128.9900000003
"2464",2017-03-17 15:23:09,-93128.99,2.7648638933897e-10
"2465",2017-03-17 15:43:39,47212.57,47212.5700000003
"2466",2017-03-17 15:45:48,-47212.57,2.7648638933897e-10
"2467",2017-03-17 15:49:13,32495.61,32495.6100000003
"2468",2017-03-17 15:50:48,42049.13,74544.7400000003
"2469",2017-03-17 15:50:48,-32495.61,42049.1300000003
"2470",2017-03-17 16:16:47,61556.37,103605.5
"2471",2017-03-17 16:16:47,21936.6,125542.1
"2472",2017-03-17 16:16:47,23258.37,148800.47
"2473",2017-03-17 16:16:47,17843.5,166643.97
"2474",2017-03-17 16:16:47,-42049.13,124594.84
"2475",2017-03-17 16:25:31,-124594.84,2.91038304567337e-10
"2476",2017-03-17 16:40:11,56443.41,56443.4100000003
"2477",2017-03-17 16:40:11,22728.78,79172.1900000003
"2478",2017-03-17 17:14:22,18955.82,98128.0100000003
"2479",2017-03-17 17:14:22,-79172.19,18955.8200000003
"2480",2017-03-17 17:18:57,58535.22,77491.0400000003
"2481",2017-03-17 17:18:57,34461.46,111952.5
"2482",2017-03-17 17:18:57,-18955.82,92996.6800000003
"2483",2017-03-17 17:27:28,42007.24,135003.92
"2484",2017-03-17 17:27:28,54825.29,189829.21
"2485",2017-03-17 17:27:28,-92996.68,96832.5300000003
"2486",2017-03-17 17:41:03,36962.34,133794.87
"2487",2017-03-17 17:41:03,-96832.53,36962.3400000003
"2488",2017-03-17 17:52:33,-36962.34,2.91038304567337e-10
"2489",2017-03-17 17:59:14,38639.74,38639.7400000003
"2490",2017-03-17 17:59:14,33792.62,72432.3600000003
"2491",2017-03-17 18:04:22,-72432.36,2.91038304567337e-10
"2492",2017-03-17 18:06:18,13167.46,13167.4600000003
"2493",2017-03-17 18:38:13,31177.46,44344.9200000003
"2494",2017-03-17 18:38:13,29580.05,73924.9700000003
"2495",2017-03-17 18:38:13,40422.47,114347.44
"2496",2017-03-17 19:05:21,-114347.44,2.91038304567337e-10
"2497",2017-03-17 19:18:53,12252.55,12252.5500000003
"2498",2017-03-17 19:18:53,99816.54,112069.09
"2499",2017-03-17 19:18:53,18690.08,130759.17
"2500",2017-03-17 19:25:03,18041.57,148800.74
"2501",2017-03-17 19:25:03,-130759.17,18041.5700000003
"2502",2017-03-17 19:28:05,-18041.57,2.83762346953154e-10
"2503",2017-03-17 19:42:39,34393.15,34393.1500000003
"2504",2017-03-17 20:13:16,36903.45,71296.6000000003
"2505",2017-03-17 20:13:16,99039.59,170336.19
"2506",2017-03-17 20:13:16,-34393.15,135943.04
"2507",2017-03-17 20:33:34,50039.6,185982.64
"2508",2017-03-17 20:33:34,-135943.04,50039.6000000003
"2509",2017-03-17 20:39:57,-50039.6,2.9831426218152e-10
"2510",2017-03-17 20:56:16,39283.75,39283.7500000003
"2511",2017-03-17 21:09:32,-39283.75,2.9831426218152e-10
"2512",2017-03-17 21:09:32,78116.75,78116.7500000003
"2513",2017-03-17 21:09:32,38098.96,116215.71
"2514",2017-03-17 21:11:17,-116215.71,2.7648638933897e-10
"2515",2017-03-17 21:30:03,67527.91,67527.9100000003
"2516",2017-03-17 21:32:39,-67527.91,2.7648638933897e-10
"2517",2017-03-17 21:57:28,99039.68,99039.6800000003
"2518",2017-03-17 21:57:28,18374.41,117414.09
"2519",2017-03-17 22:37:31,35405.07,152819.16
"2520",2017-03-17 22:37:31,34486.33,187305.49
"2521",2017-03-17 22:39:42,-117414.09,69891.4000000003
"2522",2017-03-17 22:55:17,-69891.4,2.91038304567337e-10
"2523",2017-03-17 22:59:58,41550.13,41550.1300000003
"2524",2017-03-17 22:59:58,5756.82,47306.9500000003
"2525",2017-03-17 23:24:21,44977.59,92284.5400000003
"2526",2017-03-17 23:24:21,-47306.95,44977.5900000003
"2527",2017-03-17 23:28:03,-44977.59,2.91038304567337e-10
"2528",2017-03-18 00:08:16,30077.12,30077.1200000003
"2529",2017-03-18 00:08:16,59139.68,89216.8000000003
"2530",2017-03-18 00:10:52,-89216.8,2.91038304567337e-10
"2531",2017-03-18 00:21:41,54334.02,54334.0200000003
"2532",2017-03-18 00:21:41,50193.23,104527.25
"2533",2017-03-18 00:36:38,37435.74,141962.99
"2534",2017-03-18 00:36:38,48501.34,190464.33
"2535",2017-03-18 00:36:38,42055.25,232519.58
"2536",2017-03-18 00:36:38,-104527.25,127992.33
"2537",2017-03-18 00:50:30,99039.82,227032.15
"2538",2017-03-18 00:50:30,-127992.33,99039.8200000003
"2539",2017-03-18 01:00:13,-99039.82,2.7648638933897e-10
"2540",2017-03-18 01:15:28,33471.93,33471.9300000003
"2541",2017-03-18 01:22:56,-33471.93,2.7648638933897e-10
"2542",2017-03-18 03:11:16,41450.98,41450.9800000003
"2543",2017-03-18 03:17:13,-41450.98,2.7648638933897e-10
"2544",2017-03-18 04:04:33,38536.68,38536.6800000003
"2545",2017-03-18 04:22:36,-38536.68,2.7648638933897e-10
"2546",2017-03-18 04:42:30,46139.22,46139.2200000003
"2547",2017-03-18 04:45:50,-46139.22,2.7648638933897e-10
"2548",2017-03-18 05:04:44,47430.25,47430.2500000003
"2549",2017-03-18 05:07:17,-47430.25,2.7648638933897e-10
"2550",2017-03-18 05:37:57,39699.85,39699.8500000003
"2551",2017-03-18 05:37:57,72629.1,112328.95
"2552",2017-03-18 05:37:57,38403.46,150732.41
"2553",2017-03-18 05:41:48,41475.93,192208.34
"2554",2017-03-18 05:41:48,99816.92,292025.26
"2555",2017-03-18 05:41:48,-47430.25,244595.01
"2556",2017-03-18 05:41:48,-150732.41,93862.6000000002
"2557",2017-03-18 05:45:59,-93862.6,2.3283064365387e-10
"2558",2017-03-18 06:27:06,50921.05,50921.0500000002
"2559",2017-03-18 06:34:25,-50921.05,2.3283064365387e-10
"2560",2017-03-18 06:42:50,39427.89,39427.8900000002
"2561",2017-03-18 07:07:58,-39427.89,2.3283064365387e-10
"2562",2017-03-18 08:09:09,51745.41,51745.4100000002
"2563",2017-03-18 08:09:09,99040,150785.41
"2564",2017-03-18 08:09:09,45838.82,196624.23
"2565",2017-03-18 08:17:06,-196624.23,2.3283064365387e-10
"2566",2017-03-18 08:35:23,23507.97,23507.9700000002
"2567",2017-03-18 08:35:23,37884.21,61392.1800000002
"2568",2017-03-18 08:35:23,60260.62,121652.8
"2569",2017-03-18 08:35:23,99040.05,220692.85
"2570",2017-03-18 08:46:49,-220692.85,2.3283064365387e-10
"2571",2017-03-18 09:12:13,40423.73,40423.7300000002
"2572",2017-03-18 09:23:10,47103.83,87527.5600000002
"2573",2017-03-18 09:23:10,-40423.73,47103.8300000002
"2574",2017-03-18 09:29:32,-47103.83,2.25554686039686e-10
"2575",2017-03-18 10:11:09,99040.1,99040.1000000002
"2576",2017-03-18 10:15:22,-99040.1,2.3283064365387e-10
"2577",2017-03-18 13:53:17,99818.24,99818.2400000002
"2578",2017-03-18 13:53:17,25900.25,125718.49
"2579",2017-03-18 13:54:02,99041.26,224759.75
"2580",2017-03-18 14:00:16,-224759.75,2.3283064365387e-10
"2581",2017-03-18 15:22:53,40508.13,40508.1300000002
"2582",2017-03-18 15:22:53,99041.32,139549.45
"2583",2017-03-18 15:22:53,66777.67,206327.12
"2584",2017-03-18 15:22:53,42622.74,248949.86
"2585",2017-03-18 15:24:32,-248949.86,2.3283064365387e-10
"2586",2017-03-18 16:00:36,56261.56,56261.5600000002
"2587",2017-03-18 16:20:47,54976.71,111238.27
"2588",2017-03-18 16:20:47,44147.86,155386.13
"2589",2017-03-18 16:20:47,64039.33,219425.46
"2590",2017-03-18 16:20:47,-56261.56,163163.9
"2591",2017-03-18 16:49:16,61272.73,224436.63
"2592",2017-03-18 16:49:16,48046.51,272483.14
"2593",2017-03-18 16:49:16,49941.73,322424.87
"2594",2017-03-18 16:49:16,-163163.9,159260.97
"2595",2017-03-18 16:59:40,99041.42,258302.39
"2596",2017-03-18 16:59:40,-159260.97,99041.4200000002
"2597",2017-03-18 17:05:26,-99041.42,2.47382558882236e-10
"2598",2017-03-18 20:28:10,70041.45,70041.4500000002
"2599",2017-03-18 20:29:11,-70041.45,2.47382558882236e-10
"2600",2017-03-18 20:30:33,46191.32,46191.3200000002
"2601",2017-03-18 20:33:31,-46191.32,2.47382558882236e-10
"2602",2017-03-18 21:02:50,38605.52,38605.5200000002
"2603",2017-03-18 21:07:23,-38605.52,2.47382558882236e-10
"2604",2017-03-18 21:21:51,99041.47,99041.4700000002
"2605",2017-03-18 21:36:35,-99041.47,2.47382558882236e-10
"2606",2017-03-18 23:44:47,99041.49,99041.4900000003
"2607",2017-03-18 23:54:06,99041.51,198083
"2608",2017-03-18 23:54:06,-99041.49,99041.5100000002
"2609",2017-03-18 23:54:06,99041.5,198083.01
"2610",2017-03-19 00:05:09,-198083.01,2.3283064365387e-10
"2611",2017-03-19 02:57:30,99818.55,99818.5500000002
"2612",2017-03-19 02:57:30,40290.85,140109.4
"2613",2017-03-19 02:57:30,15971.56,156080.96
"2614",2017-03-19 03:01:58,-156080.96,2.3283064365387e-10
"2615",2017-03-19 03:05:07,55041.59,55041.5900000002
"2616",2017-03-19 03:05:07,99818.58,154860.17
"2617",2017-03-19 03:19:11,-154860.17,2.03726813197136e-10
"2618",2017-03-19 03:48:01,71639.56,71639.5600000002
"2619",2017-03-19 03:54:48,44911.15,116550.71
"2620",2017-03-19 03:54:48,58726,175276.71
"2621",2017-03-19 03:54:48,-71639.56,103637.15
"2622",2017-03-19 04:17:50,-103637.15,2.03726813197136e-10
"2623",2017-03-19 04:53:46,39013.41,39013.4100000002
"2624",2017-03-19 04:53:46,39859.71,78873.1200000002
"2625",2017-03-19 04:53:46,42703.57,121576.69
"2626",2017-03-19 05:00:04,-121576.69,2.03726813197136e-10
"2627",2017-03-19 05:46:49,99041.67,99041.6700000002
"2628",2017-03-19 05:46:49,59873.41,158915.08
"2629",2017-03-19 05:50:35,-158915.08,2.03726813197136e-10
"2630",2017-03-19 06:30:02,19852.57,19852.5700000002
"2631",2017-03-19 06:33:07,-19852.57,2.03726813197136e-10
"2632",2017-03-19 07:39:50,42988.08,42988.0800000002
"2633",2017-03-19 07:43:47,-42988.08,2.03726813197136e-10
"2634",2017-03-19 10:56:48,99041.7,99041.7000000002
"2635",2017-03-19 11:13:25,-99041.7,2.03726813197136e-10
"2636",2017-03-19 12:45:18,38563.85,38563.8500000002
"2637",2017-03-19 12:53:41,-38563.85,2.03726813197136e-10
"2638",2017-03-19 20:53:52,38029.75,38029.7500000002
"2639",2017-03-19 21:08:20,-38029.75,2.03726813197136e-10
"2640",2017-03-19 21:08:20,43024.92,43024.9200000002
"2641",2017-03-19 21:26:10,60766.22,103791.14
"2642",2017-03-19 21:26:10,-43024.92,60766.2200000002
"2643",2017-03-19 21:32:29,-60766.22,2.03726813197136e-10
"2644",2017-03-19 22:08:12,54957.9,54957.9000000002
"2645",2017-03-19 22:08:12,52571.93,107529.83
"2646",2017-03-19 22:08:12,42436.11,149965.94
"2647",2017-03-19 22:15:14,-149965.94,2.03726813197136e-10
"2648",2017-03-20 14:05:54,62735.33,62735.3300000002
"2649",2017-03-20 14:05:54,62981.47,125716.8
"2650",2017-03-20 19:01:27,-125716.8,2.03726813197136e-10
"2651",2017-03-21 01:35:49,48409.75,48409.7500000002
"2652",2017-03-21 01:54:39,56253.16,104662.91
"2653",2017-03-21 02:02:16,-104662.91,2.03726813197136e-10
"2654",2017-03-21 11:53:54,43901.84,43901.8400000002
"2655",2017-03-21 11:57:19,-43901.84,2.03726813197136e-10
"2656",2017-03-21 12:11:25,38112.2,38112.2000000002
"2657",2017-03-21 12:14:07,-38112.2,2.03726813197136e-10
"2658",2017-03-21 12:25:04,47390.39,47390.3900000002
"2659",2017-03-21 12:25:04,34286.33,81676.7200000002
"2660",2017-03-21 12:25:04,59440.32,141117.04
"2661",2017-03-21 12:48:41,92285.49,233402.53
"2662",2017-03-21 13:01:50,-141117.04,92285.4900000002
"2663",2017-03-21 13:02:42,-92285.49,1.89174897968769e-10
"2664",2017-03-21 15:12:05,44988.03,44988.0300000002
"2665",2017-03-21 15:25:35,-44988.03,1.89174897968769e-10
"2666",2017-03-21 19:00:18,39198.81,39198.8100000002
"2667",2017-03-21 19:16:13,-39198.81,1.89174897968769e-10
"2668",2017-03-21 21:33:27,39501.71,39501.7100000002
"2669",2017-03-21 21:33:27,40618.63,80120.3400000002
"2670",2017-03-21 21:41:58,57548.09,137668.43
"2671",2017-03-21 21:41:58,-80120.34,57548.0900000002
"2672",2017-03-21 21:46:05,-57548.09,1.74622982740402e-10
"2673",2017-03-21 22:41:14,60462.49,60462.4900000002
"2674",2017-03-21 22:43:38,-60462.49,1.74622982740402e-10
"2675",2017-03-22 04:57:55,54348.93,54348.9300000002
"2676",2017-03-22 05:05:40,-54348.93,1.74622982740402e-10
"2677",2017-03-22 06:38:12,50976.11,50976.1100000002
"2678",2017-03-22 06:44:25,-50976.11,1.74622982740402e-10
"2679",2017-03-22 07:07:57,67169.73,67169.7300000002
"2680",2017-03-22 07:09:59,-67169.73,1.74622982740402e-10
"2681",2017-03-22 07:31:03,45271.46,45271.4600000002
"2682",2017-03-22 07:41:27,-45271.46,1.74622982740402e-10
"2683",2017-03-22 09:31:34,46385.84,46385.8400000002
"2684",2017-03-22 09:54:07,-46385.84,1.74622982740402e-10
"2685",2017-03-22 12:11:31,50121.5,50121.5000000002
"2686",2017-03-22 12:34:45,47690.06,97811.5600000002
"2687",2017-03-22 12:34:45,51360.18,149171.74
"2688",2017-03-22 12:34:45,-50121.5,99050.2400000002
"2689",2017-03-22 12:37:10,-99050.24,1.60071067512035e-10
"2690",2017-03-22 12:55:01,66995.5,66995.5000000002
"2691",2017-03-22 12:58:26,-66995.5,1.60071067512035e-10
"2692",2017-03-22 23:09:53,66791.41,66791.4100000002
"2693",2017-03-22 23:16:04,-66791.41,1.60071067512035e-10
"2694",2017-03-22 23:33:50,52187.88,52187.8800000002
"2695",2017-03-22 23:38:49,-52187.88,1.60071067512035e-10
"2696",2017-03-23 16:51:06,46609.12,46609.1200000002
"2697",2017-03-23 17:02:46,-46609.12,1.60071067512035e-10
"2698",2017-03-23 21:44:55,50560.42,50560.4200000002
"2699",2017-03-23 21:49:50,-50560.42,1.60071067512035e-10
"2700",2017-03-23 21:56:46,60152.53,60152.5300000002
"2701",2017-03-23 22:05:08,-60152.53,1.60071067512035e-10
"2702",2017-03-23 22:12:37,61369.73,61369.7300000002
"2703",2017-03-23 22:19:24,64349.62,125719.35
"2704",2017-03-23 22:19:24,-61369.73,64349.6200000002
"2705",2017-03-23 22:43:32,-64349.62,1.60071067512035e-10
"2706",2017-03-23 22:48:21,44660.08,44660.0800000002
"2707",2017-03-23 23:05:54,-44660.08,1.60071067512035e-10
"2708",2017-03-24 13:34:17,113099.08,113099.08
"2709",2017-03-24 13:37:22,-113099.08,1.60071067512035e-10
"2710",2017-03-24 14:23:29,56343.12,56343.1200000002
"2711",2017-03-24 14:25:58,-56343.12,1.60071067512035e-10
"2712",2017-03-24 14:29:08,76425.03,76425.0300000002
"2713",2017-03-24 14:35:00,-76425.03,1.60071067512035e-10
"2714",2017-03-24 15:23:33,48253.75,48253.7500000002
"2715",2017-03-24 15:26:10,-48253.75,1.60071067512035e-10
"2716",2017-03-24 16:02:03,73216.28,73216.2800000002
"2717",2017-03-24 16:08:27,80433.61,153649.89
"2718",2017-03-24 16:08:27,-73216.28,80433.6100000002
"2719",2017-03-24 16:13:16,-80433.61,1.60071067512035e-10
"2720",2017-03-24 16:46:53,52184,52184.0000000002
"2721",2017-03-24 16:56:04,51918.84,104102.84
"2722",2017-03-24 16:56:04,-52184,51918.8400000002
"2723",2017-03-24 16:59:47,-51918.84,1.60071067512035e-10
"2724",2017-03-24 17:24:56,46006.77,46006.7700000002
"2725",2017-03-24 17:41:46,-46006.77,1.60071067512035e-10
"2726",2017-03-24 21:31:32,58008.83,58008.8300000002
"2727",2017-03-24 21:42:20,45948.92,103957.75
"2728",2017-03-24 21:42:20,-58008.83,45948.9200000002
"2729",2017-03-24 21:46:28,-45948.92,1.60071067512035e-10
"2730",2017-03-24 21:59:12,50368.47,50368.4700000002
"2731",2017-03-24 21:59:12,44954.81,95323.2800000002
"2732",2017-03-24 22:07:37,65308.7,160631.98
"2733",2017-03-24 22:07:37,-95323.28,65308.7000000002
"2734",2017-03-24 22:11:44,-65308.7,1.60071067512035e-10
"2735",2017-03-24 22:43:09,87617.7,87617.7000000002
"2736",2017-03-24 22:43:09,75728.74,163346.44
"2737",2017-03-24 22:43:09,100042.76,263389.2
"2738",2017-03-24 22:50:53,-263389.2,1.74622982740402e-10
"2739",2017-03-24 23:26:03,62513.9,62513.9000000002
"2740",2017-03-24 23:26:03,70546.34,133060.24
"2741",2017-03-24 23:55:13,100042.81,233103.05
"2742",2017-03-24 23:55:13,100042.8,333145.85
"2743",2017-03-24 23:55:13,48377.33,381523.18
"2744",2017-03-24 23:55:13,-133060.24,248462.94
"2745",2017-03-25 00:00:13,-248462.94,1.74622982740402e-10
"2746",2017-03-25 17:50:14,58391.01,58391.0100000002
"2747",2017-03-25 17:54:56,-58391.01,1.74622982740402e-10
"2748",2017-03-25 18:00:16,80659.27,80659.2700000002
"2749",2017-03-25 18:08:59,-80659.27,1.74622982740402e-10
"2750",2017-03-25 19:25:12,55219.1,55219.1000000002
"2751",2017-03-25 19:56:51,-55219.1,1.74622982740402e-10
"2752",2017-03-25 20:19:59,53998.53,53998.5300000002
"2753",2017-03-25 20:27:37,-53998.53,1.74622982740402e-10
"2754",2017-03-25 20:40:18,50373.16,50373.1600000002
"2755",2017-03-25 21:09:39,45003.27,95376.4300000002
"2756",2017-03-25 21:09:39,-50373.16,45003.2700000002
"2757",2017-03-25 21:11:47,-45003.27,1.67347025126219e-10
"2758",2017-03-25 21:25:45,55473.12,55473.1200000002
"2759",2017-03-25 21:33:55,-55473.12,1.67347025126219e-10
"2760",2017-03-25 22:08:49,60356.07,60356.0700000002
"2761",2017-03-25 22:12:57,-60356.07,1.67347025126219e-10
"2762",2017-03-27 01:44:24,92429.64,92429.6400000002
"2763",2017-03-27 02:26:10,-92429.64,1.60071067512035e-10
"2764",2017-03-27 12:54:30,74327.67,74327.6700000002
"2765",2017-03-27 13:05:22,-74327.67,1.60071067512035e-10
"2766",2017-03-27 13:15:05,67705.55,67705.5500000002
"2767",2017-03-27 13:46:31,86036.84,153742.39
"2768",2017-03-27 13:46:31,80253.11,233995.5
"2769",2017-03-27 13:46:31,-67705.55,166289.95
"2770",2017-03-27 13:54:15,-166289.95,1.74622982740402e-10
"2771",2017-03-27 14:37:48,74522.28,74522.2800000002
"2772",2017-03-27 14:47:42,70565.1,145087.38
"2773",2017-03-27 14:47:42,-74522.28,70565.1000000002
"2774",2017-03-27 15:09:01,-70565.1,1.74622982740402e-10
"2775",2017-03-27 18:00:17,89897.08,89897.0800000002
"2776",2017-03-27 18:00:17,92576.65,182473.73
"2777",2017-03-27 18:21:27,-182473.73,1.45519152283669e-10
"2778",2017-03-28 20:03:17,68478.44,68478.4400000001
"2779",2017-03-28 20:03:17,105713.63,174192.07
"2780",2017-03-28 20:20:03,-174192.07,1.45519152283669e-10
"2781",2017-03-29 01:18:06,67698.67,67698.6700000001
"2782",2017-03-29 01:26:35,-67698.67,1.45519152283669e-10
"2783",2017-03-29 03:05:34,91107.49,91107.4900000002
"2784",2017-03-29 03:07:37,-91107.49,1.45519152283669e-10
"2785",2017-03-29 07:36:46,70330.65,70330.6500000001
"2786",2017-03-29 07:59:38,-70330.65,1.45519152283669e-10
"2787",2017-03-29 20:01:19,77514.91,77514.9100000001
"2788",2017-03-29 20:07:11,-77514.91,1.45519152283669e-10
"2789",2017-03-29 20:07:11,67296.39,67296.3900000001
"2790",2017-03-29 20:10:08,-67296.39,1.45519152283669e-10
"2791",2017-03-29 21:19:16,57189.53,57189.5300000001
"2792",2017-03-29 21:45:08,63314.8,120504.33
"2793",2017-03-29 21:45:08,82824.57,203328.9
"2794",2017-03-29 21:45:08,73759.07,277087.97
"2795",2017-03-29 21:45:08,-57189.53,219898.44
"2796",2017-03-29 22:03:02,4874.51,224772.95
"2797",2017-03-29 22:03:02,-219898.44,4874.51000000015
"2798",2017-03-29 22:14:13,56377.65,61252.1600000002
"2799",2017-03-29 22:14:13,-4874.51,56377.6500000002
"2800",2017-03-29 22:18:03,-56377.65,1.52795109897852e-10
"2801",2017-03-29 23:05:37,27405.79,27405.7900000002
"2802",2017-03-29 23:05:37,19996.12,47401.9100000001
"2803",2017-03-29 23:10:01,23093.71,70495.6200000001
"2804",2017-03-29 23:10:01,-47401.91,23093.7100000001
"2805",2017-03-29 23:13:56,27774.72,50868.4300000001
"2806",2017-03-29 23:13:56,-23093.71,27774.7200000001
"2807",2017-03-29 23:36:34,-27774.72,1.38243194669485e-10
"2808",2017-03-30 00:57:08,27259.68,27259.6800000001
"2809",2017-03-30 00:57:08,23426.37,50686.0500000001
"2810",2017-03-30 01:06:08,-50686.05,1.30967237055302e-10
"2811",2017-03-30 01:49:53,22407.02,22407.0200000001
"2812",2017-03-30 01:54:36,-22407.02,1.30967237055302e-10
"2813",2017-03-30 02:14:30,20782.84,20782.8400000001
"2814",2017-03-30 02:29:03,-20782.84,1.30967237055302e-10
"2815",2017-03-30 03:50:54,42348.74,42348.7400000001
"2816",2017-03-30 03:55:38,-42348.74,1.30967237055302e-10
"2817",2017-03-30 12:36:11,58311.01,58311.0100000001
"2818",2017-03-30 12:57:00,-58311.01,1.30967237055302e-10
"2819",2017-04-01 02:00:57,56292.24,56292.2400000001
"2820",2017-04-01 02:03:29,-56292.24,1.30967237055302e-10
"2821",2017-04-01 05:41:25,69966.04,69966.0400000001
"2822",2017-04-01 05:58:06,-69966.04,1.30967237055302e-10
"2823",2017-04-01 09:21:44,56028.06,56028.0600000001
"2824",2017-04-01 09:27:08,-56028.06,1.30967237055302e-10
"2825",2017-04-01 09:55:54,66032.4,66032.4000000001
"2826",2017-04-01 10:09:01,-66032.4,1.30967237055302e-10
"2827",2017-04-01 10:36:34,56188.24,56188.2400000001
"2828",2017-04-01 11:08:49,-56188.24,1.30967237055302e-10
"2829",2017-04-02 12:29:10,67472.9,67472.9000000001
"2830",2017-04-02 12:39:13,-67472.9,1.30967237055302e-10
"2831",2017-04-02 13:27:34,67082.4,67082.4000000001
"2832",2017-04-02 13:36:43,-67082.4,1.30967237055302e-10
"2833",2017-04-02 14:10:20,68492.2,68492.2000000001
"2834",2017-04-02 14:26:39,69454.94,137947.14
"2835",2017-04-02 14:26:39,79079.18,217026.32
"2836",2017-04-02 14:26:39,-68492.2,148534.12
"2837",2017-04-02 14:26:39,68687.14,217221.26
"2838",2017-04-02 14:42:37,70160.58,287381.84
"2839",2017-04-02 14:42:37,-217221.26,70160.5800000001
"2840",2017-04-02 15:14:38,69634.11,139794.69
"2841",2017-04-02 15:14:38,-70160.58,69634.1100000001
"2842",2017-04-02 15:26:55,-69634.11,1.16415321826935e-10
"2843",2017-04-02 15:26:55,70772.08,70772.0800000001
"2844",2017-04-02 15:40:11,-70772.08,1.16415321826935e-10
"2845",2017-04-02 17:16:08,74016.07,74016.0700000001
"2846",2017-04-02 17:32:08,78514.18,152530.25
"2847",2017-04-02 17:46:44,67867.92,220398.17
"2848",2017-04-02 17:46:44,-152530.25,67867.9200000001
"2849",2017-04-02 18:11:09,-67867.92,1.01863406598568e-10
"2850",2017-04-02 18:34:11,108241.97,108241.97
"2851",2017-04-02 19:01:14,68793.22,177035.19
"2852",2017-04-02 19:18:05,87078.21,264113.4
"2853",2017-04-02 19:18:05,-177035.19,87078.2100000001
"2854",2017-04-02 19:21:12,-87078.21,1.30967237055302e-10
"2855",2017-04-02 19:31:58,67714.66,67714.6600000001
"2856",2017-04-02 19:36:40,-67714.66,1.30967237055302e-10
"2857",2017-04-02 21:14:51,157161.09,157161.09
"2858",2017-04-02 21:25:45,-157161.09,1.45519152283669e-10
"2859",2017-04-02 22:00:16,74754.85,74754.8500000002
"2860",2017-04-02 22:13:56,127390.39,202145.24
"2861",2017-04-02 22:13:56,-74754.85,127390.39
"2862",2017-04-02 22:18:40,-127390.39,1.60071067512035e-10
"2863",2017-04-03 00:41:16,70571.08,70571.0800000002
"2864",2017-04-03 00:50:24,-70571.08,1.60071067512035e-10
"2865",2017-04-03 01:23:12,67675.11,67675.1100000002
"2866",2017-04-03 01:27:45,-67675.11,1.60071067512035e-10
"2867",2017-04-03 03:12:40,89717.57,89717.5700000002
"2868",2017-04-03 03:28:08,-89717.57,1.60071067512035e-10
"2869",2017-04-03 04:19:34,69580.82,69580.8200000002
"2870",2017-04-03 04:22:39,-69580.82,1.60071067512035e-10
"2871",2017-04-03 04:41:35,75132.45,75132.4500000002
"2872",2017-04-03 04:44:45,-75132.45,1.60071067512035e-10
"2873",2017-04-03 04:58:44,71201.21,71201.2100000002
"2874",2017-04-03 05:02:44,-71201.21,1.60071067512035e-10
"2875",2017-04-03 06:16:12,69394.86,69394.8600000002
"2876",2017-04-03 06:42:45,-69394.86,1.60071067512035e-10
"2877",2017-04-03 08:09:42,68785.56,68785.5600000002
"2878",2017-04-03 08:19:41,-68785.56,1.60071067512035e-10
"2879",2017-04-03 08:34:25,72351.43,72351.4300000002
"2880",2017-04-03 08:36:38,-72351.43,1.60071067512035e-10
"2881",2017-04-03 15:36:37,264075.82,264075.82
"2882",2017-04-03 15:53:10,-264075.82,1.74622982740402e-10
"2883",2017-04-03 22:41:17,67366.27,67366.2700000002
"2884",2017-04-03 22:41:17,67649.68,135015.95
"2885",2017-04-03 23:06:14,-135015.95,1.74622982740402e-10
"2886",2017-04-04 00:03:13,77697.66,77697.6600000002
"2887",2017-04-04 00:13:49,-77697.66,1.74622982740402e-10
"2888",2017-04-04 01:53:21,82647.32,82647.3200000002
"2889",2017-04-04 02:03:29,-82647.32,1.74622982740402e-10
"2890",2017-04-04 02:28:44,93614.14,93614.1400000002
"2891",2017-04-04 02:53:36,-93614.14,1.74622982740402e-10
"2892",2017-04-04 03:20:08,68626.35,68626.3500000002
"2893",2017-04-04 03:22:32,-68626.35,1.74622982740402e-10
"2894",2017-04-04 03:26:47,81872.27,81872.2700000002
"2895",2017-04-04 03:45:52,-81872.27,1.74622982740402e-10
"2896",2017-04-04 12:52:53,103025.17,103025.17
"2897",2017-04-04 13:02:07,-103025.17,1.74622982740402e-10
"2898",2017-04-04 13:19:46,69821.83,69821.8300000002
"2899",2017-04-04 13:24:24,-69821.83,1.74622982740402e-10
"2900",2017-04-06 03:48:21,71035.79,71035.7900000002
"2901",2017-04-06 04:10:06,-71035.79,1.74622982740402e-10
"2902",2017-04-06 06:53:03,92224.46,92224.4600000002
"2903",2017-04-06 06:58:20,-92224.46,1.74622982740402e-10
"2904",2017-04-06 08:20:16,84654.88,84654.8800000002
"2905",2017-04-06 08:22:54,-84654.88,1.74622982740402e-10
"2906",2017-04-06 10:53:36,70419.03,70419.0300000002
"2907",2017-04-06 10:55:56,-70419.03,1.74622982740402e-10
"2908",2017-04-06 11:59:42,72159.17,72159.1700000002
"2909",2017-04-06 12:09:10,-72159.17,1.74622982740402e-10
"2910",2017-04-06 12:34:16,74803.25,74803.2500000002
"2911",2017-04-06 12:48:55,-74803.25,1.74622982740402e-10
"2912",2017-04-07 19:30:16,54690.32,54690.3200000002
"2913",2017-04-07 19:30:16,50613.86,105304.18
"2914",2017-04-07 19:34:34,-105304.18,1.74622982740402e-10
"2915",2017-04-07 19:34:34,84153.39,84153.3900000002
"2916",2017-04-07 19:43:50,69013.71,153167.1
"2917",2017-04-07 19:43:50,-84153.39,69013.7100000002
"2918",2017-04-07 19:43:50,1045.7,70059.4100000002
"2919",2017-04-07 19:47:50,-70059.41,1.74622982740402e-10
"2920",2017-04-07 21:54:26,66030.1,66030.1000000002
"2921",2017-04-07 22:09:33,-66030.1,1.74622982740402e-10
"2922",2017-04-08 01:01:04,68359.57,68359.5700000002
"2923",2017-04-08 01:19:45,-68359.57,1.74622982740402e-10
"2924",2017-04-08 01:36:01,77643.93,77643.9300000002
"2925",2017-04-08 01:47:29,-77643.93,1.74622982740402e-10
"2926",2017-04-08 03:44:03,79307.03,79307.0300000002
"2927",2017-04-08 03:50:19,-79307.03,1.74622982740402e-10
"2928",2017-04-08 18:31:58,67418.7,67418.7000000002
"2929",2017-04-08 19:17:58,-67418.7,1.74622982740402e-10
"2930",2017-04-09 07:18:07,83498.1,83498.1000000002
"2931",2017-04-09 07:27:40,-83498.1,1.74622982740402e-10
"2932",2017-04-09 07:53:08,68491.82,68491.8200000002
"2933",2017-04-09 07:59:47,-68491.82,1.74622982740402e-10
"2934",2017-04-09 22:45:45,71688.46,71688.4600000002
"2935",2017-04-09 22:50:00,-71688.46,1.74622982740402e-10
"2936",2017-04-09 23:01:12,83033.87,83033.8700000002
"2937",2017-04-09 23:05:45,-83033.87,1.74622982740402e-10
"2938",2017-04-09 23:25:59,69789.97,69789.9700000002
"2939",2017-04-09 23:56:59,-69789.97,1.74622982740402e-10
"2940",2017-04-10 00:48:18,70160.39,70160.3900000002
"2941",2017-04-10 01:03:44,-70160.39,1.74622982740402e-10
"2942",2017-04-10 02:01:47,73935.95,73935.9500000002
"2943",2017-04-10 02:09:01,-73935.95,1.74622982740402e-10
"2944",2017-04-10 08:34:43,67299.61,67299.6100000002
"2945",2017-04-10 08:42:54,-67299.61,1.74622982740402e-10
"2946",2017-04-10 09:44:31,69171.18,69171.1800000002
"2947",2017-04-10 09:50:14,-69171.18,1.74622982740402e-10
"2948",2017-04-10 16:54:50,35096.19,35096.1900000002
"2949",2017-04-10 17:01:35,-35096.19,1.74622982740402e-10
"2950",2017-04-10 19:32:04,41024.4,41024.4000000002
"2951",2017-04-10 19:41:46,-41024.4,1.74622982740402e-10
"2952",2017-04-10 19:41:46,25951.91,25951.9100000002
"2953",2017-04-10 19:53:14,-25951.91,1.74622982740402e-10
"2954",2017-04-10 22:04:13,23808.12,23808.1200000002
"2955",2017-04-10 22:11:38,39931.31,63739.4300000002
"2956",2017-04-10 22:11:38,-23808.12,39931.3100000002
"2957",2017-04-10 22:17:20,-39931.31,1.74622982740402e-10
"2958",2017-04-10 22:49:03,24669.82,24669.8200000002
"2959",2017-04-10 22:58:05,25462.76,50132.5800000002
"2960",2017-04-10 22:58:05,-24669.82,25462.7600000002
"2961",2017-04-10 22:58:05,-24669.82,792.940000000177
"2962",2017-04-10 23:04:12,-792.94,1.76896719494835e-10
"2963",2017-04-11 00:44:04,25593.62,25593.6200000002
"2964",2017-04-11 00:44:04,23655.23,49248.8500000002
"2965",2017-04-11 00:44:04,26246.08,75494.9300000002
"2966",2017-04-11 00:49:31,-75494.93,1.89174897968769e-10
"2967",2017-04-11 01:31:05,24114.86,24114.8600000002
"2968",2017-04-11 01:37:16,-24114.86,1.89174897968769e-10
"2969",2017-04-11 04:11:38,25508.8,25508.8000000002
"2970",2017-04-11 04:15:54,-25508.8,1.89174897968769e-10
"2971",2017-04-11 04:19:55,26586.69,26586.6900000002
"2972",2017-04-11 04:36:44,-26586.69,1.89174897968769e-10
"2973",2017-04-11 04:48:24,27233.93,27233.9300000002
"2974",2017-04-11 04:55:36,-27233.93,1.89174897968769e-10
"2975",2017-04-11 05:46:22,24389.27,24389.2700000002
"2976",2017-04-11 06:22:12,24775.55,49164.8200000002
"2977",2017-04-11 06:51:24,-49164.82,1.89174897968769e-10
"2978",2017-04-11 07:04:21,29203.23,29203.2300000002
"2979",2017-04-11 07:27:24,25474.83,54678.0600000002
"2980",2017-04-11 07:27:24,29771.86,84449.9200000002
"2981",2017-04-11 07:27:24,-29203.23,55246.6900000002
"2982",2017-04-11 07:27:24,-29203.23,26043.4600000002
"2983",2017-04-11 07:32:53,23576.55,49620.0100000002
"2984",2017-04-11 07:32:53,-26043.46,23576.5500000002
"2985",2017-04-11 07:42:53,-23576.55,1.92812876775861e-10
"2986",2017-04-11 08:11:36,24375.55,24375.5500000002
"2987",2017-04-11 08:11:36,24023.65,48399.2000000002
"2988",2017-04-11 08:19:07,31529.68,79928.8800000002
"2989",2017-04-11 08:19:07,-48399.2,31529.6800000002
"2990",2017-04-11 08:23:56,-31529.68,1.96450855582952e-10
"2991",2017-04-11 08:43:30,27747.71,27747.7100000002
"2992",2017-04-11 08:54:33,-27747.71,1.96450855582952e-10
"2993",2017-04-11 09:04:29,27136.78,27136.7800000002
"2994",2017-04-11 09:04:29,39306.63,66443.4100000002
"2995",2017-04-11 09:39:19,44939.88,111383.29
"2996",2017-04-11 09:39:19,27131.54,138514.83
"2997",2017-04-11 09:39:19,33862.45,172377.28
"2998",2017-04-11 09:39:19,50047.28,222424.56
"2999",2017-04-11 09:39:19,41999.92,264424.48
"3000",2017-04-11 09:39:19,-66443.41,197981.07
"3001",2017-04-11 09:43:16,-197981.07,2.03726813197136e-10
"3002",2017-04-11 10:24:07,74050.87,74050.8700000002
"3003",2017-04-11 10:24:07,77824.3,151875.17
"3004",2017-04-11 10:27:49,-151875.17,2.03726813197136e-10
"3005",2017-04-11 12:42:13,23687.14,23687.1400000002
"3006",2017-04-11 12:50:45,-23687.14,2.03726813197136e-10
"3007",2017-04-11 13:48:57,27395.91,27395.9100000002
"3008",2017-04-11 14:23:23,24591.85,51987.7600000002
"3009",2017-04-11 14:23:23,-27395.91,24591.8500000002
"3010",2017-04-11 14:31:40,-24591.85,2.00088834390044e-10
"3011",2017-04-11 15:44:36,33111.97,33111.9700000002
"3012",2017-04-11 15:44:36,71144.13,104256.1
"3013",2017-04-11 15:58:03,-104256.1,2.03726813197136e-10
"3014",2017-04-11 19:33:23,44868.21,44868.2100000002
"3015",2017-04-11 19:45:52,-44868.21,2.03726813197136e-10
"3016",2017-04-11 22:37:01,47338.8,47338.8000000002
"3017",2017-04-11 22:56:21,-47338.8,2.03726813197136e-10
"3018",2017-04-12 00:55:25,55057.4,55057.4000000002
"3019",2017-04-12 01:02:34,-55057.4,2.03726813197136e-10
"3020",2017-04-12 01:45:02,62802.47,62802.4700000002
"3021",2017-04-12 01:48:51,-62802.47,2.03726813197136e-10
"3022",2017-04-12 03:21:50,72454,72454.0000000002
"3023",2017-04-12 03:25:26,-72454,2.03726813197136e-10
"3024",2017-04-12 04:42:13,66768.17,66768.1700000002
"3025",2017-04-12 04:55:05,-66768.17,2.03726813197136e-10
"3026",2017-04-12 05:25:05,67730.21,67730.2100000002
"3027",2017-04-12 05:29:10,-67730.21,2.03726813197136e-10
"3028",2017-04-12 07:28:54,53368.41,53368.4100000002
"3029",2017-04-12 07:28:54,66006.78,119375.19
"3030",2017-04-12 07:38:04,-119375.19,2.03726813197136e-10
"3031",2017-04-12 08:01:31,55868.74,55868.7400000002
"3032",2017-04-12 08:06:03,-55868.74,2.03726813197136e-10
"3033",2017-04-12 10:44:18,83360.97,83360.9700000002
"3034",2017-04-12 11:00:32,-83360.97,2.03726813197136e-10
"3035",2017-04-12 11:10:28,54298.75,54298.7500000002
"3036",2017-04-12 11:16:28,-54298.75,2.03726813197136e-10
"3037",2017-04-12 11:51:00,25179.6,25179.6000000002
"3038",2017-04-12 11:58:49,-25179.6,2.03726813197136e-10
"3039",2017-04-12 14:26:36,40362.74,40362.7400000002
"3040",2017-04-12 14:26:36,3832.28,44195.0200000002
"3041",2017-04-12 14:26:36,74865.31,119060.33
"3042",2017-04-12 14:30:23,-119060.33,1.89174897968769e-10
"3043",2017-04-12 15:30:51,29914.89,29914.8900000002
"3044",2017-04-12 15:59:09,-29914.89,1.89174897968769e-10
"3045",2017-04-12 16:17:37,74879.67,74879.6700000002
"3046",2017-04-12 16:21:53,-74879.67,1.89174897968769e-10
"3047",2017-04-12 19:49:33,38948.67,38948.6700000002
"3048",2017-04-12 19:49:33,39363.53,78312.2000000002
"3049",2017-04-12 19:49:33,25673.57,103985.77
"3050",2017-04-12 19:56:25,56907.62,160893.39
"3051",2017-04-12 19:56:25,-103985.77,56907.6200000002
"3052",2017-04-12 19:59:54,41459.2,98366.8200000002
"3053",2017-04-12 19:59:54,-56907.62,41459.2000000002
"3054",2017-04-12 20:19:24,42771.32,84230.5200000002
"3055",2017-04-12 20:19:24,-41459.2,42771.3200000002
"3056",2017-04-12 20:19:24,-41459.2,1312.12000000018
"3057",2017-04-12 20:28:36,-1312.12,1.84627424459904e-10
"3058",2017-04-12 20:31:33,62444.39,62444.3900000002
"3059",2017-04-12 20:45:57,-62444.39,1.81898940354586e-10
"3060",2017-04-12 22:19:54,53947.16,53947.1600000002
"3061",2017-04-12 22:22:43,-53947.16,1.81898940354586e-10
"3062",2017-04-12 22:39:18,28027.35,28027.3500000002
"3063",2017-04-12 23:07:25,-28027.35,1.81898940354586e-10
"3064",2017-04-13 00:05:18,42140.67,42140.6700000002
"3065",2017-04-13 00:32:06,-42140.67,1.81898940354586e-10
"3066",2017-04-13 02:59:50,56954.14,56954.1400000002
"3067",2017-04-13 03:07:27,-56954.14,1.81898940354586e-10
"3068",2017-04-13 03:53:07,54611.93,54611.9300000002
"3069",2017-04-13 04:02:13,-54611.93,1.81898940354586e-10
"3070",2017-04-13 07:09:11,94390.9,94390.9000000002
"3071",2017-04-13 07:14:18,-94390.9,1.74622982740402e-10
"3072",2017-04-13 07:36:00,67482.87,67482.8700000002
"3073",2017-04-13 07:42:10,24905.87,92388.7400000002
"3074",2017-04-13 07:42:10,-67482.87,24905.8700000002
"3075",2017-04-13 08:08:39,-24905.87,1.70985003933311e-10
"3076",2017-04-13 08:34:35,67467.33,67467.3300000002
"3077",2017-04-13 08:39:44,-67467.33,1.74622982740402e-10
"3078",2017-04-13 11:24:41,71823.11,71823.1100000002
"3079",2017-04-13 11:29:53,-71823.11,1.74622982740402e-10
"3080",2017-04-13 11:59:30,63726.16,63726.1600000002
"3081",2017-04-13 12:08:58,-63726.16,1.74622982740402e-10
"3082",2017-04-13 13:34:55,52582.72,52582.7200000002
"3083",2017-04-13 13:41:43,-52582.72,1.74622982740402e-10
"3084",2017-04-13 17:13:13,5408.84,5408.84000000017
"3085",2017-04-13 17:25:17,-5408.84,1.74622982740402e-10
"3086",2017-04-13 18:12:44,43443.95,43443.9500000002
"3087",2017-04-13 18:18:13,-43443.95,1.74622982740402e-10
"3088",2017-04-13 19:33:42,35132.26,35132.2600000002
"3089",2017-04-13 20:16:18,-35132.26,1.74622982740402e-10
"3090",2017-04-13 20:31:44,43906.32,43906.3200000002
"3091",2017-04-13 22:17:26,28830.69,72737.0100000002
"3092",2017-04-13 22:17:26,39197.93,111934.94
"3093",2017-04-13 22:33:17,67754.6,179689.54
"3094",2017-04-13 22:33:17,-43906.32,135783.22
"3095",2017-04-13 22:44:35,-43906.32,91876.9000000002
"3096",2017-04-13 23:05:54,-91876.9,1.74622982740402e-10
"3097",2017-04-13 23:05:54,45336.34,45336.3400000002
"3098",2017-04-13 23:13:46,-45336.34,1.74622982740402e-10
"3099",2017-04-14 01:33:58,28497.78,28497.7800000002
"3100",2017-04-14 01:33:58,75142.93,103640.71
"3101",2017-04-14 01:40:57,-103640.71,1.60071067512035e-10
"3102",2017-04-14 02:13:33,23826.23,23826.2300000002
"3103",2017-04-14 02:13:33,2218.9,26045.1300000002
"3104",2017-04-14 02:23:54,2038.96,28084.0900000002
"3105",2017-04-14 02:23:54,-26045.13,2038.96000000016
"3106",2017-04-14 02:40:37,-2038.96,1.59161572810262e-10
"3107",2017-04-14 02:51:04,55804.42,55804.4200000002
"3108",2017-04-14 02:56:50,-55804.42,1.60071067512035e-10
"3109",2017-04-14 04:33:21,25902.2,25902.2000000002
"3110",2017-04-14 04:36:21,-25902.2,1.60071067512035e-10
"3111",2017-04-14 15:44:47,71132.47,71132.4700000002
"3112",2017-04-14 16:00:40,-71132.47,1.60071067512035e-10
"3113",2017-04-14 19:02:30,79469.17,79469.1700000002
"3114",2017-04-14 19:16:41,-79469.17,1.60071067512035e-10
"3115",2017-04-14 19:52:04,67814.95,67814.9500000002
"3116",2017-04-14 20:04:40,-67814.95,1.60071067512035e-10
"3117",2017-04-14 21:04:09,68726.63,68726.6300000002
"3118",2017-04-14 21:07:40,-68726.63,1.60071067512035e-10
"3119",2017-04-15 00:12:12,74302.78,74302.7800000002
"3120",2017-04-15 00:16:12,-74302.78,1.60071067512035e-10
"3121",2017-04-15 00:25:16,2165.88,2165.88000000016
"3122",2017-04-15 00:30:19,-2165.88,1.60071067512035e-10
"3123",2017-04-15 01:02:44,70928.53,70928.5300000002
"3124",2017-04-15 01:14:53,54934.64,125863.17
"3125",2017-04-15 01:14:53,-70928.53,54934.6400000002
"3126",2017-04-15 01:16:55,-54934.64,1.60071067512035e-10
"3127",2017-04-15 17:24:11,66855.12,66855.1200000002
"3128",2017-04-15 17:34:16,73478.83,140333.95
"3129",2017-04-15 17:34:16,-66855.12,73478.8300000002
"3130",2017-04-15 17:41:54,-73478.83,1.60071067512035e-10
"3131",2017-04-15 18:42:36,70578.87,70578.8700000002
"3132",2017-04-15 18:48:27,-70578.87,1.60071067512035e-10
"3133",2017-04-15 22:28:58,76858.69,76858.6900000002
"3134",2017-04-15 22:39:43,-76858.69,1.60071067512035e-10
"3135",2017-04-17 15:39:38,46093.88,46093.8800000002
"3136",2017-04-17 15:39:38,43922.51,90016.3900000002
"3137",2017-04-17 15:54:27,76509.33,166525.72
"3138",2017-04-17 15:54:27,54118.08,220643.8
"3139",2017-04-17 16:29:09,74663.14,295306.94
"3140",2017-04-17 16:29:09,83521.06,378828
"3141",2017-04-17 16:38:24,-378828,1.74622982740402e-10
"3142",2017-04-17 17:16:17,93922.12,93922.1200000002
"3143",2017-04-17 17:16:17,83173.95,177096.07
"3144",2017-04-17 17:22:24,-177096.07,1.74622982740402e-10
"3145",2017-04-17 17:54:32,69471.01,69471.0100000002
"3146",2017-04-17 17:59:56,-69471.01,1.74622982740402e-10
"3147",2017-04-17 18:42:52,85252.85,85252.8500000002
"3148",2017-04-17 18:42:52,111382.44,196635.29
"3149",2017-04-17 18:42:52,83109.47,279744.76
"3150",2017-04-17 19:03:03,68270.9,348015.66
"3151",2017-04-17 19:23:10,75429.79,423445.45
"3152",2017-04-17 19:23:10,126688.98,550134.43
"3153",2017-04-17 19:23:10,-348015.66,202118.77
"3154",2017-04-17 20:30:56,88890.46,291009.23
"3155",2017-04-17 20:30:56,-202118.77,88890.4600000002
"3156",2017-04-17 20:43:59,68638.06,157528.52
"3157",2017-04-17 21:03:57,-157528.52,2.3283064365387e-10
"3158",2017-04-17 21:21:08,49999,49999.0000000002
"3159",2017-04-17 21:27:29,-49999,2.3283064365387e-10
"3160",2017-04-17 21:48:45,72143.84,72143.8400000002
"3161",2017-04-17 21:51:34,-72143.84,2.3283064365387e-10
"3162",2017-04-17 22:07:35,70160.56,70160.5600000002
"3163",2017-04-17 22:26:06,-70160.56,2.3283064365387e-10
"3164",2017-04-17 23:46:43,74896.12,74896.1200000002
"3165",2017-04-18 00:09:07,66977.07,141873.19
"3166",2017-04-18 00:09:07,-74896.12,66977.0700000002
"3167",2017-04-18 00:20:17,-66977.07,2.3283064365387e-10
"3168",2017-04-18 18:34:38,77842.39,77842.3900000002
"3169",2017-04-18 19:01:17,-77842.39,2.3283064365387e-10
"3170",2017-04-18 22:23:23,78308.61,78308.6100000002
"3171",2017-04-18 22:32:36,-78308.61,2.3283064365387e-10
"3172",2017-04-19 18:06:56,88937.28,88937.2800000002
"3173",2017-04-19 18:06:56,159343.38,248280.66
"3174",2017-04-19 18:06:56,89767.94,338048.6
"3175",2017-04-19 18:06:56,79036.59,417085.19
"3176",2017-04-19 18:11:54,26798.161,443883.351
"3177",2017-04-19 18:52:17,88937.32,532820.671
"3178",2017-04-19 18:52:17,92094.11,624914.781
"3179",2017-04-19 18:52:17,124268.04,749182.821
"3180",2017-04-19 18:52:17,114656.09,863838.911
"3181",2017-04-19 19:57:41,-863838.911,2.3283064365387e-10
"3182",2017-04-20 15:28:59,93810.02,93810.0200000002
"3183",2017-04-20 15:42:13,-93810.02,2.3283064365387e-10
"3184",2017-04-20 15:51:14,95651.78,95651.7800000002
"3185",2017-04-20 16:05:20,-95651.78,2.3283064365387e-10
"3186",2017-04-20 18:32:30,100439.15,100439.15
"3187",2017-04-20 18:35:15,-100439.15,2.3283064365387e-10
"3188",2017-04-20 18:45:01,103505.51,103505.51
"3189",2017-04-20 18:48:21,-103505.51,2.3283064365387e-10
"3190",2017-04-21 02:39:04,86479.41,86479.4100000002
"3191",2017-04-21 02:44:09,-86479.41,2.3283064365387e-10
"3192",2017-04-21 03:28:36,111230.84,111230.84
"3193",2017-04-21 03:33:30,-111230.84,2.3283064365387e-10
"3194",2017-04-21 04:01:20,94557.79,94557.7900000002
"3195",2017-04-21 04:25:44,-94557.79,2.3283064365387e-10
"3196",2017-04-21 04:58:21,96723.93,96723.9300000002
"3197",2017-04-21 05:20:22,-96723.93,2.3283064365387e-10
"3198",2017-04-21 07:24:27,78789.9,78789.9000000002
"3199",2017-04-21 07:30:56,-78789.9,2.3283064365387e-10
"3200",2017-04-21 14:45:18,81575.62,81575.6200000002
"3201",2017-04-21 14:49:22,-81575.62,2.3283064365387e-10
"3202",2017-04-21 15:06:31,99494.51,99494.5100000002
"3203",2017-04-21 15:14:35,-99494.51,2.3283064365387e-10
"3204",2017-04-21 16:37:01,78295.45,78295.4500000002
"3205",2017-04-21 16:41:53,-78295.45,2.3283064365387e-10
"3206",2017-04-21 16:48:23,84762.93,84762.9300000002
"3207",2017-04-21 17:08:31,-84762.93,2.3283064365387e-10
"3208",2017-04-21 17:36:43,87480.82,87480.8200000002
"3209",2017-04-21 17:44:13,-87480.82,2.3283064365387e-10
"3210",2017-04-21 18:47:50,78584.56,78584.5600000002
"3211",2017-04-21 19:00:51,-78584.56,2.3283064365387e-10
"3212",2017-04-21 22:09:38,86359.96,86359.9600000002
"3213",2017-04-21 22:23:35,-86359.96,2.3283064365387e-10
"3214",2017-04-22 05:30:15,88827.7,88827.7000000002
"3215",2017-04-22 05:46:53,-88827.7,2.3283064365387e-10
"3216",2017-04-22 17:37:54,93868.69,93868.6900000002
"3217",2017-04-22 17:42:33,-93868.69,2.3283064365387e-10
"3218",2017-04-22 19:08:09,84187.44,84187.4400000002
"3219",2017-04-22 19:14:25,-84187.44,2.3283064365387e-10
"3220",2017-04-22 19:32:53,139252.98,139252.98
"3221",2017-04-22 19:36:50,-139252.98,2.3283064365387e-10
"3222",2017-04-22 21:19:22,93104.18,93104.1800000002
"3223",2017-04-22 21:53:05,84950.96,178055.14
"3224",2017-04-22 21:53:05,87381.64,265436.78
"3225",2017-04-22 21:53:05,85500.67,350937.45
"3226",2017-04-22 21:53:05,-93104.18,257833.27
"3227",2017-04-22 22:00:08,-257833.27,2.61934474110603e-10
"3228",2017-04-22 22:10:33,102855.63,102855.63
"3229",2017-04-22 22:18:25,-102855.63,2.61934474110603e-10
"3230",2017-04-22 22:19:28,85823.06,85823.0600000003
"3231",2017-04-22 22:24:25,134305.49,220128.55
"3232",2017-04-22 22:24:25,-85823.06,134305.49
"3233",2017-04-22 22:36:00,-134305.49,2.61934474110603e-10
"3234",2017-04-24 00:01:09,90388.83,90388.8300000003
"3235",2017-04-24 00:06:45,-90388.83,2.61934474110603e-10
"3236",2017-04-24 00:11:13,81126.68,81126.6800000003
"3237",2017-04-24 00:22:44,-81126.68,2.61934474110603e-10
"3238",2017-04-24 02:02:34,85090.57,85090.5700000003
"3239",2017-04-24 02:05:10,-85090.57,2.61934474110603e-10
"3240",2017-04-24 03:21:40,78528.52,78528.5200000003
"3241",2017-04-24 03:25:48,-78528.52,2.61934474110603e-10
"3242",2017-04-24 04:18:51,79148.88,79148.8800000003
"3243",2017-04-24 04:42:12,79538.05,158686.93
"3244",2017-04-24 04:42:12,-79148.88,79538.0500000003
"3245",2017-04-24 04:57:05,-79538.05,2.7648638933897e-10
"3246",2017-04-24 05:25:17,86343.54,86343.5400000003
"3247",2017-04-24 05:38:59,-86343.54,2.7648638933897e-10
"3248",2017-04-24 08:17:18,117446.86,117446.86
"3249",2017-04-24 08:24:30,-117446.86,2.7648638933897e-10
"3250",2017-04-26 04:49:42,80241.39,80241.3900000003
"3251",2017-04-26 04:57:36,-80241.39,2.7648638933897e-10
"3252",2017-04-26 05:39:25,80120.98,80120.9800000003
"3253",2017-04-26 05:56:07,-80120.98,2.7648638933897e-10
"3254",2017-04-26 06:22:29,84364.9,84364.9000000003
"3255",2017-04-26 06:37:28,-84364.9,2.7648638933897e-10
"3256",2017-04-26 07:17:02,83017.45,83017.4500000003
"3257",2017-04-26 08:01:04,-83017.45,2.7648638933897e-10
"3258",2017-04-26 08:42:03,94826.24,94826.2400000003
"3259",2017-04-26 09:02:13,-94826.24,2.7648638933897e-10
"3260",2017-04-26 09:02:13,93191.74,93191.7400000003
"3261",2017-04-26 09:07:14,-93191.74,2.7648638933897e-10
"3262",2017-04-27 12:07:55,78924.54,78924.5400000003
"3263",2017-04-27 12:30:02,79170.16,158094.7
"3264",2017-04-27 12:30:02,-78924.54,79170.1600000003
"3265",2017-04-27 12:43:25,-79170.16,2.7648638933897e-10
"3266",2017-04-27 13:33:15,79906.48,79906.4800000003
"3267",2017-04-27 13:59:20,83365.08,163271.56
"3268",2017-04-27 14:01:26,105684.01,268955.57
"3269",2017-04-27 14:16:34,83012.06,351967.63
"3270",2017-04-27 14:16:34,-163271.56,188696.07
"3271",2017-04-27 14:19:00,-188696.07,2.91038304567337e-10
"3272",2017-04-27 15:03:14,80510.82,80510.8200000003
"3273",2017-04-27 15:28:18,-80510.82,2.91038304567337e-10
"3274",2017-04-27 17:23:27,92112.24,92112.2400000003
"3275",2017-04-27 17:26:32,-92112.24,2.91038304567337e-10
"3276",2017-04-27 20:56:43,84168.22,84168.2200000003
"3277",2017-04-27 20:56:43,30050.86,114219.08
"3278",2017-04-27 20:57:35,30050.88,144269.96
"3279",2017-04-27 21:00:47,-144269.96,2.91038304567337e-10
"3280",2017-04-28 01:09:20,82875.84,82875.8400000003
"3281",2017-04-28 01:11:51,-82875.84,2.91038304567337e-10
"3282",2017-04-28 04:34:45,93994.57,93994.5700000003
"3283",2017-04-28 04:45:44,-93994.57,2.91038304567337e-10
"3284",2017-04-28 11:43:16,84870.18,84870.1800000003
"3285",2017-04-28 12:06:11,108470.5,193340.68
"3286",2017-04-28 12:06:11,-84870.18,108470.5
"3287",2017-04-28 12:06:11,123987.5,232458
"3288",2017-04-28 12:17:08,-232458,2.91038304567337e-10
"3289",2017-04-28 13:56:54,81859.99,81859.9900000003
"3290",2017-04-28 14:02:07,-81859.99,2.91038304567337e-10
"3291",2017-04-28 18:01:32,90883.62,90883.6200000003
"3292",2017-04-28 18:11:14,-90883.62,2.91038304567337e-10
"3293",2017-04-28 20:13:44,103777.81,103777.81
"3294",2017-04-28 20:16:48,-103777.81,2.91038304567337e-10
"3295",2017-04-28 21:24:07,83029.22,83029.2200000003
"3296",2017-04-28 21:28:01,-83029.22,2.91038304567337e-10
"3297",2017-04-28 22:16:12,82213.49,82213.4900000003
"3298",2017-04-28 22:20:41,-82213.49,2.91038304567337e-10
"3299",2017-04-28 23:30:11,95311.11,95311.1100000003
"3300",2017-04-28 23:34:06,-95311.11,2.91038304567337e-10
"3301",2017-04-28 23:36:32,99933.03,99933.0300000003
"3302",2017-04-28 23:43:02,81928.23,181861.26
"3303",2017-04-28 23:43:02,-99933.03,81928.2300000003
"3304",2017-04-28 23:49:03,-81928.23,3.05590219795704e-10
"3305",2017-04-29 01:04:06,81253.18,81253.1800000003
"3306",2017-04-29 01:09:26,-81253.18,3.05590219795704e-10
"3307",2017-04-29 03:30:33,85682.17,85682.1700000003
"3308",2017-04-29 04:10:15,-85682.17,3.05590219795704e-10
"3309",2017-04-29 06:08:04,80091.14,80091.1400000003
"3310",2017-04-29 06:19:12,-80091.14,3.05590219795704e-10
"3311",2017-04-29 06:43:13,78529.41,78529.4100000003
"3312",2017-04-29 06:58:22,-78529.41,3.05590219795704e-10
"3313",2017-04-29 07:05:25,102333.13,102333.13
"3314",2017-04-29 07:12:25,79675.64,182008.77
"3315",2017-04-29 07:12:25,-102333.13,79675.6400000003
"3316",2017-04-29 07:24:25,-79675.64,3.05590219795704e-10
"3317",2017-04-29 09:55:21,112542.22,112542.22
"3318",2017-04-29 10:06:54,-112542.22,3.05590219795704e-10
"3319",2017-04-29 12:44:16,83953.92,83953.9200000003
"3320",2017-04-29 12:51:57,-83953.92,3.05590219795704e-10
"3321",2017-04-29 13:49:20,79989.73,79989.7300000003
"3322",2017-04-29 13:52:34,-79989.73,3.05590219795704e-10
"3323",2017-04-29 19:49:45,88204.39,88204.3900000003
"3324",2017-04-29 19:56:00,-88204.39,3.05590219795704e-10
"3325",2017-04-29 20:36:14,89130.08,89130.0800000003
"3326",2017-04-29 20:48:30,-89130.08,3.05590219795704e-10
"3327",2017-04-30 03:06:21,100978.23,100978.23
"3328",2017-04-30 03:10:10,-100978.23,3.05590219795704e-10
"3329",2017-04-30 05:03:26,80903.5,80903.5000000003
"3330",2017-04-30 05:18:12,-80903.5,3.05590219795704e-10
"3331",2017-04-30 23:16:19,92988.57,92988.5700000003
"3332",2017-04-30 23:30:49,-92988.57,3.05590219795704e-10
"3333",2017-05-01 00:40:53,83753.27,83753.2700000003
"3334",2017-05-01 01:05:11,92901.12,176654.39
"3335",2017-05-01 01:05:11,-83753.27,92901.1200000003
"3336",2017-05-01 01:05:11,-83753.27,9147.8500000003
"3337",2017-05-01 01:14:16,79381.68,88529.5300000003
"3338",2017-05-01 01:14:16,-9147.85,79381.6800000003
"3339",2017-05-01 01:19:44,-79381.68,2.91038304567337e-10
"3340",2017-05-01 03:39:15,78436.59,78436.5900000003
"3341",2017-05-01 03:55:06,-78436.59,2.91038304567337e-10
"3342",2017-05-01 06:19:32,79475.29,79475.2900000003
"3343",2017-05-01 06:23:43,-79475.29,2.91038304567337e-10
"3344",2017-05-01 06:37:01,96060.75,96060.7500000003
"3345",2017-05-01 06:54:32,-96060.75,2.91038304567337e-10
"3346",2017-05-01 09:49:31,83771.59,83771.5900000003
"3347",2017-05-01 09:49:31,113634.93,197406.52
"3348",2017-05-01 09:56:21,-197406.52,2.91038304567337e-10
"3349",2017-05-01 10:22:37,81834.97,81834.9700000003
"3350",2017-05-01 10:31:51,100680.27,182515.24
"3351",2017-05-01 10:31:51,-81834.97,100680.27
"3352",2017-05-01 10:36:54,-100680.27,2.7648638933897e-10
"3353",2017-05-01 13:36:45,99955.99,99955.9900000003
"3354",2017-05-01 13:53:26,-99955.99,2.7648638933897e-10
"3355",2017-05-01 13:59:24,88429.51,88429.5100000003
"3356",2017-05-01 14:03:12,-88429.51,2.7648638933897e-10
"3357",2017-05-01 14:22:23,121976.69,121976.69
"3358",2017-05-01 14:36:49,-121976.69,2.7648638933897e-10
"3359",2017-05-01 14:36:49,87779.31,87779.3100000003
"3360",2017-05-01 14:36:49,111127.56,198906.87
"3361",2017-05-01 14:42:04,-198906.87,2.91038304567337e-10
"3362",2017-05-01 15:02:41,116016.67,116016.67
"3363",2017-05-01 15:07:34,-116016.67,2.91038304567337e-10
"3364",2017-05-01 16:20:25,12922.82,12922.8200000003
"3365",2017-05-01 16:27:59,87581.94,100504.76
"3366",2017-05-01 16:27:59,98724.87,199229.63
"3367",2017-05-01 16:45:44,89857.21,289086.84
"3368",2017-05-01 20:42:51,-289086.84,2.91038304567337e-10
"3369",2017-05-02 00:49:45,89006.36,89006.3600000003
"3370",2017-05-02 00:53:59,-89006.36,2.91038304567337e-10
"3371",2017-05-02 01:45:18,79123.85,79123.8500000003
"3372",2017-05-02 02:00:51,-79123.85,2.91038304567337e-10
"3373",2017-05-02 05:23:23,78507.9,78507.9000000003
"3374",2017-05-02 05:28:00,-78507.9,2.91038304567337e-10
"3375",2017-05-03 05:29:45,71722.04,71722.0400000003
"3376",2017-05-03 05:41:51,42459.88,114181.92
"3377",2017-05-03 05:41:51,-71722.04,42459.8800000003
"3378",2017-05-03 05:44:19,-42459.88,2.83762346953154e-10
"3379",2017-05-03 12:24:35,27106.79,27106.7900000003
"3380",2017-05-03 12:25:28,27625.52,54732.3100000003
"3381",2017-05-03 12:31:15,-54732.31,2.91038304567337e-10
"3382",2017-05-03 12:46:29,33597.05,33597.0500000003
"3383",2017-05-03 12:55:21,-33597.05,2.91038304567337e-10
"3384",2017-05-03 15:06:13,30404.3,30404.3000000003
"3385",2017-05-03 15:10:56,-30404.3,2.91038304567337e-10
"3386",2017-05-03 15:33:03,31415.12,31415.1200000003
"3387",2017-05-03 15:33:03,58963.89,90379.0100000003
"3388",2017-05-03 15:48:43,-90379.01,2.91038304567337e-10
"3389",2017-05-03 17:19:25,43193.77,43193.7700000003
"3390",2017-05-03 17:33:02,-43193.77,2.91038304567337e-10
"3391",2017-05-03 18:06:41,158632.41,158632.41
"3392",2017-05-03 18:11:47,78667.1,237299.51
"3393",2017-05-03 18:11:47,-158632.41,78667.1000000003
"3394",2017-05-03 18:16:29,-78667.1,2.91038304567337e-10
"3395",2017-05-03 18:44:39,77604.49,77604.4900000003
"3396",2017-05-03 18:44:39,109510.82,187115.31
"3397",2017-05-03 18:55:39,62695.33,249810.64
"3398",2017-05-03 18:55:39,-187115.31,62695.3300000003
"3399",2017-05-03 19:07:17,-62695.33,3.05590219795704e-10
"3400",2017-05-03 19:07:17,33452.9,33452.9000000003
"3401",2017-05-03 19:22:17,-33452.9,3.05590219795704e-10
"3402",2017-05-03 19:22:17,45527.25,45527.2500000003
"3403",2017-05-03 19:34:19,58828.97,104356.22
"3404",2017-05-03 19:34:19,-45527.25,58828.9700000003
"3405",2017-05-03 19:50:14,62847.94,121676.91
"3406",2017-05-03 19:50:14,-58828.97,62847.9400000003
"3407",2017-05-03 19:57:38,-62847.94,3.05590219795704e-10
"3408",2017-05-03 20:00:46,45076.53,45076.5300000003
"3409",2017-05-03 20:57:41,31546.9,76623.4300000003
"3410",2017-05-03 20:59:08,-45076.53,31546.9000000003
"3411",2017-05-03 21:04:58,-31546.9,3.12866177409887e-10
"3412",2017-05-03 22:18:02,27900.65,27900.6500000003
"3413",2017-05-03 22:28:03,-27900.65,3.12866177409887e-10
"3414",2017-05-03 23:17:31,25986.53,25986.5300000003
"3415",2017-05-03 23:54:56,-25986.53,3.12866177409887e-10
"3416",2017-05-04 01:23:47,31958.8,31958.8000000003
"3417",2017-05-04 01:28:42,-31958.8,3.12866177409887e-10
"3418",2017-05-04 01:49:42,11692.62,11692.6200000003
"3419",2017-05-04 01:55:03,-11692.62,3.12866177409887e-10
"3420",2017-05-04 03:38:51,49221.63,49221.6300000003
"3421",2017-05-04 03:49:50,-49221.63,3.12866177409887e-10
"3422",2017-05-04 10:38:07,79016.02,79016.0200000003
"3423",2017-05-04 11:01:58,-79016.02,3.05590219795704e-10
"3424",2017-05-04 11:36:32,44422.46,44422.4600000003
"3425",2017-05-04 11:38:29,-44422.46,3.05590219795704e-10
"3426",2017-05-04 12:15:30,28264.01,28264.0100000003
"3427",2017-05-04 12:29:39,-28264.01,3.05590219795704e-10
"3428",2017-05-04 14:58:55,55433.45,55433.4500000003
"3429",2017-05-04 15:02:58,-55433.45,3.05590219795704e-10
"3430",2017-05-04 15:15:52,50214.32,50214.3200000003
"3431",2017-05-04 15:15:52,87332.59,137546.91
"3432",2017-05-04 15:15:52,33418.74,170965.65
"3433",2017-05-04 15:20:13,-170965.65,2.91038304567337e-10
"3434",2017-05-04 15:26:59,4544.46,4544.46000000029
"3435",2017-05-04 15:51:28,93983.86,98528.3200000003
"3436",2017-05-04 15:51:28,52349.85,150878.17
"3437",2017-05-04 15:51:28,-4544.46,146333.71
"3438",2017-05-04 16:07:53,59565.63,205899.34
"3439",2017-05-04 16:07:53,54690.62,260589.96
"3440",2017-05-04 16:07:53,45750.31,306340.27
"3441",2017-05-04 16:07:53,76326.41,382666.68
"3442",2017-05-04 16:07:53,-146333.71,236332.97
"3443",2017-05-04 16:07:53,45280.93,281613.9
"3444",2017-05-04 16:11:04,-281613.9,2.91038304567337e-10
"3445",2017-05-04 16:59:43,41916.65,41916.6500000003
"3446",2017-05-04 16:59:43,32834.76,74751.4100000003
"3447",2017-05-04 17:01:42,77175.17,151926.58
"3448",2017-05-04 17:07:37,-151926.58,3.20142135024071e-10
"3449",2017-05-04 17:14:15,53885.29,53885.2900000003
"3450",2017-05-04 17:40:15,52338.9,106224.19
"3451",2017-05-04 18:05:27,55044.42,161268.61
"3452",2017-05-04 18:05:27,82783.53,244052.14
"3453",2017-05-04 18:05:27,98774.88,342827.02
"3454",2017-05-04 18:05:27,42928.64,385755.66
"3455",2017-05-04 18:09:27,-385755.66,4.07453626394272e-10
"3456",2017-05-04 18:16:55,68231.94,68231.9400000004
"3457",2017-05-04 18:23:40,46169.99,114401.93
"3458",2017-05-04 18:44:48,65074.22,179476.15
"3459",2017-05-04 18:44:48,43297.86,222774.01
"3460",2017-05-04 18:44:48,158172.29,380946.3
"3461",2017-05-04 18:44:48,-114401.93,266544.37
"3462",2017-05-04 18:50:23,44855.35,311399.72
"3463",2017-05-04 18:50:23,-266544.37,44855.3500000004
"3464",2017-05-04 18:54:08,-44855.35,3.85625753551722e-10
"3465",2017-05-04 18:58:12,64520.43,64520.4300000004
"3466",2017-05-04 19:06:08,50047.14,114567.57
"3467",2017-05-04 19:06:08,-64520.43,50047.1400000004
"3468",2017-05-04 19:13:25,60773.31,110820.45
"3469",2017-05-04 19:13:25,-50047.14,60773.3100000004
"3470",2017-05-04 19:24:13,31815.5,92588.8100000004
"3471",2017-05-04 19:28:04,56019.5,148608.31
"3472",2017-05-04 19:28:04,32937.75,181546.06
"3473",2017-05-04 19:28:04,-92588.81,88957.2500000004
"3474",2017-05-04 19:28:04,-60773.31,28183.9400000004
"3475",2017-05-04 19:32:05,-28183.94,4.11091605201364e-10
"3476",2017-05-04 19:38:13,34147.33,34147.3300000004
"3477",2017-05-04 19:53:21,32815.83,66963.1600000004
"3478",2017-05-04 19:53:21,-34147.33,32815.8300000004
"3479",2017-05-04 20:00:08,-32815.83,4.07453626394272e-10
"3480",2017-05-04 20:06:11,40978.47,40978.4700000004
"3481",2017-05-04 20:23:23,33117.91,74096.3800000004
"3482",2017-05-04 20:23:23,-40978.47,33117.9100000004
"3483",2017-05-04 20:31:09,-33117.91,4.07453626394272e-10
"3484",2017-05-04 21:18:56,88225.74,88225.7400000004
"3485",2017-05-04 21:18:56,97805.35,186031.09
"3486",2017-05-04 21:18:56,100143,286174.09
"3487",2017-05-04 21:22:22,-286174.09,4.07453626394272e-10
"3488",2017-05-04 21:44:02,81094.11,81094.1100000004
"3489",2017-05-04 21:44:02,83632.43,164726.54
"3490",2017-05-04 22:03:09,27546.91,192273.45
"3491",2017-05-04 22:03:09,27107.93,219381.38
"3492",2017-05-04 22:03:09,-164726.54,54654.8400000004
"3493",2017-05-04 22:06:13,43465.08,98119.9200000004
"3494",2017-05-04 22:06:13,-54654.84,43465.0800000004
"3495",2017-05-04 22:27:47,66938.4,110403.48
"3496",2017-05-04 22:27:47,62680.7,173084.18
"3497",2017-05-04 23:43:36,68623.11,241707.29
"3498",2017-05-04 23:43:36,34526.46,276233.75
"3499",2017-05-04 23:43:36,85451.66,361685.41
"3500",2017-05-04 23:55:52,30280.94,391966.35
"3501",2017-05-05 00:14:38,59001.19,450967.54
"3502",2017-05-05 00:14:38,125024.82,575992.36
"3503",2017-05-05 00:22:11,30336.66,606329.02
"3504",2017-05-05 00:24:01,4105.87,610434.89
"3505",2017-05-05 01:25:12,-610434.89,3.49245965480804e-10
"3506",2017-05-05 02:09:14,74512.5,74512.5000000003
"3507",2017-05-05 02:55:21,-74512.5,3.49245965480804e-10
"3508",2017-05-05 03:28:41,81903.91,81903.9100000004
"3509",2017-05-05 05:00:49,-81903.91,3.49245965480804e-10
"3510",2017-05-05 07:38:29,88724.39,88724.3900000003
"3511",2017-05-05 07:38:29,98940.27,187664.66
"3512",2017-05-05 07:42:14,-187664.66,3.49245965480804e-10
"3513",2017-05-05 07:51:42,68878.93,68878.9300000003
"3514",2017-05-05 07:57:21,-68878.93,3.49245965480804e-10
"3515",2017-05-05 08:30:53,117563.27,117563.27
"3516",2017-05-05 08:30:53,65689.82,183253.09
"3517",2017-05-05 08:31:45,69436.4,252689.49
"3518",2017-05-05 08:39:19,-252689.49,3.78349795937538e-10
"3519",2017-05-05 08:53:45,74064.12,74064.1200000004
"3520",2017-05-05 09:10:15,92552.29,166616.41
"3521",2017-05-05 09:10:15,75522.26,242138.67
"3522",2017-05-05 09:10:15,-74064.12,168074.55
"3523",2017-05-05 09:13:47,-168074.55,4.07453626394272e-10
"3524",2017-05-05 09:28:18,75374.74,75374.7400000004
"3525",2017-05-05 09:36:38,-75374.74,4.07453626394272e-10
"3526",2017-05-05 10:43:45,79403.51,79403.5100000004
"3527",2017-05-05 11:04:30,-79403.51,4.07453626394272e-10
"3528",2017-05-05 12:53:19,109047.29,109047.29
"3529",2017-05-05 13:07:31,73698.31,182745.6
"3530",2017-05-05 13:07:31,81948.94,264694.54
"3531",2017-05-05 13:07:31,-109047.29,155647.25
"3532",2017-05-05 13:07:31,-109047.29,46599.9600000004
"3533",2017-05-05 13:21:27,-46599.96,4.14729584008455e-10
"3534",2017-05-05 13:21:27,93116.54,93116.5400000004
"3535",2017-05-05 13:56:45,78743.62,171860.16
"3536",2017-05-05 13:56:45,74149.11,246009.27
"3537",2017-05-05 13:56:45,91238.78,337248.05
"3538",2017-05-05 14:41:49,86463.68,423711.73
"3539",2017-05-05 14:41:49,81381.25,505092.98
"3540",2017-05-05 14:41:49,-337248.05,167844.93
"3541",2017-05-05 14:41:49,-93116.54,74728.3900000004
"3542",2017-05-05 14:53:04,-74728.39,4.07453626394272e-10
"3543",2017-05-05 15:10:23,93336.46,93336.4600000004
"3544",2017-05-05 15:24:47,74684.93,168021.39
"3545",2017-05-05 15:24:47,84995.75,253017.14
"3546",2017-05-05 15:24:47,78941.65,331958.79
"3547",2017-05-05 15:24:47,-93336.46,238622.33
"3548",2017-05-05 15:40:47,85290.51,323912.84
"3549",2017-05-05 15:40:47,79576.38,403489.22
"3550",2017-05-05 15:40:47,30660.95,434150.17
"3551",2017-05-05 15:40:47,-238622.33,195527.84
"3552",2017-05-05 15:50:44,-195527.84,4.07453626394272e-10
"3553",2017-05-05 15:54:34,124216.87,124216.87
"3554",2017-05-05 16:11:15,78193.77,202410.64
"3555",2017-05-05 16:11:15,-124216.87,78193.7700000004
"3556",2017-05-05 16:18:52,-78193.77,4.22005541622639e-10
"3557",2017-05-05 16:26:32,72285.93,72285.9300000004
"3558",2017-05-05 16:49:15,32365.51,104651.44
"3559",2017-05-05 16:49:15,80914.35,185565.79
"3560",2017-05-05 16:57:37,76475.11,262040.9
"3561",2017-05-05 16:57:37,-72285.93,189754.97
"3562",2017-05-05 16:57:37,-185565.79,4189.18000000043
"3563",2017-05-05 17:28:42,77830.44,82019.6200000004
"3564",2017-05-05 17:28:42,67410.36,149429.98
"3565",2017-05-05 17:28:42,177830.5,327260.48
"3566",2017-05-05 18:03:38,29668.97,356929.45
"3567",2017-05-05 19:55:12,81267.48,438196.93
"3568",2017-05-05 20:01:58,45914.55,484111.48
"3569",2017-05-05 20:04:26,29791.01,513902.49
"3570",2017-05-05 20:16:41,44274.83,558177.32
"3571",2017-05-05 20:16:41,47029.03,605206.35
"3572",2017-05-05 20:16:41,-4189.18,601017.17
"3573",2017-05-05 20:16:41,-327260.48,273756.69
"3574",2017-05-05 20:19:33,-273756.69,4.07453626394272e-10
"3575",2017-05-05 20:24:46,46290.73,46290.7300000004
"3576",2017-05-05 20:41:49,-46290.73,4.07453626394272e-10
"3577",2017-05-05 21:04:40,46166.89,46166.8900000004
"3578",2017-05-05 21:08:56,-46166.89,4.07453626394272e-10
"3579",2017-05-05 21:08:56,43289.6,43289.6000000004
"3580",2017-05-05 21:20:21,-43289.6,4.07453626394272e-10
"3581",2017-05-05 21:56:23,28653.65,28653.6500000004
"3582",2017-05-05 22:33:32,-28653.65,4.07453626394272e-10
"3583",2017-05-07 07:28:52,67172.44,67172.4400000004
"3584",2017-05-07 07:36:55,-67172.44,4.07453626394272e-10
"3585",2017-05-07 07:46:11,77830.48,77830.4800000004
"3586",2017-05-07 07:45:14,-77830.48,4.07453626394272e-10
"3587",2017-05-07 09:25:07,38609.62,38609.6200000004
"3588",2017-05-07 09:34:46,-38609.62,4.07453626394272e-10
"3589",2017-05-07 09:34:46,60017.24,60017.2400000004
"3590",2017-05-07 09:41:21,-60017.24,4.07453626394272e-10
"3591",2017-05-07 09:45:10,26317.98,26317.9800000004
"3592",2017-05-07 09:48:35,43645.09,69963.0700000004
"3593",2017-05-07 09:48:35,-26317.98,43645.0900000004
"3594",2017-05-07 09:48:35,-26317.98,17327.1100000004
"3595",2017-05-07 09:58:14,-17327.11,4.0381564758718e-10
"3596",2017-05-07 10:16:39,54059.11,54059.1100000004
"3597",2017-05-07 10:22:55,-54059.11,4.07453626394272e-10
"3598",2017-05-07 10:26:16,32220.63,32220.6300000004
"3599",2017-05-07 10:41:02,82864.82,115085.45
"3600",2017-05-07 10:41:02,28787.45,143872.9
"3601",2017-05-07 10:51:37,36877.54,180750.44
"3602",2017-05-07 11:02:14,-180750.44,4.36557456851006e-10
"3603",2017-05-07 15:42:57,68543.85,68543.8500000004
"3604",2017-05-07 16:04:47,86153.44,154697.29
"3605",2017-05-07 16:04:47,-68543.85,86153.4400000004
"3606",2017-05-07 16:04:47,-68543.85,17609.5900000004
"3607",2017-05-07 16:21:12,-17609.59,4.32919478043914e-10
"3608",2017-05-07 16:37:48,89582.75,89582.7500000004
"3609",2017-05-07 17:09:24,65337.48,154920.23
"3610",2017-05-07 17:16:33,-154920.23,4.36557456851006e-10
"3611",2017-05-07 20:27:06,87252.2,87252.2000000004
"3612",2017-05-07 20:41:17,-87252.2,4.36557456851006e-10
"3613",2017-05-07 21:48:47,88661.55,88661.5500000004
"3614",2017-05-07 21:48:47,135132.02,223793.57
"3615",2017-05-07 22:05:28,-223793.57,4.07453626394272e-10
"3616",2017-05-08 02:08:20,84622.41,84622.4100000004
"3617",2017-05-08 02:21:52,-84622.41,4.07453626394272e-10
"3618",2017-05-08 02:35:19,84410.59,84410.5900000004
"3619",2017-05-08 02:38:45,-84410.59,4.07453626394272e-10
"3620",2017-05-08 02:42:47,89253.33,89253.3300000004
"3621",2017-05-08 02:53:52,89416.05,178669.38
"3622",2017-05-08 02:53:52,-89253.33,89416.0500000004
"3623",2017-05-08 02:53:52,-89253.33,162.720000000409
"3624",2017-05-08 03:01:22,-162.72,4.08618916480918e-10
"3625",2017-05-08 03:57:32,52837.11,52837.1100000004
"3626",2017-05-08 04:19:11,86437.41,139274.52
"3627",2017-05-08 04:19:11,-52837.11,86437.4100000004
"3628",2017-05-08 04:25:50,46842.8,133280.21
"3629",2017-05-08 04:25:50,40246.13,173526.34
"3630",2017-05-08 04:25:50,-86437.41,87088.9300000004
"3631",2017-05-08 04:31:22,30241.54,117330.47
"3632",2017-05-08 04:31:22,-87088.93,30241.5400000004
"3633",2017-05-08 04:40:29,-30241.54,4.43833414465189e-10
"3634",2017-05-08 05:35:35,77640.94,77640.9400000004
"3635",2017-05-08 05:46:45,95784.7,173425.64
"3636",2017-05-08 05:51:20,-173425.64,4.07453626394272e-10
"3637",2017-05-09 10:46:44,300055.3,300055.3
"3638",2017-05-09 10:53:08,-300055.3,4.07453626394272e-10
"3639",2017-05-09 15:35:43,82862.56,82862.5600000004
"3640",2017-05-09 15:47:03,-82862.56,4.07453626394272e-10
"3641",2017-05-09 16:20:15,106422.91,106422.91
"3642",2017-05-09 16:53:51,-106422.91,4.07453626394272e-10
"3643",2017-05-09 18:01:58,80187.86,80187.8600000004
"3644",2017-05-09 18:43:44,78844.26,159032.12
"3645",2017-05-09 18:43:44,159191.21,318223.33
"3646",2017-05-09 18:44:17,-80187.86,238035.47
"3647",2017-05-09 18:44:17,-80187.86,157847.61
"3648",2017-05-09 18:54:36,83042.68,240890.29
"3649",2017-05-09 19:09:01,77777.09,318667.38
"3650",2017-05-09 19:09:01,-240890.29,77777.0900000005
"3651",2017-05-09 19:14:21,-77777.09,4.65661287307739e-10
"3652",2017-05-09 20:48:12,85917.13,85917.1300000005
"3653",2017-05-09 21:04:50,82532.66,168449.79
"3654",2017-05-09 21:04:50,177777.14,346226.930000001
"3655",2017-05-09 21:41:44,47095.28,393322.210000001
"3656",2017-05-09 21:42:11,105648.05,498970.260000001
"3657",2017-05-09 22:00:59,113924.55,612894.810000001
"3658",2017-05-09 23:14:32,-612894.81,4.65661287307739e-10
"3659",2017-05-10 02:12:53,52761.4,52761.4000000005
"3660",2017-05-10 03:21:17,-52761.4,4.65661287307739e-10
"3661",2017-05-10 04:46:23,8001,8001.00000000047
"3662",2017-05-10 04:48:21,51330.79,59331.7900000005
"3663",2017-05-10 04:48:21,78821.11,138152.9
"3664",2017-05-10 04:53:18,-138152.9,4.65661287307739e-10
"3665",2017-05-10 05:23:03,49784.94,49784.9400000005
"3666",2017-05-10 05:23:03,77780.81,127565.75
"3667",2017-05-10 05:23:03,40978.13,168543.88
"3668",2017-05-10 05:39:49,-168543.88,4.65661287307739e-10
"3669",2017-05-10 16:05:00,55602.48,55602.4800000005
"3670",2017-05-10 16:20:52,-55602.48,4.65661287307739e-10
"3671",2017-05-10 16:30:05,103151.87,103151.87
"3672",2017-05-10 16:44:14,-103151.87,4.65661287307739e-10
"3673",2017-05-10 18:18:35,87459.44,87459.4400000005
"3674",2017-05-10 18:36:42,-87459.44,4.65661287307739e-10
"3675",2017-05-11 00:20:53,86761.95,86761.9500000005
"3676",2017-05-11 00:24:58,-86761.95,4.65661287307739e-10
"3677",2017-05-11 02:16:49,60075.34,60075.3400000005
"3678",2017-05-11 02:28:18,-60075.34,4.65661287307739e-10
"3679",2017-05-11 02:28:18,88385.65,88385.6500000005
"3680",2017-05-11 02:36:47,-88385.65,4.65661287307739e-10
"3681",2017-05-11 02:51:49,112439.17,112439.17
"3682",2017-05-11 03:00:07,-112439.17,4.65661287307739e-10
"3683",2017-05-11 03:05:39,93097.1,93097.1000000005
"3684",2017-05-11 03:35:57,42678.88,135775.98
"3685",2017-05-11 03:35:57,-93097.1,42678.8800000005
"3686",2017-05-11 03:42:10,-42678.88,4.72937244921923e-10
"3687",2017-05-11 03:59:41,78744.51,78744.5100000005
"3688",2017-05-11 04:33:03,-78744.51,4.80213202536106e-10
"3689",2017-05-11 05:05:29,88888.7,88888.7000000005
"3690",2017-05-11 05:14:20,-88888.7,4.80213202536106e-10
"3691",2017-05-11 05:55:37,59558.89,59558.8900000005
"3692",2017-05-11 06:07:09,-59558.89,4.80213202536106e-10
"3693",2017-05-11 07:50:50,54550.46,54550.4600000005
"3694",2017-05-11 07:50:50,77777.79,132328.25
"3695",2017-05-11 07:50:50,77777.77,210106.02
"3696",2017-05-11 08:15:54,-210106.02,4.94765117764473e-10
"3697",2017-05-11 08:21:34,63771.74,63771.7400000005
"3698",2017-05-11 08:21:34,77777.78,141549.52
"3699",2017-05-11 08:44:46,77777.81,219327.33
"3700",2017-05-11 08:44:46,88888.82,308216.15
"3701",2017-05-11 08:44:46,-141549.52,166666.63
"3702",2017-05-11 09:04:49,-166666.63,4.94765117764473e-10
"3703",2017-05-11 09:47:42,88888.84,88888.8400000005
"3704",2017-05-11 09:51:17,-88888.84,4.94765117764473e-10
"3705",2017-05-11 10:16:52,88888.85,88888.8500000005
"3706",2017-05-11 10:16:52,-88888.84,0.0100000005040783
"3707",2017-05-11 19:53:46,77777.92,77777.9300000005
"3708",2017-05-11 20:11:49,88851.78,166629.71
"3709",2017-05-11 20:46:42,89055.25,255684.96
"3710",2017-05-11 21:06:34,75534.76,331219.72
"3711",2017-05-11 22:03:59,177777.96,508997.680000001
"3712",2017-05-11 22:12:39,-331219.72,177777.960000001
"3713",2017-05-11 23:38:48,-77777.93,100000.030000001
"3714",2017-05-12 00:22:13,-100000.03,5.5297277867794e-10
"3715",2017-05-12 01:02:59,77777.98,77777.9800000005
"3716",2017-05-12 01:19:55,-77777.98,5.5297277867794e-10
"3717",2017-05-12 05:20:24,82628.89,82628.8900000006
"3718",2017-05-12 05:43:01,42071.36,124700.250000001
"3719",2017-05-12 05:43:01,48526.53,173226.780000001
"3720",2017-05-12 05:54:27,-82628.89,90597.8900000006
"3721",2017-05-12 06:01:57,-90597.89,5.5297277867794e-10
"3722",2017-05-12 08:55:29,31700.38,31700.3800000006
"3723",2017-05-12 09:04:32,-31700.38,5.5297277867794e-10
"3724",2017-05-12 09:09:04,34196.27,34196.2700000005
"3725",2017-05-12 09:25:45,40403.54,74599.8100000006
"3726",2017-05-12 09:27:45,-34196.27,40403.5400000006
"3727",2017-05-12 09:40:23,63293.44,103696.980000001
"3728",2017-05-12 09:40:23,-40403.54,63293.4400000006
"3729",2017-05-12 10:11:57,35157.01,98450.4500000006
"3730",2017-05-12 10:15:49,5338.97,103789.420000001
"3731",2017-05-12 10:15:49,-40403.54,63385.8800000006
"3732",2017-05-12 10:15:49,4847.51,68233.3900000006
"3733",2017-05-12 10:19:07,6553.21,74786.6000000006
"3734",2017-05-12 10:19:07,-68233.39,6553.21000000057
"3735",2017-05-12 10:19:07,33507.71,40060.9200000006
"3736",2017-05-12 10:28:50,39826.44,79887.3600000006
"3737",2017-05-12 10:28:50,-40060.92,39826.4400000006
"3738",2017-05-12 10:41:19,30879.16,70705.6000000006
"3739",2017-05-12 10:41:19,-39826.44,30879.1600000006
"3740",2017-05-12 10:45:24,-30879.16,5.71162672713399e-10
"3741",2017-05-12 10:49:59,39718.06,39718.0600000006
"3742",2017-05-12 10:55:22,-39718.06,5.67524693906307e-10
"3743",2017-05-12 11:08:21,47804.43,47804.4300000006
"3744",2017-05-12 11:23:12,-47804.43,5.67524693906307e-10
"3745",2017-05-12 11:34:03,37916.89,37916.8900000006
"3746",2017-05-12 11:42:49,-37916.89,5.67524693906307e-10
"3747",2017-05-12 12:23:41,37549.56,37549.5600000006
"3748",2017-05-12 12:39:51,-37549.56,5.67524693906307e-10
"3749",2017-05-12 12:43:33,29943.86,29943.8600000006
"3750",2017-05-12 13:13:37,-29943.86,5.67524693906307e-10
"3751",2017-05-12 13:42:04,41664.24,41664.2400000006
"3752",2017-05-12 13:42:04,39676.81,81341.0500000006
"3753",2017-05-12 13:46:51,-81341.05,5.67524693906307e-10
"3754",2017-05-12 20:52:12,33261.93,33261.9300000006
"3755",2017-05-12 20:52:12,62975.24,96237.1700000006
"3756",2017-05-12 21:11:40,-96237.17,5.67524693906307e-10
"3757",2017-05-12 23:21:10,36694.19,36694.1900000006
"3758",2017-05-12 23:40:09,33568.49,70262.6800000006
"3759",2017-05-13 00:13:48,30368.64,100631.320000001
"3760",2017-05-13 00:13:48,33246.48,133877.800000001
"3761",2017-05-13 00:13:48,-70262.68,63615.1200000006
"3762",2017-05-13 00:13:48,-36694.19,26920.9300000006
"3763",2017-05-13 00:22:27,-26920.93,5.74800651520491e-10
"3764",2017-05-13 00:33:34,31884.93,31884.9300000006
"3765",2017-05-13 01:48:21,-31884.93,5.74800651520491e-10
"3766",2017-05-13 02:22:55,33219.42,33219.4200000006
"3767",2017-05-13 02:22:55,64410.92,97630.3400000006
"3768",2017-05-13 02:22:55,39528.27,137158.610000001
"3769",2017-05-13 02:24:46,52759.01,189917.620000001
"3770",2017-05-13 02:27:08,-189917.62,5.82076609134674e-10
"3771",2017-05-13 02:35:11,121610.26,121610.260000001
"3772",2017-05-13 02:37:42,39804.22,161414.480000001
"3773",2017-05-13 02:37:42,-121610.26,39804.2200000006
"3774",2017-05-13 02:40:01,31474.76,71278.9800000006
"3775",2017-05-13 02:47:33,-39804.22,31474.7600000006
"3776",2017-05-13 02:54:18,-31474.76,5.63886715099216e-10
"3777",2017-05-13 02:54:18,29887.13,29887.1300000006
"3778",2017-05-13 03:14:50,40250.54,70137.6700000006
"3779",2017-05-13 03:14:50,74768.06,144905.730000001
"3780",2017-05-13 03:14:50,39743.99,184649.720000001
"3781",2017-05-13 03:14:50,-29887.13,154762.590000001
"3782",2017-05-13 03:18:35,-154762.59,5.5297277867794e-10
"3783",2017-05-13 03:29:38,77778.51,77778.5100000005
"3784",2017-05-13 03:34:20,-77778.51,5.5297277867794e-10
"3785",2017-05-13 04:32:35,60384.57,60384.5700000006
"3786",2017-05-13 04:35:04,38192.02,98576.5900000005
"3787",2017-05-13 04:35:04,-60384.57,38192.0200000005
"3788",2017-05-13 06:02:26,30934.92,69126.9400000006
"3789",2017-05-13 06:02:26,42120.81,111247.750000001
"3790",2017-05-13 06:02:26,32502.6,143750.350000001
"3791",2017-05-13 06:02:26,30110.62,173860.970000001
"3792",2017-05-13 06:02:26,37799.53,211660.500000001
"3793",2017-05-13 06:13:57,65731.13,277391.630000001
"3794",2017-05-13 06:35:34,83983.65,361375.280000001
"3795",2017-05-13 06:43:14,33915.79,395291.070000001
"3796",2017-05-13 06:43:14,-38192.02,357099.050000001
"3797",2017-05-13 06:43:14,-38192.02,318907.030000001
"3798",2017-05-13 06:43:14,-277391.63,41515.4000000005
"3799",2017-05-13 06:46:42,37988.09,79503.4900000005
"3800",2017-05-13 06:46:42,-41515.4,37988.0900000005
"3801",2017-05-13 06:59:24,32400.15,70388.2400000005
"3802",2017-05-13 06:59:24,-37988.09,32400.1500000005
"3803",2017-05-13 07:07:07,-32400.15,5.45696821063757e-10
"3804",2017-05-13 07:22:38,34346.8,34346.8000000005
"3805",2017-05-13 07:30:53,42794.09,77140.8900000005
"3806",2017-05-13 07:30:53,-34346.8,42794.0900000005
"3807",2017-05-13 07:30:53,-34346.8,8447.29000000053
"3808",2017-05-13 07:52:17,88889.67,97336.9600000005
"3809",2017-05-13 07:52:17,-8447.29,88889.6700000005
"3810",2017-05-13 07:52:17,-8447.29,80442.3800000005
"3811",2017-05-13 08:08:48,-80442.38,5.23868948221207e-10
"3812",2017-05-13 10:21:30,10653.85,10653.8500000005
"3813",2017-05-13 10:44:18,-10653.85,5.23868948221207e-10
"3814",2017-05-13 11:36:38,5639.08,5639.08000000052
"3815",2017-05-13 12:00:17,-5639.08,5.23868948221207e-10
"3816",2017-05-13 12:09:08,4354.28,4354.28000000052
"3817",2017-05-13 12:18:02,-4354.28,5.23868948221207e-10
"3818",2017-05-13 12:18:02,5946.51,5946.51000000052
"3819",2017-05-13 12:48:23,-5946.51,5.23868948221207e-10
"3820",2017-05-13 12:48:30,8392.45,8392.45000000052
"3821",2017-05-13 13:10:10,-8392.45,5.23868948221207e-10
"3822",2017-05-13 21:55:48,60517.59,60517.5900000005
"3823",2017-05-13 22:03:37,38661.43,99179.0200000005
"3824",2017-05-13 22:03:37,-60517.59,38661.4300000005
"3825",2017-05-13 22:14:02,-38661.43,5.16592990607023e-10
"3826",2017-05-13 22:55:29,24514.37,24514.3700000005
"3827",2017-05-13 23:20:19,-24514.37,5.16592990607023e-10
"3828",2017-05-14 09:20:33,56773.39,56773.3900000005
"3829",2017-05-14 09:55:34,28994.15,85767.5400000005
"3830",2017-05-14 09:55:34,-56773.39,28994.1500000005
"3831",2017-05-14 10:00:56,-28994.15,5.16592990607023e-10
"3832",2017-05-14 10:38:33,7751.01,7751.01000000052
"3833",2017-05-14 10:41:36,-7751.01,5.16592990607023e-10
"3834",2017-05-14 13:16:21,78167.36,78167.3600000005
"3835",2017-05-14 13:19:21,-78167.36,5.0931703299284e-10
"3836",2017-05-14 13:35:19,63443.33,63443.3300000005
"3837",2017-05-14 13:46:48,-63443.33,5.0931703299284e-10
"3838",2017-05-14 14:39:33,62940.47,62940.4700000005
"3839",2017-05-14 14:46:40,-62940.47,5.0931703299284e-10
"3840",2017-05-14 14:55:05,25472.49,25472.4900000005
"3841",2017-05-14 15:05:06,-25472.49,5.0931703299284e-10
"3842",2017-05-14 18:15:56,38088.12,38088.1200000005
"3843",2017-05-14 18:31:33,-38088.12,5.0931703299284e-10
"3844",2017-05-14 18:40:24,75056.3,75056.3000000005
"3845",2017-05-14 18:43:48,-75056.3,5.0931703299284e-10
"3846",2017-05-14 20:21:08,80689.87,80689.8700000005
"3847",2017-05-14 20:51:25,69746.04,150435.91
"3848",2017-05-14 21:20:22,57540.14,207976.050000001
"3849",2017-05-14 22:51:36,40548.8,248524.850000001
"3850",2017-05-15 00:15:00,61652.03,310176.88
"3851",2017-05-15 02:48:45,64241.76,374418.64
"3852",2017-05-15 02:53:19,-374418.64,4.65661287307739e-10
"3853",2017-05-15 06:00:02,88531.61,88531.6100000005
"3854",2017-05-15 06:00:02,77777.56,166309.17
"3855",2017-05-15 06:06:26,-166309.17,4.36557456851006e-10
"3856",2017-05-15 06:17:29,32459.4,32459.4000000004
"3857",2017-05-15 06:27:25,-32459.4,4.36557456851006e-10
"3858",2017-05-15 06:37:38,65490.56,65490.5600000004
"3859",2017-05-15 06:39:35,-65490.56,4.36557456851006e-10
"3860",2017-05-15 10:24:33,39625.78,39625.7800000004
"3861",2017-05-15 10:31:53,-39625.78,4.36557456851006e-10
"3862",2017-05-15 14:20:47,42179.95,42179.9500000004
"3863",2017-05-15 15:04:07,-42179.95,4.36557456851006e-10
"3864",2017-05-15 20:35:45,70725.39,70725.3900000004
"3865",2017-05-15 20:37:58,-70725.39,4.36557456851006e-10
"3866",2017-05-15 20:42:07,69107.87,69107.8700000004
"3867",2017-05-15 21:15:51,28103.55,97211.4200000004
"3868",2017-05-15 21:15:51,-69107.87,28103.5500000004
"3869",2017-05-15 21:31:29,84435.59,112539.14
"3870",2017-05-15 21:31:29,-69107.87,43431.2700000004
"3871",2017-05-15 21:46:38,-43431.27,4.43833414465189e-10
"3872",2017-05-15 22:12:39,61296.13,61296.1300000004
"3873",2017-05-15 23:02:45,-61296.13,4.43833414465189e-10
"3874",2017-05-15 23:33:44,83103.18,83103.1800000004
"3875",2017-05-15 23:46:48,-83103.18,4.36557456851006e-10
"3876",2017-05-16 00:35:24,73354.81,73354.8100000004
"3877",2017-05-16 00:36:35,73102.33,146457.14
"3878",2017-05-16 00:41:32,-146457.14,4.07453626394272e-10
"3879",2017-05-16 00:56:22,69201.74,69201.7400000004
"3880",2017-05-16 00:59:16,-69201.74,4.07453626394272e-10
"3881",2017-05-16 01:24:16,62994.49,62994.4900000004
"3882",2017-05-16 02:28:38,71694.68,134689.17
"3883",2017-05-16 02:28:38,69851.39,204540.56
"3884",2017-05-16 02:32:21,75272.18,279812.74
"3885",2017-05-16 02:42:57,109788.38,389601.12
"3886",2017-05-16 02:42:57,84966.51,474567.63
"3887",2017-05-16 03:21:59,67614.83,542182.46
"3888",2017-05-16 03:21:59,-62994.49,479187.97
"3889",2017-05-16 03:21:59,-62994.49,416193.48
"3890",2017-05-16 03:21:59,-204540.56,211652.92
"3891",2017-05-16 03:21:59,-62994.49,148658.43
"3892",2017-05-16 03:29:35,-148658.43,4.65661287307739e-10
"3893",2017-05-16 03:48:50,76119.74,76119.7400000005
"3894",2017-05-16 04:06:09,-76119.74,4.65661287307739e-10
"3895",2017-05-16 04:52:51,73622.87,73622.8700000005
"3896",2017-05-16 05:06:51,-73622.87,4.65661287307739e-10
"3897",2017-05-16 07:16:14,80186.15,80186.1500000005
"3898",2017-05-16 07:30:01,-80186.15,4.65661287307739e-10
"3899",2017-05-17 06:04:26,23512.91,23512.9100000005
"3900",2017-05-17 16:06:47,-23512.91,4.65661287307739e-10
"3901",2017-05-17 20:57:38,149065.99,149065.99
"3902",2017-05-17 21:18:15,96695.04,245761.03
"3903",2017-05-17 21:32:06,-23512.91,222248.12
"3904",2017-05-17 21:32:06,-23512.91,198735.21
"3905",2017-05-17 21:32:06,-23512.91,175222.3
"3906",2017-05-17 22:11:11,67705.89,242928.19
"3907",2017-05-17 22:37:20,75914.56,318842.75
"3908",2017-05-17 23:11:25,61780.29,380623.04
"3909",2017-05-17 23:11:25,83886.1,464509.14
"3910",2017-05-17 23:11:25,68684.87,533194.01
"3911",2017-05-17 23:59:55,42781.99,575976
"3912",2017-05-18 00:43:11,15912.02,591888.02
"3913",2017-05-18 01:05:01,41899.78,633787.8
"3914",2017-05-18 01:20:30,-23512.91,610274.89
"3915",2017-05-18 01:20:30,-23512.91,586761.98
"3916",2017-05-18 01:41:06,45093.44,631855.42
"3917",2017-05-18 01:41:06,40561.52,672416.94
"3918",2017-05-18 01:41:06,-23512.91,648904.03
"3919",2017-05-18 01:41:06,-23512.91,625391.12
"3920",2017-05-18 01:41:06,-23512.91,601878.21
"3921",2017-05-18 01:45:45,-23512.91,578365.3
"3922",2017-05-18 01:45:45,-23512.91,554852.39
"3923",2017-05-18 02:19:03,7468.38,562320.77
"3924",2017-05-18 03:17:10,44592.44,606913.21
"3925",2017-05-18 03:32:12,40818.43,647731.64
"3926",2017-05-18 03:44:43,59437.38,707169.02
"3927",2017-05-18 03:45:27,-23512.91,683656.11
"3928",2017-05-18 03:45:27,-23512.91,660143.2
"3929",2017-05-18 03:45:27,-23512.91,636630.29
"3930",2017-05-18 04:27:36,62034.1,698664.39
"3931",2017-05-18 04:27:36,-23512.91,675151.48
"3932",2017-05-18 04:48:09,-23512.91,651638.57
"3933",2017-05-18 04:48:09,44678.49,696317.06
"3934",2017-05-18 08:39:57,-696317.06,0
"3935",2017-05-18 09:42:34,75571.91,75571.91
"3936",2017-05-18 09:42:34,69557.2,145129.11
"3937",2017-05-18 09:42:34,48992.01,194121.12
"3938",2017-05-18 10:16:23,44720.16,238841.28
"3939",2017-05-18 10:48:21,44788.14,283629.42
"3940",2017-05-18 11:12:41,-194121.12,89508.3
"3941",2017-05-18 11:30:44,92890.82,182399.12
"3942",2017-05-18 11:30:44,52737.55,235136.67
"3943",2017-05-18 11:30:44,6618.69,241755.36
"3944",2017-05-18 11:48:23,-194121.12,47634.24
"3945",2017-05-18 12:31:10,39096.66,86730.9
"3946",2017-05-18 13:53:17,-47634.24,39096.66
"3947",2017-05-18 14:08:42,56679.3,95775.96
"3948",2017-05-18 14:23:16,43052.14,138828.1
"3949",2017-05-18 14:23:16,-86730.9,52097.2
"3950",2017-05-18 14:23:16,-47634.24,4462.95999999998
"3951",2017-05-18 14:23:16,46423.17,50886.13
"3952",2017-05-18 14:36:09,53871.61,104757.74
"3953",2017-05-18 15:23:38,68645.44,173403.18
"3954",2017-05-18 15:24:06,-86730.9,86672.28
"3955",2017-05-18 15:36:37,-39096.66,47575.62
"3956",2017-05-18 16:43:19,-47575.62,-7.27595761418343e-12
"3957",2017-05-18 19:06:24,55780.24,55780.24
"3958",2017-05-18 19:41:10,79823.98,135604.22
"3959",2017-05-18 19:50:28,-55780.24,79823.98
"3960",2017-05-18 19:50:28,-55780.24,24043.74
"3961",2017-05-18 20:26:26,50583.51,74627.25
"3962",2017-05-18 20:26:26,-24043.74,50583.51
"3963",2017-05-18 20:31:04,-24043.74,26539.77
"3964",2017-05-18 21:17:22,-24043.74,2496.02999999998
"3965",2017-05-18 22:57:58,47802.23,50298.26
"3966",2017-05-18 23:34:42,66606.24,116904.5
"3967",2017-05-18 23:34:42,52666.79,169571.29
"3968",2017-05-19 06:18:01,67895.75,237467.04
"3969",2017-05-19 06:25:51,-237467.04,-2.91038304567337e-11
"3970",2017-05-19 07:52:08,41397.37,41397.37
"3971",2017-05-19 07:52:08,100003.78,141401.15
"3972",2017-05-19 08:01:06,55484.57,196885.72
"3973",2017-05-19 10:11:29,-141401.15,55484.57
"3974",2017-05-19 13:26:19,-55484.57,-2.18278728425503e-11
"3975",2017-05-19 14:39:29,40033.01,40033.01
"3976",2017-05-19 14:40:29,88891.87,128924.88
"3977",2017-05-19 14:40:29,-55484.57,73440.31
"3978",2017-05-19 14:40:29,-55484.57,17955.74
"3979",2017-05-19 16:02:16,77780.88,95736.62
"3980",2017-05-19 16:14:25,-17955.74,77780.88
"3981",2017-05-19 16:14:25,-17955.74,59825.14
"3982",2017-05-19 16:14:25,-17955.74,41869.4
"3983",2017-05-19 16:14:25,-17955.74,23913.6599999999
"3984",2017-05-19 16:20:35,-17955.74,5957.91999999995
"3985",2017-05-19 18:10:19,-5957.92,-5.27506927028298e-11
"3986",2017-05-20 01:45:52,7633.1,7633.09999999995
"3987",2017-05-20 01:51:55,14762.9,22395.9999999999
"3988",2017-05-20 03:19:57,76079.3,98475.3
"3989",2017-05-20 03:19:57,39998.13,138473.43
"3990",2017-05-20 03:31:05,-7633.1,130840.33
"3991",2017-05-20 03:31:17,38236.4,169076.73
"3992",2017-05-20 03:33:07,-7633.1,161443.63
"3993",2017-05-20 03:42:04,-22396,139047.63
"3994",2017-05-20 04:19:36,-22396,116651.63
"3995",2017-05-20 04:19:36,50409.06,167060.69
"3996",2017-05-20 04:55:27,-22396,144664.69
"3997",2017-05-20 04:55:27,-22396,122268.69
"3998",2017-05-20 05:42:47,-22396,99872.6899999999
"3999",2017-05-20 05:57:24,-22396,77476.6899999999
"4000",2017-05-20 05:57:24,-22396,55080.6899999999
"4001",2017-05-20 08:36:41,-55080.69,-5.82076609134674e-11
"4002",2017-05-20 11:06:40,13215.86,13215.8599999999
"4003",2017-05-20 11:29:10,50944.68,64160.5399999999
"4004",2017-05-20 11:29:10,37213.98,101374.52
"4005",2017-05-20 11:29:10,-55080.69,46293.8299999999
"4006",2017-05-20 11:29:10,46671.45,92965.2799999999
"4007",2017-05-20 11:29:10,46125.48,139090.76
"4008",2017-05-20 11:34:48,54826.27,193917.03
"4009",2017-05-20 12:36:10,40844.81,234761.84
"4010",2017-05-20 13:35:30,56562.02,291323.86
"4011",2017-05-20 13:58:51,40379.05,331702.91
"4012",2017-05-20 14:00:42,53345.69,385048.6
"4013",2017-05-20 14:11:15,72523.82,457572.42
"4014",2017-05-20 14:27:35,37344.38,494916.8
"4015",2017-05-20 14:28:51,37942.68,532859.48
"4016",2017-05-20 15:00:50,39501.7,572361.18
"4017",2017-05-20 15:00:50,53514.97,625876.15
"4018",2017-05-20 15:33:08,-139090.76,486785.39
"4019",2017-05-20 15:33:08,-13215.86,473569.53
"4020",2017-05-20 15:38:56,-193917.03,279652.5
"4021",2017-05-20 15:54:09,54503.77,334156.27
"4022",2017-05-20 15:54:09,-234761.84,99394.4299999999
"4023",2017-05-20 16:02:46,43998.22,143392.65
"4024",2017-05-20 16:02:46,39285.82,182678.47
"4025",2017-05-20 16:26:21,75262.89,257941.36
"4026",2017-05-20 16:44:45,-234761.84,23179.5199999999
"4027",2017-05-20 16:52:36,53311.73,76491.2499999999
"4028",2017-05-20 17:28:23,66522.7,143013.95
"4029",2017-05-20 17:55:05,66146.2,209160.15
"4030",2017-05-20 18:32:52,78518.69,287678.84
"4031",2017-05-20 19:24:58,42241.37,329920.21
"4032",2017-05-20 19:24:58,79363.05,409283.26
"4033",2017-05-20 19:48:08,41017.03,450300.29
"4034",2017-05-20 19:48:08,44711.53,495011.82
"4035",2017-05-20 19:48:08,55222.58,550234.4
"4036",2017-05-20 19:48:08,-532859.48,17374.9199999999
"4037",2017-05-20 20:00:46,52993.97,70368.8899999999
"4038",2017-05-20 20:41:17,48205.63,118574.52
"4039",2017-05-20 21:41:02,37606.54,156181.06
"4040",2017-05-20 22:28:15,-99394.43,56786.6299999999
"4041",2017-05-20 22:33:14,136770.12,193556.75
"4042",2017-05-20 22:33:14,43486.34,237043.09
"4043",2017-05-20 22:34:23,37786.66,274829.75
"4044",2017-05-20 22:43:16,-257941.36,16888.39
"4045",2017-05-21 01:20:08,-16888.39,-4.36557456851006e-11
"4046",2017-05-21 23:35:31,167152.83,167152.83
"4047",2017-05-21 23:35:31,77781.74,244934.57
"4048",2017-05-22 07:11:57,-244934.57,-5.82076609134674e-11
"4049",2017-05-22 09:26:11,53484.38,53484.3799999999
"4050",2017-05-22 09:45:04,77781.9,131266.28
"4051",2017-05-22 09:45:04,42688.94,173955.22
"4052",2017-05-22 10:23:46,195666.56,369621.78
"4053",2017-05-22 10:23:46,22304.69,391926.47
"4054",2017-05-22 10:33:46,45898.03,437824.5
"4055",2017-05-22 10:33:46,106947.39,544771.89
"4056",2017-05-22 11:00:37,44073.27,588845.16
"4057",2017-05-22 11:00:37,66999.07,655844.23
"4058",2017-05-22 11:00:37,65725.12,721569.35
"4059",2017-05-22 11:00:37,39658.28,761227.63
"4060",2017-05-22 11:34:52,81118.62,842346.25
"4061",2017-05-22 11:34:52,98130.8,940477.05
"4062",2017-05-22 11:34:52,23643.31,964120.36
"4063",2017-05-22 11:39:01,40552.91,1004673.27
"4064",2017-05-22 12:06:12,29478.99,1034152.26
"4065",2017-05-22 12:06:12,104071.9,1138224.16
"4066",2017-05-22 12:10:39,81546.57,1219770.73
"4067",2017-05-22 13:00:18,41185.51,1260956.24
"4068",2017-05-22 13:00:18,64520.28,1325476.52
"4069",2017-05-22 13:00:18,36590.81,1362067.33
"4070",2017-05-22 13:00:18,43954.96,1406022.29
"4071",2017-05-22 13:23:00,67591.05,1473613.34
"4072",2017-05-22 14:35:35,64744.39,1538357.73
"4073",2017-05-22 14:35:35,167403.53,1705761.26
"4074",2017-05-22 14:35:35,27585.42,1733346.68
"4075",2017-05-22 14:42:50,46708.46,1780055.14
"4076",2017-05-22 15:29:04,27397.44,1807452.58
"4077",2017-05-22 15:29:04,27147.37,1834599.95
"4078",2017-05-22 15:29:04,46652.21,1881252.16
"4079",2017-05-22 16:04:32,25529.71,1906781.87
"4080",2017-05-22 16:31:58,35682.87,1942464.74
"4081",2017-05-22 16:32:57,39411.01,1981875.75
"4082",2017-05-22 16:32:57,-244934.57,1736941.18
"4083",2017-05-22 16:42:18,51802.12,1788743.3
"4084",2017-05-22 17:06:16,77155.65,1865898.95
"4085",2017-05-22 17:29:22,52708.58,1918607.53
"4086",2017-05-22 17:29:22,46134.26,1964741.79
"4087",2017-05-22 17:34:34,52243.59,2016985.38
"4088",2017-05-22 17:40:34,-244934.57,1772050.81
"4089",2017-05-22 17:40:34,-244934.57,1527116.24
"4090",2017-05-22 17:40:34,34555.95,1561672.19
"4091",2017-05-22 17:54:15,25916.1,1587588.29
"4092",2017-05-22 17:54:15,42924.47,1630512.76
"4093",2017-05-22 18:05:11,-244934.57,1385578.19
"4094",2017-05-22 18:33:41,-244934.57,1140643.62
"4095",2017-05-22 18:40:23,88391.62,1229035.24
"4096",2017-05-22 18:44:21,-244934.57,984100.67
"4097",2017-05-22 18:52:06,-244934.57,739166.1
"4098",2017-05-22 19:27:34,-244934.57,494231.53
"4099",2017-05-22 19:41:11,-244934.57,249296.96
"4100",2017-05-22 20:09:49,-244934.57,4362.39000000007
"4101",2017-05-22 22:08:54,19992.28,24354.6700000001
"4102",2017-05-22 22:08:54,94995.97,119350.64
"4103",2017-05-22 22:47:52,-119350.64,7.27595761418343e-11
"4104",2017-05-22 23:00:49,70223.96,70223.9600000001
"4105",2017-05-22 23:05:11,-70223.96,7.27595761418343e-11
"4106",2017-05-22 23:09:15,135339.59,135339.59
"4107",2017-05-22 23:37:11,-135339.59,8.73114913702011e-11
"4108",2017-05-22 23:37:11,57058.74,57058.7400000001
"4109",2017-05-22 23:37:11,82362.41,139421.15
"4110",2017-05-22 23:37:11,50278.02,189699.17
"4111",2017-05-22 23:37:11,102576.06,292275.23
"4112",2017-05-22 23:41:20,-292275.23,1.16415321826935e-10
"4113",2017-05-23 00:05:46,105763.07,105763.07
"4114",2017-05-23 00:05:46,38591.07,144354.14
"4115",2017-05-23 00:10:29,-144354.14,1.16415321826935e-10
"4116",2017-05-23 00:48:16,155436.8,155436.8
"4117",2017-05-23 00:52:13,141876.99,297313.79
"4118",2017-05-23 00:52:13,-155436.8,141876.99
"4119",2017-05-23 00:56:42,-141876.99,1.16415321826935e-10
"4120",2017-05-23 03:48:18,93636.57,93636.5700000001
"4121",2017-05-23 03:56:48,-93636.57,1.16415321826935e-10
"4122",2017-05-23 04:34:40,61912.57,61912.5700000001
"4123",2017-05-23 04:51:02,-61912.57,1.16415321826935e-10
"4124",2017-05-23 05:58:21,40587.14,40587.1400000001
"4125",2017-05-23 06:06:45,-40587.14,1.16415321826935e-10
"4126",2017-05-23 06:28:40,76274.37,76274.3700000001
"4127",2017-05-23 06:35:06,-76274.37,1.16415321826935e-10
"4128",2017-05-23 06:56:28,97409.64,97409.6400000001
"4129",2017-05-23 07:24:35,-97409.64,1.16415321826935e-10
"4130",2017-05-23 07:24:35,59463.68,59463.6800000001
"4131",2017-05-23 07:29:52,-59463.68,1.16415321826935e-10
"4132",2017-05-23 09:05:21,57067.98,57067.9800000001
"4133",2017-05-23 09:23:31,-57067.98,1.16415321826935e-10
"4134",2017-05-23 11:02:01,79684.57,79684.5700000001
"4135",2017-05-23 11:22:17,-79684.57,1.16415321826935e-10
"4136",2017-05-23 11:22:17,58071.76,58071.7600000001
"4137",2017-05-23 11:50:20,70787.59,128859.35
"4138",2017-05-23 11:50:20,-58071.76,70787.5900000001
"4139",2017-05-23 11:50:20,116414.03,187201.62
"4140",2017-05-23 11:58:04,-187201.62,1.16415321826935e-10
"4141",2017-05-23 12:13:48,92432.93,92432.9300000001
"4142",2017-05-23 12:28:21,-92432.93,1.16415321826935e-10
"4143",2017-05-23 12:51:24,38303.8,38303.8000000001
"4144",2017-05-23 13:15:38,-38303.8,1.16415321826935e-10
"4145",2017-05-23 13:15:38,53933.32,53933.3200000001
"4146",2017-05-23 13:28:54,-53933.32,1.16415321826935e-10
"4147",2017-05-23 14:48:12,64194.33,64194.3300000001
"4148",2017-05-23 14:48:12,55738.07,119932.4
"4149",2017-05-23 14:48:12,174545.58,294477.98
"4150",2017-05-23 14:48:12,64143.29,358621.27
"4151",2017-05-23 14:54:00,-358621.27,5.82076609134674e-11
"4152",2017-05-23 15:14:26,85947.78,85947.7800000001
"4153",2017-05-23 15:14:26,95866.03,181813.81
"4154",2017-05-23 15:14:26,114323.27,296137.08
"4155",2017-05-23 15:23:56,39345.26,335482.34
"4156",2017-05-23 15:23:56,-296137.08,39345.2600000001
"4157",2017-05-23 15:23:56,109674.81,149020.07
"4158",2017-05-23 15:31:44,94443.51,243463.58
"4159",2017-05-23 15:31:44,-149020.07,94443.5100000001
"4160",2017-05-23 15:31:44,125141.33,219584.84
"4161",2017-05-23 15:45:31,59239.91,278824.75
"4162",2017-05-23 15:45:31,174275.05,453099.8
"4163",2017-05-23 15:45:31,60398.01,513497.81
"4164",2017-05-23 15:45:31,-149020.07,364477.74
"4165",2017-05-23 15:45:31,-219584.84,144892.9
"4166",2017-05-23 15:56:28,37695.77,182588.67
"4167",2017-05-23 15:56:28,56820.52,239409.19
"4168",2017-05-23 15:56:28,-144892.9,94516.2900000001
"4169",2017-05-23 15:56:28,88893.89,183410.18
"4170",2017-05-23 16:23:10,88893.94,272304.12
"4171",2017-05-23 16:23:10,107128.93,379433.05
"4172",2017-05-23 16:23:10,112639.03,492072.08
"4173",2017-05-23 16:23:10,-183410.18,308661.9
"4174",2017-05-23 16:27:29,100005.95,408667.85
"4175",2017-05-23 16:27:29,-308661.9,100005.95
"4176",2017-05-23 16:31:19,-100005.95,7.27595761418343e-11
"4177",2017-05-23 16:43:55,73626.14,73626.1400000001
"4178",2017-05-23 16:55:04,42392.68,116018.82
"4179",2017-05-23 16:55:04,-73626.14,42392.6800000001
"4180",2017-05-23 16:59:09,-42392.68,6.54836185276508e-11
"4181",2017-05-23 17:03:05,86902.81,86902.8100000001
"4182",2017-05-23 17:13:22,81248.79,168151.6
"4183",2017-05-23 17:13:22,-86902.81,81248.79
"4184",2017-05-23 17:20:33,-81248.79,4.36557456851006e-11
"4185",2017-05-23 18:45:37,53841.09,53841.09
"4186",2017-05-23 18:45:37,72056.11,125897.2
"4187",2017-05-23 18:45:37,70353.26,196250.46
"4188",2017-05-23 18:45:37,70815.34,267065.8
"4189",2017-05-23 19:09:47,-267065.8,5.82076609134674e-11
"4190",2017-05-23 22:40:52,85987.66,85987.6600000001
"4191",2017-05-23 22:48:13,-85987.66,5.82076609134674e-11
"4192",2017-05-23 22:48:13,103727.37,103727.37
"4193",2017-05-23 22:52:47,267427.92,371155.29
"4194",2017-05-23 22:52:47,70580.84,441736.13
"4195",2017-05-23 22:52:47,-103727.37,338008.76
"4196",2017-05-23 22:59:31,-338008.76,0
"4197",2017-05-23 23:17:47,58253.47,58253.47
"4198",2017-05-23 23:17:47,73625.26,131878.73
"4199",2017-05-23 23:27:18,49807.88,181686.61
"4200",2017-05-23 23:31:13,-181686.61,0
"4201",2017-05-23 23:54:29,71706,71706
"4202",2017-05-24 00:40:52,67144.88,138850.88
"4203",2017-05-24 00:40:52,75090.33,213941.21
"4204",2017-05-24 00:40:52,-71706,142235.21
"4205",2017-05-24 00:40:52,-71706,70529.21
"4206",2017-05-24 00:40:52,179726.59,250255.8
"4207",2017-05-24 00:40:52,75511.8,325767.6
"4208",2017-05-24 00:53:23,88361.94,414129.54
"4209",2017-05-24 00:53:23,221222.59,635352.13
"4210",2017-05-24 00:53:23,-325767.6,309584.53
"4211",2017-05-24 01:00:02,96389.08,405973.61
"4212",2017-05-24 01:00:02,-309584.53,96389.08
"4213",2017-05-24 01:19:46,112739.04,209128.12
"4214",2017-05-24 01:19:46,67202.02,276330.14
"4215",2017-05-24 01:19:46,-96389.08,179941.06
"4216",2017-05-24 01:30:08,-179941.06,0
"4217",2017-05-24 01:30:08,69300.06,69300.06
"4218",2017-05-24 01:44:41,179124.95,248425.01
"4219",2017-05-24 01:44:41,83740.64,332165.65
"4220",2017-05-24 01:44:41,-69300.06,262865.59
"4221",2017-05-24 01:44:41,-69300.06,193565.53
"4222",2017-05-24 02:06:11,94848.46,288413.99
"4223",2017-05-24 02:06:11,-193565.53,94848.4600000001
"4224",2017-05-24 02:26:12,-94848.46,4.36557456851006e-11
"4225",2017-05-24 15:50:51,41441.09,41441.09
"4226",2017-05-24 15:55:20,-41441.09,4.36557456851006e-11
"4227",2017-05-24 16:08:13,122954.74,122954.74
"4228",2017-05-24 16:13:12,-122954.74,4.36557456851006e-11
"4229",2017-05-24 17:30:40,97598.08,97598.08
"4230",2017-05-24 17:38:47,451402.16,549000.24
"4231",2017-05-24 17:52:27,146256.13,695256.37
"4232",2017-05-24 17:52:27,79661.46,774917.83
"4233",2017-05-24 18:10:37,68927.9,843845.73
"4234",2017-05-24 18:17:16,65902.69,909748.42
"4235",2017-05-24 18:17:16,83160.26,992908.68
"4236",2017-05-24 18:28:49,61331.91,1054240.59
"4237",2017-05-24 18:28:49,169742.86,1223983.45
"4238",2017-05-24 18:35:29,87506.59,1311490.04
"4239",2017-05-24 18:58:30,81775.14,1393265.18
"4240",2017-05-24 18:58:30,105174.3,1498439.48
"4241",2017-05-24 19:02:10,99755.92,1598195.4
"4242",2017-05-24 19:15:05,55623.04,1653818.44
"4243",2017-05-24 19:15:05,72574.85,1726393.29
"4244",2017-05-24 19:15:05,116047.77,1842441.06
"4245",2017-05-24 19:35:15,65577.7,1908018.76
"4246",2017-05-24 19:39:25,57971.86,1965990.62
"4247",2017-05-24 20:14:25,59543.44,2025534.06
"4248",2017-05-24 20:44:09,149770.66,2175304.72
"4249",2017-05-24 20:44:09,101688.59,2276993.31
"4250",2017-05-24 20:44:09,188719.82,2465713.13
"4251",2017-05-24 21:01:51,65020.15,2530733.28
"4252",2017-05-24 21:01:51,130405.38,2661138.66
"4253",2017-05-24 21:10:43,50697.7,2711836.36
"4254",2017-05-24 21:10:43,79363.7,2791200.06
"4255",2017-05-24 21:27:00,66716.84,2857916.9
"4256",2017-05-25 00:43:45,245391.73,3103308.63
"4257",2017-05-25 00:43:45,82340.81,3185649.44
"4258",2017-05-25 00:43:45,58996.25,3244645.69
"4259",2017-05-25 01:36:14,124022.41,3368668.1
"4260",2017-05-25 01:36:14,100318.18,3468986.28
"4261",2017-05-25 01:36:14,97913.38,3566899.66
"4262",2017-05-25 01:36:14,76973.52,3643873.18
"4263",2017-05-25 01:36:14,127904.13,3771777.31
"4264",2017-05-25 01:38:19,168978.73,3940756.04
"4265",2017-05-25 01:55:22,216603.09,4157359.13
"4266",2017-05-25 01:55:22,86514.2,4243873.33
"4267",2017-05-25 02:00:18,80120.78,4323994.11
"4268",2017-05-25 02:08:35,55517.88,4379511.99
"4269",2017-05-25 02:08:35,62674.38,4442186.37
"4270",2017-05-25 02:12:30,-4442186.37,-9.31322574615479e-10
"4271",2017-05-25 02:12:30,80181.38,80181.3799999991
"4272",2017-05-25 02:20:54,-80181.38,-9.31322574615479e-10
"4273",2017-05-25 02:20:54,88699.08,88699.0799999991
"4274",2017-05-25 02:27:23,107099.21,195798.289999999
"4275",2017-05-25 02:27:23,85735.21,281533.499999999
"4276",2017-05-25 02:27:23,-88699.08,192834.419999999
"4277",2017-05-25 02:41:16,-192834.42,-9.60426405072212e-10
"4278",2017-05-25 08:26:03,77795,77794.999999999
"4279",2017-05-25 08:55:13,77795.01,155590.009999999
"4280",2017-05-25 08:55:13,-77795,77795.009999999
"4281",2017-05-25 09:03:43,170018.02,247813.029999999
"4282",2017-05-25 09:03:43,-77795.01,170018.019999999
"4283",2017-05-25 09:06:59,-170018.02,-9.60426405072212e-10
"4284",2017-05-25 09:14:29,117931.7,117931.699999999
"4285",2017-05-25 09:24:16,124034.73,241966.429999999
"4286",2017-05-25 09:24:16,-117931.7,124034.729999999
"4287",2017-05-25 09:24:16,-117931.7,6103.02999999904
"4288",2017-05-25 09:35:24,315864.3,321967.329999999
"4289",2017-05-25 09:35:24,-6103.03,315864.299999999
"4290",2017-05-25 09:48:57,166215.78,482080.079999999
"4291",2017-05-25 09:48:57,-315864.3,166215.779999999
"4292",2017-05-25 10:00:17,104079.8,270295.579999999
"4293",2017-05-25 10:00:17,-166215.78,104079.799999999
"4294",2017-05-25 10:12:47,173820.91,277900.709999999
"4295",2017-05-25 10:12:47,-104079.8,173820.909999999
"4296",2017-05-25 10:16:23,-173820.91,-9.60426405072212e-10
"4297",2017-05-25 10:42:58,149368.09,149368.089999999
"4298",2017-05-25 10:50:50,-149368.09,-9.60426405072212e-10
"4299",2017-05-25 10:55:23,148912.56,148912.559999999
"4300",2017-05-25 11:02:13,-148912.56,-9.60426405072212e-10
"4301",2017-05-25 12:24:44,173996.07,173996.069999999
"4302",2017-05-25 12:24:44,115270.33,289266.399999999
"4303",2017-05-25 12:30:24,-289266.4,-9.89530235528946e-10
"4304",2017-05-25 12:43:34,228307.54,228307.539999999
"4305",2017-05-25 12:43:34,110795.82,339103.359999999
"4306",2017-05-25 12:57:27,183807.79,522911.149999999
"4307",2017-05-25 12:57:27,-339103.36,183807.789999999
"4308",2017-05-25 13:02:28,-183807.79,-9.02218744158745e-10
"4309",2017-05-25 13:12:33,140526.05,140526.049999999
"4310",2017-05-25 13:25:16,-140526.05,-9.02218744158745e-10
"4311",2017-05-25 13:52:57,121757.33,121757.329999999
"4312",2017-05-25 13:52:57,187222.3,308979.629999999
"4313",2017-05-25 14:13:56,145817.38,454797.009999999
"4314",2017-05-25 14:13:56,135118.06,589915.069999999
"4315",2017-05-25 14:13:56,-308979.63,280935.439999999
"4316",2017-05-25 14:25:44,162561.78,443497.219999999
"4317",2017-05-25 14:25:44,-280935.44,162561.779999999
"4318",2017-05-25 14:29:46,-162561.78,-8.44011083245277e-10
"4319",2017-05-25 14:54:53,134809.47,134809.469999999
"4320",2017-05-25 15:05:12,-134809.47,-8.44011083245277e-10
"4321",2017-05-25 15:10:04,84759.82,84759.8199999992
"4322",2017-05-25 15:10:04,41053.77,125813.589999999
"4323",2017-05-25 15:15:55,-125813.59,-8.44011083245277e-10
"4324",2017-05-25 15:33:29,64674.38,64674.3799999992
"4325",2017-05-25 15:41:40,71619.31,136293.689999999
"4326",2017-05-25 15:41:40,-64674.38,71619.3099999992
"4327",2017-05-25 15:47:27,100466.58,172085.889999999
"4328",2017-05-25 15:47:27,-71619.31,100466.579999999
"4329",2017-05-25 15:56:04,71176.44,171643.019999999
"4330",2017-05-25 15:56:04,46809.53,218452.549999999
"4331",2017-05-25 15:56:04,57425.91,275878.459999999
"4332",2017-05-25 15:56:04,-100466.58,175411.879999999
"4333",2017-05-25 16:00:16,47793.23,223205.109999999
"4334",2017-05-25 16:00:16,-175411.88,47793.2299999991
"4335",2017-05-25 16:02:31,86690.3,134483.529999999
"4336",2017-05-25 16:24:34,49601.3,184084.829999999
"4337",2017-05-25 16:24:34,-134483.53,49601.2999999991
"4338",2017-05-25 16:24:34,-47793.23,1808.06999999914
"4339",2017-05-25 16:28:32,47900.14,49708.2099999991
"4340",2017-05-25 16:28:32,-1808.07,47900.1399999991
"4341",2017-05-25 16:48:36,38331.18,86231.3199999991
"4342",2017-05-25 16:48:36,-47900.14,38331.1799999991
"4343",2017-05-25 17:03:46,-38331.18,-8.65838956087828e-10
"4344",2017-05-25 19:04:54,255198.48,255198.479999999
"4345",2017-05-25 19:04:54,182130.82,437329.299999999
"4346",2017-05-25 19:07:28,-437329.3,-8.73114913702011e-10
"4347",2017-05-25 19:14:04,38763.82,38763.8199999991
"4348",2017-05-25 19:14:04,132662.31,171426.129999999
"4349",2017-05-25 19:14:04,153287.09,324713.219999999
"4350",2017-05-25 19:32:35,111232.84,435946.059999999
"4351",2017-05-25 19:32:35,179401.79,615347.849999999
"4352",2017-05-25 19:32:35,73841.51,689189.359999999
"4353",2017-05-25 19:32:35,-324713.22,364476.139999999
"4354",2017-05-25 19:32:35,-324713.22,39762.9199999992
"4355",2017-05-25 19:50:44,-39762.92,-7.71251507103443e-10
"4356",2017-05-25 20:27:25,100019.63,100019.629999999
"4357",2017-05-25 20:51:30,-100019.63,-7.71251507103443e-10
"4358",2017-05-25 21:24:28,130019.64,130019.639999999
"4359",2017-05-25 21:42:03,-130019.64,-7.71251507103443e-10
"4360",2017-05-25 21:58:04,130019.65,130019.649999999
"4361",2017-05-25 21:58:04,130019.62,260039.269999999
"4362",2017-05-25 22:23:34,-260039.27,-7.8580342233181e-10
"4363",2017-05-25 22:50:44,130019.67,130019.669999999
"4364",2017-05-25 23:02:37,295916.29,425935.959999999
"4365",2017-05-25 23:02:37,-130019.67,295916.289999999
"4366",2017-05-25 23:07:23,-295916.29,-7.56699591875076e-10
"4367",2017-05-25 23:11:02,184845.79,184845.789999999
"4368",2017-05-25 23:19:26,136779.42,321625.209999999
"4369",2017-05-25 23:19:26,106702.67,428327.879999999
"4370",2017-05-25 23:19:26,-184845.79,243482.089999999
"4371",2017-05-25 23:25:17,-243482.09,-7.56699591875076e-10
"4372",2017-05-25 23:29:49,84590.38,84590.3799999992
"4373",2017-05-25 23:38:31,179012.45,263602.829999999
"4374",2017-05-25 23:38:31,102296.34,365899.169999999
"4375",2017-05-25 23:38:31,-84590.38,281308.789999999
"4376",2017-05-25 23:43:43,130019.74,411328.529999999
"4377",2017-05-25 23:43:43,-281308.79,130019.739999999
"4378",2017-05-25 23:47:09,61486.67,191506.409999999
"4379",2017-05-25 23:58:35,57697.75,249204.159999999
"4380",2017-05-25 23:58:35,78926.72,328130.879999999
"4381",2017-05-26 00:10:39,104968.09,433098.969999999
"4382",2017-05-26 00:13:50,80229,513327.969999999
"4383",2017-05-26 00:17:30,105625.3,618953.269999999
"4384",2017-05-26 00:25:11,66515.99,685469.259999999
"4385",2017-05-26 00:25:11,77796.85,763266.109999999
"4386",2017-05-26 00:36:47,133789.33,897055.439999999
"4387",2017-05-26 00:41:36,111359.44,1008414.88
"4388",2017-05-26 01:30:22,92665.55,1101080.43
"4389",2017-05-26 01:30:22,58779.13,1159859.56
"4390",2017-05-26 01:30:22,76951.31,1236810.87
"4391",2017-05-26 02:01:16,65669.87,1302480.74
"4392",2017-05-26 02:01:28,62761.37,1365242.11
"4393",2017-05-26 02:18:55,82620.79,1447862.9
"4394",2017-05-26 02:41:20,109873.52,1557736.42
"4395",2017-05-26 02:49:14,118914.22,1676650.64
"4396",2017-05-26 03:06:47,97631.65,1774282.29
"4397",2017-05-26 03:19:24,173985.85,1948268.14
"4398",2017-05-26 07:58:55,108665.71,2056933.85
"4399",2017-05-26 07:58:55,31926.35,2088860.2
"4400",2017-05-26 07:58:55,123870.19,2212730.39
"4401",2017-05-26 07:58:55,-1948268.14,264462.25
"4402",2017-05-26 07:58:55,98529.83,362992.08
"4403",2017-05-26 08:45:09,-362992.08,-2.3283064365387e-10
"4404",2017-05-26 10:32:46,90172.21,90172.2099999998
"4405",2017-05-26 10:32:46,109124.35,199296.56
"4406",2017-05-26 10:32:46,87643.98,286940.54
"4407",2017-05-26 10:42:45,-286940.54,-2.3283064365387e-10
"4408",2017-05-26 10:54:28,130504.08,130504.08
"4409",2017-05-26 10:56:11,101947.35,232451.43
"4410",2017-05-26 11:03:13,75855.7,308307.13
"4411",2017-05-26 11:03:13,-232451.43,75855.6999999998
"4412",2017-05-26 11:22:02,67378.2,143233.9
"4413",2017-05-26 11:22:02,-75855.7,67378.1999999998
"4414",2017-05-26 11:41:39,61380.25,128758.45
"4415",2017-05-26 11:41:39,49329.33,178087.78
"4416",2017-05-26 11:41:39,-67378.2,110709.58
"4417",2017-05-26 11:41:39,-67378.2,43331.3799999998
"4418",2017-05-26 11:59:02,-43331.38,-1.96450855582952e-10
"4419",2017-05-26 13:57:35,75222.62,75222.6199999998
"4420",2017-05-26 13:57:35,311518.17,386740.79
"4421",2017-05-26 14:14:45,160473.87,547214.66
"4422",2017-05-26 14:14:45,137497.81,684712.47
"4423",2017-05-26 14:14:45,-386740.79,297971.68
"4424",2017-05-26 14:35:29,111554.49,409526.17
"4425",2017-05-26 14:35:29,146544.94,556071.11
"4426",2017-05-26 14:35:29,-297971.68,258099.43
"4427",2017-05-26 14:42:10,125839.29,383938.72
"4428",2017-05-26 14:42:10,-258099.43,125839.29
"4429",2017-05-26 14:48:36,91751.68,217590.97
"4430",2017-05-26 14:48:36,68753.17,286344.14
"4431",2017-05-26 14:48:36,-125839.29,160504.85
"4432",2017-05-26 14:53:15,184212.27,344717.12
"4433",2017-05-26 14:53:15,-160504.85,184212.27
"4434",2017-05-26 14:56:49,97353.27,281565.54
"4435",2017-05-26 14:56:49,-184212.27,97353.2699999998
"4436",2017-05-26 15:36:52,121692.03,219045.3
"4437",2017-05-26 15:36:52,154854.58,373899.88
"4438",2017-05-26 15:36:52,104563.53,478463.41
"4439",2017-05-26 15:36:52,-97353.27,381110.14
"4440",2017-05-26 15:36:52,-97353.27,283756.87
"4441",2017-05-26 15:39:30,-283756.87,-2.3283064365387e-10
"4442",2017-05-26 15:58:07,65951.45,65951.4499999998
"4443",2017-05-26 15:58:07,104551.13,170502.58
"4444",2017-05-26 15:58:07,80058.07,250560.65
"4445",2017-05-26 16:06:02,125703.48,376264.13
"4446",2017-05-26 16:06:02,-250560.65,125703.48
"4447",2017-05-26 16:13:22,53274.34,178977.82
"4448",2017-05-26 16:13:22,-125703.48,53274.3399999998
"4449",2017-05-26 16:25:17,-53274.34,-2.18278728425503e-10
"4450",2017-05-26 18:38:59,107785.92,107785.92
"4451",2017-05-26 18:54:21,177412.52,285198.44
"4452",2017-05-26 18:54:21,129145.36,414343.8
"4453",2017-05-26 18:54:21,-107785.92,306557.88
"4454",2017-05-26 19:27:11,100021.29,406579.17
"4455",2017-05-26 19:27:11,150518.59,557097.76
"4456",2017-05-26 19:27:11,128926.16,686023.92
"4457",2017-05-26 19:27:11,-306557.88,379466.04
"4458",2017-05-26 19:27:11,-306557.88,72908.1599999998
"4459",2017-05-26 19:54:43,130021.3,202929.46
"4460",2017-05-26 19:54:43,-72908.16,130021.3
"4461",2017-05-26 19:54:43,-72908.16,57113.1399999998
"4462",2017-05-26 20:00:17,201659.93,258773.07
"4463",2017-05-26 20:00:17,-57113.14,201659.93
"4464",2017-05-26 20:10:46,166888.57,368548.5
"4465",2017-05-26 20:10:46,110931.38,479479.88
"4466",2017-05-26 20:10:46,-201659.93,277819.95
"4467",2017-05-26 20:11:57,157955.61,435775.56
"4468",2017-05-26 20:15:50,-435775.56,-2.3283064365387e-10
"4469",2017-05-26 20:39:50,132435.11,132435.11
"4470",2017-05-26 20:39:50,10021.52,142456.63
"4471",2017-05-26 21:31:28,-142456.63,-2.61934474110603e-10
"4472",2017-05-26 22:03:32,462206.32,462206.32
"4473",2017-05-26 22:08:29,304478.83,766685.15
"4474",2017-05-26 22:08:29,89133.06,855818.21
"4475",2017-05-26 22:15:25,156470.97,1012289.18
"4476",2017-05-26 22:15:25,127700.67,1139989.85
"4477",2017-05-26 22:16:59,239721.76,1379711.61
"4478",2017-05-26 22:54:43,185922.3,1565633.91
"4479",2017-05-26 22:54:43,276877.22,1842511.13
"4480",2017-05-26 22:59:26,165846.92,2008358.05
"4481",2017-05-26 23:09:52,116732.58,2125090.63
"4482",2017-05-26 23:09:52,94672.51,2219763.14
"4483",2017-05-26 23:17:16,83874.29,2303637.43
"4484",2017-05-26 23:27:36,98381.22,2402018.65
"4485",2017-05-27 00:07:33,81827.76,2483846.41
"4486",2017-05-27 00:07:33,56836.68,2540683.09
"4487",2017-05-27 00:07:33,70674.04,2611357.13
"4488",2017-05-27 00:07:33,68126.93,2679484.06
"4489",2017-05-27 00:18:35,90645.68,2770129.74
"4490",2017-05-27 00:21:41,154142.14,2924271.88
"4491",2017-05-27 00:31:27,131450.96,3055722.84
"4492",2017-05-27 01:01:23,100861.75,3156584.59
"4493",2017-05-27 01:05:13,119593,3276177.59
"4494",2017-05-27 01:24:19,168263.16,3444440.75
"4495",2017-05-27 01:24:19,143919.04,3588359.79
"4496",2017-05-27 01:24:19,118497.01,3706856.8
"4497",2017-05-27 01:50:58,185366.45,3892223.25
"4498",2017-05-27 01:50:58,118871.1,4011094.35
"4499",2017-05-27 02:30:53,105041.95,4116136.3
"4500",2017-05-27 02:30:53,159917.37,4276053.67
"4501",2017-05-27 02:30:53,118987.41,4395041.08
"4502",2017-05-27 03:18:04,120680.76,4515721.84
"4503",2017-05-27 03:18:47,143077.76,4658799.6
"4504",2017-05-27 03:32:05,166994.27,4825793.87
"4505",2017-05-27 03:53:24,104969.13,4930763
"4506",2017-05-27 04:06:14,155926.56,5086689.56
"4507",2017-05-27 04:06:14,118035.05,5204724.61
"4508",2017-05-27 04:19:27,152339.09,5357063.7
"4509",2017-05-27 04:39:09,124904.23,5481967.93
"4510",2017-05-27 04:39:09,219945.86,5701913.79
"4511",2017-05-27 04:56:08,131842.78,5833756.57
"4512",2017-05-27 04:56:08,155682.89,5989439.46
"4513",2017-05-27 05:01:48,129950.18,6119389.64
"4514",2017-05-27 05:28:47,161250.77,6280640.41
"4515",2017-05-27 05:28:47,208219.72,6488860.13
"4516",2017-05-27 05:45:16,152209.02,6641069.15
"4517",2017-05-27 05:45:16,111084.18,6752153.33
"4518",2017-05-27 05:45:16,-6488860.13,263293.199999997
"4519",2017-05-27 06:06:31,283627.04,546920.239999997
"4520",2017-05-27 06:06:31,146391.37,693311.609999997
"4521",2017-05-27 06:06:31,-263293.2,430018.409999997
"4522",2017-05-27 06:06:31,-263293.2,166725.209999997
"4523",2017-05-27 06:20:24,298551.27,465276.479999997
"4524",2017-05-27 06:20:24,-166725.21,298551.269999997
"4525",2017-05-27 06:31:22,313431.09,611982.359999998
"4526",2017-05-27 06:31:22,-298551.27,313431.089999998
"4527",2017-05-27 06:54:10,136986.94,450418.029999998
"4528",2017-05-27 06:54:10,139151.56,589569.589999998
"4529",2017-05-27 06:54:10,-313431.09,276138.499999997
"4530",2017-05-27 07:04:02,133282.59,409421.089999998
"4531",2017-05-27 07:04:02,105180.89,514601.979999998
"4532",2017-05-27 07:04:02,-276138.5,238463.479999998
"4533",2017-05-27 07:11:44,-238463.48,-2.47382558882236e-09
"4534",2017-05-27 07:48:18,104348.17,104348.169999998
"4535",2017-05-27 08:11:37,110214.36,214562.529999998
"4536",2017-05-27 08:11:37,134319.97,348882.499999998
"4537",2017-05-27 08:11:37,-104348.17,244534.329999998
"4538",2017-05-27 08:34:36,111331.35,355865.679999998
"4539",2017-05-27 08:34:36,143758.1,499623.779999998
"4540",2017-05-27 08:34:36,-244534.33,255089.449999998
"4541",2017-05-27 08:51:43,137477.12,392566.569999998
"4542",2017-05-27 08:51:43,-255089.45,137477.119999998
"4543",2017-05-27 08:59:17,-137477.12,-2.38651409745216e-09
"4544",2017-05-27 08:59:17,140450.86,140450.859999998
"4545",2017-05-27 09:16:14,-140450.86,-2.38651409745216e-09
"4546",2017-05-27 11:20:26,118110.53,118110.529999998
"4547",2017-05-27 11:23:09,-118110.53,-2.38651409745216e-09
"4548",2017-05-27 11:40:25,277330.75,277330.749999998
"4549",2017-05-27 11:40:25,300023.29,577354.039999998
"4550",2017-05-27 11:40:25,130023.27,707377.309999998
"4551",2017-05-27 11:45:28,-707377.31,-2.44472175836563e-09
"4552",2017-05-27 12:06:15,188949.33,188949.329999998
"4553",2017-05-27 12:12:35,-188949.33,-2.44472175836563e-09
"4554",2017-05-27 12:30:44,165694.71,165694.709999998
"4555",2017-05-27 12:45:36,155504.43,321199.139999998
"4556",2017-05-27 12:45:36,190640.97,511840.109999998
"4557",2017-05-27 12:45:36,-165694.71,346145.399999998
"4558",2017-05-27 12:54:40,204497.21,550642.609999998
"4559",2017-05-27 12:54:40,-346145.4,204497.209999998
"4560",2017-05-27 13:02:22,150770.89,355268.099999998
"4561",2017-05-27 13:02:22,-204497.21,150770.889999998
"4562",2017-05-27 13:07:15,-150770.89,-2.47382558882236e-09
"4563",2017-05-27 13:35:21,137112.45,137112.449999998
"4564",2017-05-27 13:35:21,164148.36,301260.809999997
"4565",2017-05-27 13:41:51,361706.89,662967.699999998
"4566",2017-05-27 13:41:51,-301260.81,361706.889999998
"4567",2017-05-27 14:07:46,108900.87,470607.759999998
"4568",2017-05-27 14:07:46,181356.92,651964.679999997
"4569",2017-05-27 14:07:46,129067.98,781032.659999997
"4570",2017-05-27 14:07:46,-361706.89,419325.769999997
"4571",2017-05-27 14:20:10,108886.66,528212.429999997
"4572",2017-05-27 14:20:10,-419325.77,108886.659999997
"4573",2017-05-27 14:26:35,174332.25,283218.909999997
"4574",2017-05-27 14:26:35,-108886.66,174332.249999997
"4575",2017-05-27 14:26:35,-108886.66,65445.5899999975
"4576",2017-05-27 14:42:22,99858.19,165303.779999997
"4577",2017-05-27 14:42:22,-65445.59,99858.1899999975
"4578",2017-05-27 14:42:30,155199.1,255057.289999997
"4579",2017-05-27 15:03:46,126810.65,381867.939999997
"4580",2017-05-27 15:03:46,165091.13,546959.069999998
"4581",2017-05-27 15:03:46,-255057.29,291901.779999997
"4582",2017-05-27 15:03:46,-255057.29,36844.4899999975
"4583",2017-05-27 15:14:05,-36844.49,-2.53930920735002e-09
"4584",2017-05-27 15:57:26,15023.69,15023.6899999975
"4585",2017-05-27 15:57:26,167144.75,182168.439999997
"4586",2017-05-27 15:59:42,-182168.44,-2.53203324973583e-09
"4587",2017-05-27 17:38:21,139664.4,139664.399999997
"4588",2017-05-27 17:38:21,143749.41,283413.809999997
"4589",2017-05-27 17:49:21,169152.67,452566.479999998
"4590",2017-05-27 20:08:09,114587.18,567153.659999998
"4591",2017-05-27 20:38:32,157819.9,724973.559999998
"4592",2017-05-27 20:49:01,157424.44,882397.999999998
"4593",2017-05-27 21:07:19,154424.66,1036822.66
"4594",2017-05-27 21:15:32,189872.93,1226695.59
"4595",2017-05-27 21:29:28,150575.25,1377270.84
"4596",2017-05-27 21:36:56,226667.98,1603938.82
"4597",2017-05-27 21:36:56,151406.24,1755345.06
"4598",2017-05-27 21:43:01,179807.63,1935152.69
"4599",2017-05-27 21:59:32,250248.1,2185400.79
"4600",2017-05-27 21:59:32,136194.99,2321595.78
"4601",2017-05-27 22:09:17,162974.17,2484569.95
"4602",2017-05-27 22:09:17,197279.64,2681849.59
"4603",2017-05-28 04:43:07,-2681849.59,-2.3283064365387e-09
"4604",2017-05-28 06:22:12,261199.74,261199.739999998
"4605",2017-05-28 06:35:57,-261199.74,-2.3283064365387e-09
"4606",2017-05-28 08:00:57,62952.09,62952.0899999977
"4607",2017-05-28 08:22:43,-62952.09,-2.3283064365387e-09
"4608",2017-05-28 10:22:20,154891.3,154891.299999998
"4609",2017-05-28 10:25:46,-154891.3,-2.3283064365387e-09
"4610",2017-05-28 17:49:40,115860.03,115860.029999998
"4611",2017-05-28 17:49:40,129813.72,245673.749999998
"4612",2017-05-28 17:49:40,160489.52,406163.269999998
"4613",2017-05-28 17:49:40,132160.68,538323.949999998
"4614",2017-05-28 18:03:46,251959.68,790283.629999998
"4615",2017-05-28 18:03:46,282842.45,1073126.08
"4616",2017-05-28 18:03:46,-538323.95,534802.129999998
"4617",2017-05-28 18:11:46,-534802.13,-2.44472175836563e-09
"4618",2017-05-28 18:26:06,188549.6,188549.599999998
"4619",2017-05-28 18:26:06,181253.5,369803.099999998
"4620",2017-05-28 18:45:39,220577.31,590380.409999998
"4621",2017-05-28 18:45:39,166277.23,756657.639999998
"4622",2017-05-28 18:45:39,-369803.1,386854.539999998
"4623",2017-05-28 18:56:40,-386854.54,-2.38651409745216e-09
"4624",2017-05-28 19:06:30,150382.82,150382.819999998
"4625",2017-05-28 19:29:27,-150382.82,-2.38651409745216e-09
"4626",2017-05-28 19:53:42,145443.82,145443.819999998
"4627",2017-05-28 20:12:54,-145443.82,-2.38651409745216e-09
"4628",2017-05-28 20:14:33,162791.46,162791.459999998
"4629",2017-05-28 20:53:16,-162791.46,-2.38651409745216e-09
"4630",2017-05-28 20:59:54,125762.04,125762.039999998
"4631",2017-05-28 21:05:39,-125762.04,-2.38651409745216e-09
"4632",2017-05-28 22:47:47,73878.66,73878.6599999976
"4633",2017-05-28 22:47:47,127612.76,201491.419999998
"4634",2017-05-28 22:51:18,-201491.42,-2.4156179279089e-09
"4635",2017-05-29 00:38:29,209925.94,209925.939999998
"4636",2017-05-29 00:52:16,153439.91,363365.849999998
"4637",2017-05-29 00:52:16,-209925.94,153439.909999998
"4638",2017-05-29 01:01:47,-153439.91,-2.4156179279089e-09
"4639",2017-05-29 01:29:03,140813.03,140813.029999998
"4640",2017-05-29 01:29:03,223554.26,364367.289999998
"4641",2017-05-29 01:41:40,-364367.29,-2.38651409745216e-09
"4642",2017-05-29 13:09:00,151559.48,151559.479999998
"4643",2017-05-29 13:09:00,174100.85,325660.329999998
"4644",2017-05-29 13:10:05,190006.45,515666.779999998
"4645",2017-05-29 13:15:24,-515666.78,-2.38651409745216e-09
"4646",2017-05-29 14:38:57,182589.73,182589.729999998
"4647",2017-05-29 14:47:57,-182589.73,-2.38651409745216e-09
"4648",2017-05-29 16:28:42,131509.02,131509.019999998
"4649",2017-05-29 16:33:50,-131509.02,-2.38651409745216e-09
"4650",2017-05-29 17:28:21,84978.94,84978.9399999976
"4651",2017-05-29 17:38:40,-84978.94,-2.38651409745216e-09
"4652",2017-05-29 17:56:37,97223.04,97223.0399999976
"4653",2017-05-29 18:02:03,-97223.04,-2.38651409745216e-09
"4654",2017-05-29 18:15:31,92944.2,92944.1999999976
"4655",2017-05-29 18:15:31,93821.55,186765.749999998
"4656",2017-05-29 18:21:30,-186765.75,-2.38651409745216e-09
"4657",2017-05-29 18:57:25,163397.34,163397.339999998
"4658",2017-05-29 18:57:25,152411.19,315808.529999998
"4659",2017-05-29 19:20:30,-315808.53,-2.44472175836563e-09
"4660",2017-05-29 19:28:51,82726.85,82726.8499999976
"4661",2017-05-29 19:38:17,-82726.85,-2.44472175836563e-09
"4662",2017-05-29 19:52:29,131939.2,131939.199999998
"4663",2017-05-29 19:56:49,138859.44,270798.639999998
"4664",2017-05-29 19:56:49,-131939.2,138859.439999998
"4665",2017-05-29 19:59:37,-138859.44,-2.44472175836563e-09
"4666",2017-05-29 20:11:01,117088.83,117088.829999998
"4667",2017-05-29 20:24:45,105083.41,222172.239999998
"4668",2017-05-29 20:24:45,-117088.83,105083.409999998
"4669",2017-05-29 20:46:13,174627.33,279710.739999998
"4670",2017-05-29 20:46:13,-105083.41,174627.329999998
"4671",2017-05-29 20:55:25,-174627.33,-2.44472175836563e-09
"4672",2017-05-29 23:27:12,157700.99,157700.989999998
"4673",2017-05-29 23:54:51,76576.35,234277.339999998
"4674",2017-05-29 23:54:51,-157700.99,76576.3499999976
"4675",2017-05-29 23:58:55,-76576.35,-2.44472175836563e-09
"4676",2017-05-30 00:49:35,121543.42,121543.419999998
"4677",2017-05-30 01:00:17,54142.04,175685.459999998
"4678",2017-05-30 01:00:17,-121543.42,54142.0399999975
"4679",2017-05-30 01:04:07,-54142.04,-2.45199771597981e-09
"4680",2017-05-30 01:22:15,103067,103066.999999998
"4681",2017-05-30 01:22:15,67260.91,170327.909999998
"4682",2017-05-30 01:25:28,-170327.91,-2.44472175836563e-09
"4683",2017-05-30 02:43:42,60534.63,60534.6299999976
"4684",2017-05-30 02:43:42,91379.73,151914.359999998
"4685",2017-05-30 02:48:41,50516.83,202431.189999998
"4686",2017-05-30 02:48:41,-151914.36,50516.8299999976
"4687",2017-05-30 03:30:43,-50516.83,-2.43016984313726e-09
"4688",2017-05-30 08:23:33,62528.3,62528.2999999976
"4689",2017-05-30 08:27:25,-62528.3,-2.43016984313726e-09
"4690",2017-05-30 08:38:28,70349.06,70349.0599999976
"4691",2017-05-30 08:51:20,-70349.06,-2.43016984313726e-09
"4692",2017-05-30 09:20:19,51090.22,51090.2199999976
"4693",2017-05-30 09:26:16,58166.95,109257.169999998
"4694",2017-05-30 09:26:16,-51090.22,58166.9499999976
"4695",2017-05-30 09:29:05,17033.12,75200.0699999976
"4696",2017-05-30 09:29:05,-58166.95,17033.1199999976
"4697",2017-05-30 09:51:01,-17033.12,-2.43380782194436e-09
"4698",2017-05-30 10:14:44,51858.66,51858.6599999976
"4699",2017-05-30 10:14:44,53389.44,105248.099999998
"4700",2017-05-30 10:20:54,50987.46,156235.559999998
"4701",2017-05-30 10:20:54,-105248.1,50987.4599999976
"4702",2017-05-30 10:40:55,70068.46,121055.919999998
"4703",2017-05-30 10:40:55,92326.96,213382.879999998
"4704",2017-05-30 10:40:55,10453.98,223836.859999998
"4705",2017-05-30 10:40:55,-50987.46,172849.399999998
"4706",2017-05-30 10:40:55,-50987.46,121861.939999998
"4707",2017-05-30 10:51:07,-121861.94,-2.38651409745216e-09
"4708",2017-05-30 16:15:39,348511.28,348511.279999998
"4709",2017-05-30 16:19:27,-348511.28,-2.38651409745216e-09
"4710",2017-05-30 16:56:49,79350.58,79350.5799999976
"4711",2017-05-30 17:02:52,-79350.58,-2.38651409745216e-09
"4712",2017-05-30 19:02:09,90972.93,90972.9299999976
"4713",2017-05-30 19:17:18,-90972.93,-2.38651409745216e-09
"4714",2017-05-30 23:12:18,15154.8,15154.7999999976
"4715",2017-05-30 23:27:14,38332.02,53486.8199999976
"4716",2017-05-30 23:38:28,89778.63,143265.449999998
"4717",2017-05-30 23:38:28,125948.48,269213.929999998
"4718",2017-05-30 23:48:31,92011.24,361225.169999998
"4719",2017-05-30 23:58:24,50652.89,411878.059999998
"4720",2017-05-30 23:58:24,24571.26,436449.319999998
"4721",2017-05-31 00:23:45,115188.28,551637.599999998
"4722",2017-05-31 00:23:45,22906.23,574543.829999998
"4723",2017-05-31 00:31:14,82518.43,657062.259999998
"4724",2017-05-31 01:55:58,-657062.26,-2.3283064365387e-09
"4725",2017-05-31 01:55:58,88990.34,88990.3399999977
"4726",2017-05-31 02:05:33,-88990.34,-2.3283064365387e-09
"4727",2017-05-31 04:47:38,14128.98,14128.9799999977
"4728",2017-05-31 04:52:29,11052.31,25181.2899999977
"4729",2017-05-31 04:52:29,10129.84,35311.1299999977
"4730",2017-05-31 04:52:29,-14128.98,21182.1499999977
"4731",2017-05-31 05:10:52,181159.46,202341.609999998
"4732",2017-05-31 05:10:52,-21182.15,181159.459999998
"4733",2017-05-31 05:16:45,-181159.46,-2.3283064365387e-09
"4734",2017-05-31 05:34:31,60762.75,60762.7499999977
"4735",2017-05-31 05:40:47,-60762.75,-2.3283064365387e-09
"4736",2017-05-31 08:59:18,77122.9,77122.8999999977
"4737",2017-05-31 08:59:18,21029.9,98152.7999999977
"4738",2017-05-31 09:08:06,-98152.8,-2.34285835176706e-09
"4739",2017-05-31 12:41:20,26192.76,26192.7599999977
"4740",2017-05-31 12:41:20,9500.52,35693.2799999977
"4741",2017-05-31 12:46:37,-35693.28,-2.34285835176706e-09
"4742",2017-05-31 12:46:37,105556.52,105556.519999998
"4743",2017-05-31 13:20:20,-105556.52,-2.34285835176706e-09
"4744",2017-05-31 14:41:45,72226.02,72226.0199999977
"4745",2017-05-31 14:43:02,-72226.02,-2.34285835176706e-09
"4746",2017-05-31 14:43:02,145444.15,145444.149999998
"4747",2017-05-31 16:04:21,226728.08,372172.229999998
"4748",2017-05-31 16:22:51,140483.72,512655.949999998
"4749",2017-05-31 16:48:50,185161.15,697817.099999998
"4750",2017-06-01 01:34:26,258831.98,956649.079999998
"4751",2017-06-01 05:41:40,92130.94,1048780.02
"4752",2017-06-01 07:11:05,66187.13,1114967.15
"4753",2017-06-01 07:36:39,283881.12,1398848.27
"4754",2017-06-01 08:32:54,129282.86,1528131.13
"4755",2017-06-01 08:32:54,12146.55,1540277.68
"4756",2017-06-01 09:22:34,56284.09,1596561.77
"4757",2017-06-01 09:31:36,59108.45,1655670.22
"4758",2017-06-01 10:21:35,36358.2,1692028.42
"4759",2017-06-01 10:21:35,10140.16,1702168.58
"4760",2017-06-01 10:52:28,65680.56,1767849.14
"4761",2017-06-01 11:15:02,61794.91,1829644.05
"4762",2017-06-01 12:01:49,79035.59,1908679.64
"4763",2017-06-01 12:01:49,26141.3,1934820.94
"4764",2017-06-01 12:45:23,76097.16,2010918.1
"4765",2017-06-01 12:45:23,25836.37,2036754.47
"4766",2017-06-01 16:24:58,100203.22,2136957.69
"4767",2017-06-01 16:45:38,62910.98,2199868.67
"4768",2017-06-01 16:45:38,65712.58,2265581.25
"4769",2017-06-01 16:53:44,121786.04,2387367.29
"4770",2017-06-01 17:03:43,67288.83,2454656.12
"4771",2017-06-01 17:17:01,63867.42,2518523.54
"4772",2017-06-01 17:17:01,90971.42,2609494.96
"4773",2017-06-01 17:49:55,-2609494.96,-1.86264514923096e-09
"4774",2017-06-01 18:09:47,12946.2,12946.1999999981
"4775",2017-06-01 18:09:47,31466.61,44412.8099999981
"4776",2017-06-01 18:14:27,17624.2,62037.0099999981
"4777",2017-06-01 18:14:27,-44412.81,17624.1999999981
"4778",2017-06-01 18:23:13,-17624.2,-1.86628312803805e-09
"4779",2017-06-01 20:13:42,97147.73,97147.7299999981
"4780",2017-06-01 21:04:38,-97147.73,-1.86264514923096e-09
"4781",2017-06-01 21:50:36,81097.91,81097.9099999981
"4782",2017-06-01 21:58:19,-81097.91,-1.86264514923096e-09
"4783",2017-06-02 05:15:14,71687.39,71687.3899999981
"4784",2017-06-02 05:18:53,-71687.39,-1.86264514923096e-09
"4785",2017-06-02 08:01:21,95980.95,95980.9499999981
"4786",2017-06-02 08:01:21,9150.93,105131.879999998
"4787",2017-06-02 08:04:06,-105131.88,-1.86264514923096e-09
"4788",2017-06-02 08:26:01,60503.35,60503.3499999981
"4789",2017-06-02 08:26:01,58166.68,118670.029999998
"4790",2017-06-02 08:26:01,10615.68,129285.709999998
"4791",2017-06-02 08:34:03,75144.5,204430.209999998
"4792",2017-06-02 08:34:03,-129285.71,75144.4999999981
"4793",2017-06-02 08:39:49,-75144.5,-1.87719706445932e-09
"4794",2017-06-02 09:07:35,89321.6,89321.5999999981
"4795",2017-06-02 09:07:35,91658.22,180979.819999998
"4796",2017-06-02 09:07:35,23771.57,204751.389999998
"4797",2017-06-02 09:15:00,61608.47,266359.859999998
"4798",2017-06-02 09:15:00,-204751.39,61608.4699999981
"4799",2017-06-02 09:15:00,73873.93,135482.399999998
"4800",2017-06-02 09:15:00,100626.01,236108.409999998
"4801",2017-06-02 09:42:46,94154.05,330262.459999998
"4802",2017-06-02 09:42:46,43331.72,373594.179999998
"4803",2017-06-02 09:42:46,-236108.41,137485.769999998
"4804",2017-06-02 09:47:53,-137485.77,-1.92085281014442e-09
"4805",2017-06-02 09:59:40,90661.43,90661.4299999981
"4806",2017-06-02 09:59:40,33497.51,124158.939999998
"4807",2017-06-02 10:10:06,-124158.94,-1.92085281014442e-09
"4808",2017-06-02 10:36:32,62123.72,62123.7199999981
"4809",2017-06-02 10:36:32,43552.64,105676.359999998
"4810",2017-06-02 10:45:46,-105676.36,-1.92085281014442e-09
"4811",2017-06-02 15:13:23,69877.62,69877.6199999981
"4812",2017-06-02 15:18:32,-69877.62,-1.92085281014442e-09
"4813",2017-06-02 17:18:42,18422.65,18422.6499999981
"4814",2017-06-02 17:26:08,-18422.65,-1.92085281014442e-09
"4815",2017-06-02 18:03:27,56718.91,56718.9099999981
"4816",2017-06-02 18:06:46,-56718.91,-1.92085281014442e-09
"4817",2017-06-02 18:26:58,60297.61,60297.6099999981
"4818",2017-06-02 18:37:41,71735.49,132033.099999998
"4819",2017-06-02 18:37:41,-60297.61,71735.4899999981
"4820",2017-06-02 18:37:41,-60297.61,11437.8799999981
"4821",2017-06-02 18:41:23,-11437.88,-1.91539584193379e-09
"4822",2017-06-02 19:07:03,59922.52,59922.5199999981
"4823",2017-06-02 19:15:01,-59922.52,-1.91357685253024e-09
"4824",2017-06-02 19:37:27,67325.94,67325.9399999981
"4825",2017-06-02 20:45:25,84239.33,151565.269999998
"4826",2017-06-02 20:45:25,-67325.94,84239.3299999981
"4827",2017-06-02 20:45:25,-67325.94,16913.3899999981
"4828",2017-06-02 21:04:40,69780.96,86694.3499999981
"4829",2017-06-02 21:13:56,-16913.39,69780.9599999981
"4830",2017-06-02 21:18:07,69797.74,139578.699999998
"4831",2017-06-02 21:18:07,-69780.96,69797.7399999981
"4832",2017-06-02 21:31:38,-69797.74,-1.92085281014442e-09
"4833",2017-06-02 22:50:40,71685.94,71685.9399999981
"4834",2017-06-02 22:50:40,70179.71,141865.649999998
"4835",2017-06-02 22:50:40,76288.37,218154.019999998
"4836",2017-06-02 22:50:40,73764.43,291918.449999998
"4837",2017-06-02 23:02:01,58682.64,350601.089999998
"4838",2017-06-02 23:29:25,70029.72,420630.809999998
"4839",2017-06-03 00:33:52,72880.78,493511.589999998
"4840",2017-06-03 01:03:58,-350601.09,142910.499999998
"4841",2017-06-03 01:09:35,-142910.5,-1.92085281014442e-09
"4842",2017-06-03 02:29:59,72619,72618.9999999981
"4843",2017-06-03 02:33:56,-72619,-1.92085281014442e-09
"4844",2017-06-03 05:00:48,113655.34,113655.339999998
"4845",2017-06-03 05:08:24,81059.09,194714.429999998
"4846",2017-06-03 05:23:07,65254.97,259969.399999998
"4847",2017-06-03 18:45:04,82307.87,342277.269999998
"4848",2017-06-03 19:14:59,36411.9,378689.169999998
"4849",2017-06-03 19:29:49,82020.24,460709.409999998
"4850",2017-06-03 20:29:05,79764.61,540474.019999998
"4851",2017-06-03 20:46:40,83532.62,624006.639999998
"4852",2017-06-03 20:46:40,72873.61,696880.249999998
"4853",2017-06-03 21:08:14,93159.01,790039.259999998
"4854",2017-06-03 21:08:14,80776.8,870816.059999998
"4855",2017-06-03 21:08:14,142469.63,1013285.69
"4856",2017-06-03 21:15:11,38153.3,1051438.99
"4857",2017-06-03 21:15:11,58376.65,1109815.64
"4858",2017-06-03 21:22:55,95954.04,1205769.68
"4859",2017-06-03 21:24:53,71636.22,1277405.9
"4860",2017-06-03 21:40:09,60737.63,1338143.53
"4861",2017-06-03 22:05:49,60602,1398745.53
"4862",2017-06-03 22:14:36,21567.21,1420312.74
"4863",2017-06-03 22:43:04,117007.73,1537320.47
"4864",2017-06-03 23:24:23,55424.23,1592744.7
"4865",2017-06-04 02:57:18,94086.67,1686831.37
"4866",2017-06-04 03:20:57,72935.58,1759766.95
"4867",2017-06-04 03:20:57,122056.4,1881823.35
"4868",2017-06-04 03:20:57,127911.73,2009735.08
"4869",2017-06-04 03:20:57,188365.46,2198100.54
"4870",2017-06-04 03:27:26,58238.37,2256338.91
"4871",2017-06-04 03:51:17,65386.48,2321725.39
"4872",2017-06-04 04:06:47,60691.29,2382416.68
"4873",2017-06-04 05:01:04,90494.6,2472911.28
"4874",2017-06-04 07:17:43,44232.5,2517143.78
"4875",2017-06-04 07:29:47,13565.63,2530709.41
"4876",2017-06-04 07:59:28,59894.3,2590603.71
"4877",2017-06-04 08:17:51,-2590603.71,-2.3283064365387e-09
"4878",2017-06-04 08:23:22,44268.01,44268.0099999977
"4879",2017-06-04 08:30:02,18971.01,63239.0199999977
"4880",2017-06-04 08:30:02,-44268.01,18971.0099999977
"4881",2017-06-04 08:35:18,-18971.01,-2.3246684577316e-09
"4882",2017-06-04 08:58:28,125334.9,125334.899999998
"4883",2017-06-04 09:08:33,64937.6,190272.499999998
"4884",2017-06-04 09:08:33,-125334.9,64937.5999999977
"4885",2017-06-04 09:16:27,72074.12,137011.719999998
"4886",2017-06-04 09:16:27,-64937.6,72074.1199999977
"4887",2017-06-04 09:22:31,75270.2,147344.319999998
"4888",2017-06-04 09:22:31,-72074.12,75270.1999999977
"4889",2017-06-04 09:30:07,66876.99,142147.189999998
"4890",2017-06-04 09:30:07,-75270.2,66876.9899999977
"4891",2017-06-04 09:33:15,-66876.99,-2.3283064365387e-09
"4892",2017-06-04 10:12:36,130040.68,130040.679999998
"4893",2017-06-04 10:24:47,56037.49,186078.169999998
"4894",2017-06-04 10:24:47,-130040.68,56037.4899999977
"4895",2017-06-04 10:36:15,-56037.49,-2.33558239415288e-09
"4896",2017-06-04 11:04:04,22868.91,22868.9099999977
"4897",2017-06-04 11:10:19,-22868.91,-2.33558239415288e-09
"4898",2017-06-04 11:16:20,64612.39,64612.3899999977
"4899",2017-06-04 11:34:24,-64612.39,-2.33558239415288e-09
"4900",2017-06-04 13:39:48,72289.33,72289.3299999977
"4901",2017-06-04 13:39:48,127027.2,199316.529999998
"4902",2017-06-04 14:29:36,61388.24,260704.769999998
"4903",2017-06-04 23:19:21,41077.5,301782.269999998
"4904",2017-06-05 01:08:45,99296.06,401078.329999998
"4905",2017-06-05 01:08:45,19241.58,420319.909999998
"4906",2017-06-05 03:45:16,36646.65,456966.559999998
"4907",2017-06-05 10:53:12,13881.44,470847.999999998
"4908",2017-06-05 10:53:12,62584.96,533432.959999998
"4909",2017-06-05 11:08:37,79036.18,612469.139999998
"4910",2017-06-05 11:41:06,67040.06,679509.199999998
"4911",2017-06-05 11:43:30,64171.33,743680.529999998
"4912",2017-06-05 12:49:18,29099.63,772780.159999998
"4913",2017-06-05 12:52:28,69616.27,842396.429999998
"4914",2017-06-05 15:39:11,62414.79,904811.219999998
"4915",2017-06-05 16:07:18,16817.85,921629.069999998
"4916",2017-06-05 20:40:13,113266.19,1034895.26
"4917",2017-06-05 21:22:49,78456.64,1113351.9
"4918",2017-06-05 21:32:06,114993.58,1228345.48
"4919",2017-06-05 21:38:44,110445.84,1338791.32
"4920",2017-06-05 22:14:52,74832.16,1413623.48
"4921",2017-06-05 22:23:24,74802.25,1488425.73
"4922",2017-06-05 23:10:32,66238.79,1554664.52
"4923",2017-06-05 23:34:24,94773.39,1649437.91
"4924",2017-06-05 23:49:11,68373.75,1717811.66
"4925",2017-06-06 00:28:14,20492.05,1738303.71
"4926",2017-06-06 00:28:14,54915.39,1793219.1
"4927",2017-06-06 01:27:37,69053.25,1862272.35
"4928",2017-06-06 01:27:37,113765.79,1976038.14
"4929",2017-06-06 01:27:37,92519.38,2068557.52
"4930",2017-06-06 01:27:37,165808.11,2234365.63
"4931",2017-06-06 01:44:34,287131.99,2521497.62
"4932",2017-06-06 01:44:34,65634,2587131.62
"4933",2017-06-06 01:44:34,70530.4,2657662.02
"4934",2017-06-06 01:59:14,144503.55,2802165.57
"4935",2017-06-06 02:05:52,75644.58,2877810.15
"4936",2017-06-06 02:05:52,97914.11,2975724.26
"4937",2017-06-06 02:19:44,62764.96,3038489.22
"4938",2017-06-06 02:19:44,112419.22,3150908.44
"4939",2017-06-06 02:19:44,75496.09,3226404.53
"4940",2017-06-06 02:19:44,174729.93,3401134.46
"4941",2017-06-06 02:28:01,169492.91,3570627.37
"4942",2017-06-06 02:28:01,87113.86,3657741.23
"4943",2017-06-06 02:32:11,122807.25,3780548.48
"4944",2017-06-06 02:37:39,101999.6,3882548.08
"4945",2017-06-06 02:37:39,210543.75,4093091.83
"4946",2017-06-06 02:40:41,94035.81,4187127.64
"4947",2017-06-06 02:45:55,209869.2,4396996.84
"4948",2017-06-06 02:49:39,140872.77,4537869.61
"4949",2017-06-06 03:01:32,200168.69,4738038.3
"4950",2017-06-06 03:01:32,60819.48,4798857.78
"4951",2017-06-06 03:01:32,53004.81,4851862.59
"4952",2017-06-06 03:14:18,56257.78,4908120.37
"4953",2017-06-06 03:14:18,263883.04,5172003.41
"4954",2017-06-06 03:28:48,64192.36,5236195.77
"4955",2017-06-06 03:28:48,295225.44,5531421.21
"4956",2017-06-06 03:37:51,64820.07,5596241.28
"4957",2017-06-06 03:37:51,5613.63,5601854.91
"4958",2017-06-06 03:37:51,4808.67,5606663.58
"4959",2017-06-06 03:42:42,95869.2,5702532.78
"4960",2017-06-06 03:42:42,-5606663.58,95869.1999999983
"4961",2017-06-06 03:46:24,100188.65,196057.849999998
"4962",2017-06-06 03:46:24,249417.34,445475.189999998
"4963",2017-06-06 03:46:24,-95869.2,349605.989999998
"4964",2017-06-06 03:54:10,161065.64,510671.629999998
"4965",2017-06-06 03:54:10,135840.27,646511.899999998
"4966",2017-06-06 03:54:10,-349605.99,296905.909999998
"4967",2017-06-06 04:01:00,67009.28,363915.189999998
"4968",2017-06-06 04:01:00,-296905.91,67009.2799999983
"4969",2017-06-06 04:07:05,167570.64,234579.919999998
"4970",2017-06-06 04:07:05,229761.77,464341.689999998
"4971",2017-06-06 04:07:05,-67009.28,397332.409999998
"4972",2017-06-06 04:13:26,-397332.41,-1.68802216649055e-09
"4973",2017-06-06 04:14:18,133404.58,133404.579999998
"4974",2017-06-06 04:28:28,126683.62,260088.199999998
"4975",2017-06-06 04:28:28,104158.11,364246.309999998
"4976",2017-06-06 04:28:28,75283.93,439530.239999998
"4977",2017-06-06 04:28:28,53766.97,493297.209999998
"4978",2017-06-06 04:28:28,86736.28,580033.489999998
"4979",2017-06-06 04:28:28,-133404.58,446628.909999998
"4980",2017-06-06 04:28:28,-133404.58,313224.329999998
"4981",2017-06-06 04:35:55,106250.37,419474.699999998
"4982",2017-06-06 04:35:55,70233.2,489707.899999998
"4983",2017-06-06 04:35:55,58745.05,548452.949999998
"4984",2017-06-06 04:35:55,-313224.33,235228.619999998
"4985",2017-06-06 04:43:10,159718.5,394947.119999998
"4986",2017-06-06 04:43:10,-235228.62,159718.499999998
"4987",2017-06-06 04:51:25,85443.18,245161.679999998
"4988",2017-06-06 04:51:25,-159718.5,85443.1799999984
"4989",2017-06-06 05:13:47,95511.38,180954.559999998
"4990",2017-06-06 05:13:47,103254.57,284209.129999998
"4991",2017-06-06 05:13:47,-85443.18,198765.949999998
"4992",2017-06-06 05:25:10,128651.16,327417.109999998
"4993",2017-06-06 05:25:10,-198765.95,128651.159999998
"4994",2017-06-06 05:38:55,214746.51,343397.669999998
"4995",2017-06-06 05:38:55,76056.02,419453.689999998
"4996",2017-06-06 05:38:55,15594.17,435047.859999998
"4997",2017-06-06 05:38:55,-128651.16,306396.699999998
"4998",2017-06-06 05:44:43,-306396.7,-1.57160684466362e-09
"4999",2017-06-06 05:55:04,21847.37,21847.3699999984
"5000",2017-06-06 06:15:40,69363.03,91210.3999999984
"5001",2017-06-06 06:15:40,116206.11,207416.509999998
"5002",2017-06-06 06:15:40,-21847.37,185569.139999998
"5003",2017-06-06 06:25:45,63429.08,248998.219999998
"5004",2017-06-06 06:25:45,-185569.14,63429.0799999984
"5005",2017-06-06 06:30:43,-63429.08,-1.55705492943525e-09
"5006",2017-06-06 07:21:43,602765.12,602765.119999998
"5007",2017-06-06 07:21:43,71439.27,674204.389999999
"5008",2017-06-06 07:50:28,23184.09,697388.479999998
"5009",2017-06-06 07:50:28,-674204.39,23184.0899999985
"5010",2017-06-06 08:06:30,-23184.09,-1.54614099301398e-09
"5011",2017-06-06 08:21:24,25762.08,25762.0799999985
"5012",2017-06-06 08:29:57,72787.73,98549.8099999985
"5013",2017-06-06 08:29:57,-25762.08,72787.7299999985
"5014",2017-06-06 08:36:25,-72787.73,-1.54250301420689e-09
"5015",2017-06-06 09:04:00,77454.05,77454.0499999985
"5016",2017-06-06 09:05:10,-77454.05,-1.54250301420689e-09
"5017",2017-06-06 09:25:54,109808.59,109808.589999998
"5018",2017-06-06 09:37:26,64726.3,174534.889999998
"5019",2017-06-06 09:37:26,-109808.59,64726.2999999984
"5020",2017-06-06 09:41:13,-64726.3,-1.55705492943525e-09
"5021",2017-06-06 12:02:06,36671.77,36671.7699999984
"5022",2017-06-06 12:11:05,126112.23,162783.999999998
"5023",2017-06-06 12:11:05,-36671.77,126112.229999998
"5024",2017-06-06 12:17:19,177055.27,303167.499999998
"5025",2017-06-06 12:17:19,-126112.23,177055.269999998
"5026",2017-06-06 12:17:19,-126112.23,50943.0399999985
"5027",2017-06-06 12:17:19,87684.06,138627.099999998
"5028",2017-06-06 12:32:23,87034.11,225661.209999998
"5029",2017-06-06 12:32:23,177609.34,403270.549999998
"5030",2017-06-06 12:32:23,193756.18,597026.729999998
"5031",2017-06-06 12:32:23,45288.8,642315.529999998
"5032",2017-06-06 12:32:23,-138627.1,503688.429999998
"5033",2017-06-06 12:32:23,5887.06,509575.489999998
"5034",2017-06-06 12:32:23,-138627.1,370948.389999998
"5035",2017-06-06 13:04:44,126170.69,497119.079999998
"5036",2017-06-06 13:04:44,75686.99,572806.069999998
"5037",2017-06-06 13:04:44,74388.53,647194.599999998
"5038",2017-06-06 13:04:44,133272.16,780466.759999998
"5039",2017-06-06 13:06:29,99543.14,880009.899999999
"5040",2017-06-06 13:06:29,-370948.39,509061.509999998
"5041",2017-06-06 13:24:38,135330.61,644392.119999998
"5042",2017-06-06 13:24:38,-509061.51,135330.609999998
"5043",2017-06-06 13:24:38,6289.44,141620.049999998
"5044",2017-06-06 13:45:16,65756.21,207376.259999998
"5045",2017-06-06 13:45:16,96831.29,304207.549999998
"5046",2017-06-06 13:45:16,103868.14,408075.689999998
"5047",2017-06-06 13:45:16,-141620.05,266455.639999999
"5048",2017-06-06 13:58:13,83661.03,350116.669999999
"5049",2017-06-06 13:58:13,102342.61,452459.279999999
"5050",2017-06-06 13:58:13,-266455.64,186003.639999999
"5051",2017-06-06 14:12:50,73409.22,259412.859999999
"5052",2017-06-06 14:12:50,-186003.64,73409.2199999985
"5053",2017-06-06 14:16:47,104759.95,178169.169999998
"5054",2017-06-06 14:16:47,-73409.22,104759.949999998
"5055",2017-06-06 14:21:46,109635.13,214395.079999998
"5056",2017-06-06 14:21:46,-104759.95,109635.129999998
"5057",2017-06-06 14:27:15,-109635.13,-1.52795109897852e-09
"5058",2017-06-06 15:02:51,159587.98,159587.979999998
"5059",2017-06-06 15:02:51,73372.82,232960.799999998
"5060",2017-06-06 15:07:51,107150.52,340111.319999998
"5061",2017-06-06 15:07:51,-232960.8,107150.519999999
"5062",2017-06-06 16:04:17,90125.42,197275.939999998
"5063",2017-06-06 16:04:17,82063.02,279338.959999999
"5064",2017-06-06 16:04:17,66621.65,345960.609999998
"5065",2017-06-06 16:33:34,96174.52,442135.129999998
"5066",2017-06-06 16:33:34,185368.95,627504.079999998
"5067",2017-06-06 16:33:34,149686.42,777190.499999998
"5068",2017-06-06 16:45:37,83528.94,860719.439999999
"5069",2017-06-06 16:45:37,104920.16,965639.599999999
"5070",2017-06-06 16:45:37,193504.87,1159144.47
"5071",2017-06-06 16:50:33,81706.62,1240851.09
"5072",2017-06-06 16:57:40,99841,1340692.09
"5073",2017-06-06 16:57:40,72460.02,1413152.11
"5074",2017-06-06 16:57:40,205645.63,1618797.74
"5075",2017-06-06 16:57:40,24598.29,1643396.03
"5076",2017-06-06 17:02:12,121397.95,1764793.98
"5077",2017-06-06 17:02:12,-1643396.03,121397.949999998
"5078",2017-06-06 17:02:12,4592.17,125990.119999998
"5079",2017-06-06 17:02:12,-107150.52,18839.5999999983
"5080",2017-06-06 17:02:12,13425.87,32265.4699999983
"5081",2017-06-06 17:15:02,110927.63,143193.099999998
"5082",2017-06-06 17:15:02,172246.93,315440.029999998
"5083",2017-06-06 17:15:02,-32265.47,283174.559999998
"5084",2017-06-06 17:46:26,293808.44,576982.999999998
"5085",2017-06-06 17:50:56,391097.2,968080.199999998
"5086",2017-06-06 18:02:12,87845.56,1055925.76
"5087",2017-06-06 18:05:14,150675.01,1206600.77
"5088",2017-06-06 18:27:37,149546.98,1356147.75
"5089",2017-06-06 18:27:37,76804.78,1432952.53
"5090",2017-06-06 18:27:37,3798.19,1436750.72
"5091",2017-06-06 18:43:26,39329.54,1476080.26
"5092",2017-06-06 18:43:26,44056.93,1520137.19
"5093",2017-06-06 19:04:09,186400.54,1706537.73
"5094",2017-06-06 19:04:09,61238.64,1767776.37
"5095",2017-06-06 19:18:15,97258.31,1865034.68
"5096",2017-06-06 20:03:37,65734.82,1930769.5
"5097",2017-06-06 20:03:37,73084.57,2003854.07
"5098",2017-06-07 06:51:59,18946.01,2022800.08
"5099",2017-06-07 07:18:13,158331.6,2181131.68
"5100",2017-06-07 07:18:13,74382.43,2255514.11
"5101",2017-06-07 08:06:37,53426.5,2308940.61
"5102",2017-06-07 08:20:40,76406.46,2385347.07
"5103",2017-06-07 09:17:54,105294.64,2490641.71
"5104",2017-06-07 09:17:54,76133.01,2566774.72
"5105",2017-06-07 09:30:51,80973.38,2647748.1
"5106",2017-06-07 09:46:26,21318.57,2669066.67
"5107",2017-06-07 10:34:02,68215.36,2737282.03
"5108",2017-06-07 11:00:08,74228.94,2811510.97
"5109",2017-06-07 11:50:46,85061.87,2896572.84
"5110",2017-06-07 13:18:07,64293.22,2960866.06
"5111",2017-06-07 13:32:07,96255.05,3057121.11
"5112",2017-06-07 13:32:07,27444.07,3084565.18
"5113",2017-06-07 13:52:05,18273.35,3102838.53
"5114",2017-06-07 13:52:05,24908.55,3127747.08
"5115",2017-06-07 13:52:05,20718.3,3148465.38
"5116",2017-06-07 13:59:54,68118.04,3216583.42
"5117",2017-06-07 14:06:02,92848.24,3309431.66
"5118",2017-06-07 14:42:08,26576.31,3336007.97
"5119",2017-06-07 14:54:35,17591.81,3353599.78
"5120",2017-06-07 15:09:09,72645.43,3426245.21
"5121",2017-06-07 16:17:37,98089.71,3524334.92
"5122",2017-06-07 16:17:37,32754.77,3557089.69
"5123",2017-06-07 16:28:08,139665.87,3696755.56
"5124",2017-06-07 16:35:15,116102.83,3812858.39
"5125",2017-06-07 17:31:03,66598.24,3879456.63
"5126",2017-06-07 19:02:17,66521.24,3945977.87
"5127",2017-06-07 19:50:26,64331.14,4010309.01
"5128",2017-06-07 19:54:07,67263.48,4077572.49
"5129",2017-06-07 21:07:42,140781.34,4218353.83
"5130",2017-06-07 22:09:44,104851.77,4323205.6
"5131",2017-06-07 22:32:40,156717.64,4479923.24
"5132",2017-06-07 22:32:40,178427.49,4658350.73
"5133",2017-06-07 22:32:40,237147.3,4895498.03
"5134",2017-06-07 22:56:07,70685.08,4966183.11
"5135",2017-06-07 22:56:07,64867.4,5031050.51
"5136",2017-06-07 22:56:07,68185.69,5099236.2
"5137",2017-06-07 22:56:07,73043.06,5172279.26
"5138",2017-06-07 22:56:07,80188.48,5252467.74
"5139",2017-06-07 23:18:17,176362.47,5428830.21
"5140",2017-06-07 23:18:17,114433.13,5543263.34
"5141",2017-06-07 23:24:40,143454.02,5686717.36
"5142",2017-06-07 23:29:00,35736.73,5722454.09
"5143",2017-06-08 00:12:18,91585,5814039.09
"5144",2017-06-08 00:21:48,107271.55,5921310.64
"5145",2017-06-08 00:29:25,137837.74,6059148.38
"5146",2017-06-08 00:30:20,104283.13,6163431.51
"5147",2017-06-08 00:34:06,146119.95,6309551.46
"5148",2017-06-08 00:40:04,77149.02,6386700.48
"5149",2017-06-08 00:46:14,99244.7,6485945.18
"5150",2017-06-08 00:46:14,77120.84,6563066.02
"5151",2017-06-08 00:59:42,89173.07,6652239.09
"5152",2017-06-08 01:21:06,76612.55,6728851.64
"5153",2017-06-08 01:21:06,118090.99,6846942.63
"5154",2017-06-08 01:21:06,71720.6,6918663.23
"5155",2017-06-08 01:21:06,13588.61,6932251.84
"5156",2017-06-08 01:33:48,153718.37,7085970.21
"5157",2017-06-08 01:33:48,82875.82,7168846.03
"5158",2017-06-08 01:33:48,7109.3,7175955.33
"5159",2017-06-08 01:33:48,102030.09,7277985.42
"5160",2017-06-08 02:01:45,165410.74,7443396.16
"5161",2017-06-08 02:16:46,100647.63,7544043.79
"5162",2017-06-08 02:16:46,80765.7,7624809.49
"5163",2017-06-08 02:29:13,104397.93,7729207.42
"5164",2017-06-08 08:08:41,-7729207.42,-9.31322574615479e-10
"5165",2017-06-08 13:30:04,68296.02,68296.0199999991
"5166",2017-06-08 13:41:32,67306.29,135602.309999999
"5167",2017-06-08 14:28:37,65184.29,200786.599999999
"5168",2017-06-08 14:28:37,70739.36,271525.959999999
"5169",2017-06-08 14:28:37,73466.55,344992.509999999
"5170",2017-06-08 15:17:32,74708.14,419700.649999999
"5171",2017-06-08 15:28:49,69778.21,489478.859999999
"5172",2017-06-08 15:47:18,77221.8,566700.659999999
"5173",2017-06-08 18:23:03,66762.71,633463.369999999
"5174",2017-06-08 19:01:56,67056.66,700520.029999999
"5175",2017-06-08 19:06:56,78715.58,779235.609999999
"5176",2017-06-09 02:29:36,11470.31,790705.919999999
"5177",2017-06-09 03:04:08,137092.27,927798.189999999
"5178",2017-06-09 03:04:08,116796.83,1044595.02
"5179",2017-06-09 14:40:27,77024.68,1121619.7
"5180",2017-06-09 15:29:42,75861.97,1197481.67
"5181",2017-06-09 16:14:49,44870.13,1242351.8
"5182",2017-06-10 07:13:07,-1242351.8,-1.16415321826935e-09
"5183",2017-06-10 10:04:44,12254.9,12254.8999999988
"5184",2017-06-10 10:23:11,-12254.9,-1.16415321826935e-09
"5185",2017-06-10 10:38:58,21509.71,21509.7099999988
"5186",2017-06-10 10:57:12,-21509.71,-1.16415321826935e-09
"5187",2017-06-10 11:02:25,80771.38,80771.3799999988
"5188",2017-06-10 11:09:21,-80771.38,-1.16415321826935e-09
"5189",2017-06-10 13:02:26,14072.11,14072.1099999988
"5190",2017-06-10 14:53:48,66968.86,81040.9699999988
"5191",2017-06-10 15:04:21,111055.51,192096.479999999
"5192",2017-06-10 17:42:48,172549.66,364646.139999999
"5193",2017-06-10 18:40:28,124864.51,489510.649999999
"5194",2017-06-10 18:40:28,233212.37,722723.019999999
"5195",2017-06-10 18:41:10,48624.43,771347.449999999
"5196",2017-06-10 22:26:30,98805.14,870152.589999999
"5197",2017-06-10 22:30:19,112611.22,982763.809999999
"5198",2017-06-10 23:10:12,73798.57,1056562.38
"5199",2017-06-10 23:52:46,96412.34,1152974.72
"5200",2017-06-11 00:00:35,105175.28,1258150
"5201",2017-06-11 00:00:35,66977.62,1325127.62
"5202",2017-06-11 00:33:22,148127.46,1473255.08
"5203",2017-06-11 00:41:58,67670.79,1540925.87
"5204",2017-06-11 01:21:56,105140.9,1646066.77
"5205",2017-06-11 01:21:56,94307.66,1740374.43
"5206",2017-06-11 02:27:09,119642.96,1860017.39
"5207",2017-06-11 02:27:09,157345.15,2017362.54
"5208",2017-06-11 05:04:28,12970.13,2030332.67
"5209",2017-06-11 05:12:08,99761.9,2130094.57
"5210",2017-06-11 05:12:08,70949.34,2201043.91
"5211",2017-06-11 06:49:40,57746.88,2258790.79
"5212",2017-06-11 10:23:31,105451.4,2364242.19
"5213",2017-06-11 13:30:44,137817.86,2502060.05
"5214",2017-06-11 14:23:51,191379.13,2693439.18
"5215",2017-06-11 14:53:42,191379.13,2884818.31
"5216",2017-06-11 14:53:42,118658.55,3003476.86
"5217",2017-06-11 14:53:42,72802.73,3076279.59
"5218",2017-06-11 15:15:54,111435.9,3187715.49
"5219",2017-06-11 15:33:19,215429.01,3403144.5
"5220",2017-06-11 15:33:19,83608.78,3486753.28
"5221",2017-06-11 15:41:37,74636.94,3561390.22
"5222",2017-06-11 15:42:29,76381.9,3637772.12
"5223",2017-06-11 16:03:04,70566.65,3708338.77
"5224",2017-06-11 16:03:04,81402.33,3789741.1
"5225",2017-06-11 16:03:04,89136.23,3878877.33
"5226",2017-06-11 16:03:04,74001.86,3952879.19
"5227",2017-06-11 16:09:13,225797.61,4178676.8
"5228",2017-06-11 16:45:45,133081.58,4311758.38
"5229",2017-06-11 16:45:45,95270.16,4407028.54
"5230",2017-06-11 16:56:43,82868.39,4489896.93
"5231",2017-06-11 17:13:13,66870.5,4556767.43
"5232",2017-06-11 18:22:00,86610.66,4643378.09
"5233",2017-06-11 18:34:49,120005.91,4763384
"5234",2017-06-11 18:34:49,85873.94,4849257.94
"5235",2017-06-11 18:34:49,106145.5,4955403.44
"5236",2017-06-11 21:02:13,77642.4,5033045.84
"5237",2017-06-11 21:13:19,87815.69,5120861.53
"5238",2017-06-11 21:20:40,86354.92,5207216.45
"5239",2017-06-11 21:26:10,94811.03,5302027.48
"5240",2017-06-11 21:42:59,56842.54,5358870.02
"5241",2017-06-11 21:58:57,101953.16,5460823.18
"5242",2017-06-11 21:58:57,88939.47,5549762.65
"5243",2017-06-11 22:25:36,121087.06,5670849.71
"5244",2017-06-12 06:11:34,89918.68,5760768.39
"5245",2017-06-12 06:11:34,25067.97,5785836.36
"5246",2017-06-12 06:11:34,28792.94,5814629.3
"5247",2017-06-12 06:18:50,107297.7,5921927
"5248",2017-06-12 06:18:50,108880.29,6030807.29
"5249",2017-06-12 06:48:50,89136.23,6119943.52
"5250",2017-06-12 06:53:33,73353.92,6193297.44
"5251",2017-06-12 10:40:33,69509.49,6262806.93
"5252",2017-06-12 10:40:33,250081.34,6512888.27
"5253",2017-06-12 11:00:07,85757.75,6598646.02
"5254",2017-06-12 11:16:24,128037.64,6726683.66
"5255",2017-06-12 11:16:24,284072.65,7010756.31
"5256",2017-06-12 11:30:05,78522.29,7089278.6
"5257",2017-06-12 11:30:05,4505.94,7093784.54
"5258",2017-06-12 11:54:36,154820.16,7248604.7
"5259",2017-06-12 11:54:36,191298.62,7439903.32
"5260",2017-06-12 12:06:46,74794.2,7514697.52
"5261",2017-06-12 12:06:46,128673.57,7643371.09
"5262",2017-06-12 12:11:01,199173.61,7842544.7
"5263",2017-06-12 12:11:01,241102.47,8083647.17
"5264",2017-06-12 12:20:21,122398.02,8206045.19
"5265",2017-06-12 12:31:18,97079.97,8303125.16
"5266",2017-06-12 12:51:45,81816.52,8384941.68
"5267",2017-06-12 12:51:45,108799.26,8493740.94
"5268",2017-06-12 12:57:57,128944.28,8622685.22
"5269",2017-06-12 13:11:21,258859.36,8881544.58
"5270",2017-06-12 13:22:45,87928.06,8969472.64
"5271",2017-06-12 13:22:45,79273.21,9048745.85
"5272",2017-06-12 13:22:45,106085.82,9154831.67
"5273",2017-06-12 13:38:43,78635.07,9233466.74
"5274",2017-06-12 13:38:43,101340.85,9334807.59
"5275",2017-06-12 13:38:43,56548.34,9391355.93
"5276",2017-06-12 13:38:43,13621.55,9404977.48
"5277",2017-06-12 13:38:43,43395.45,9448372.93
"5278",2017-06-12 13:55:18,71464.78,9519837.71
"5279",2017-06-12 14:05:53,93064.84,9612902.55
"5280",2017-06-12 14:05:53,58346.48,9671249.03
"5281",2017-06-12 14:07:54,84831.99,9756081.02
"5282",2017-06-12 14:16:37,159520.15,9915601.17
"5283",2017-06-12 14:16:37,81376.49,9996977.66
"5284",2017-06-12 14:16:37,23772.97,10020750.63
"5285",2017-06-12 14:21:00,4729.01,10025479.64
"5286",2017-06-12 14:36:00,100032.17,10125511.81
"5287",2017-06-12 15:11:33,69930.75,10195442.56
"5288",2017-06-12 15:11:33,20165.74,10215608.3
"5289",2017-06-12 15:26:44,219448.39,10435056.69
"5290",2017-06-12 15:26:44,62372.75,10497429.44
"5291",2017-06-12 15:26:44,144080.55,10641509.99
"5292",2017-06-12 15:26:44,36394.26,10677904.25
"5293",2017-06-12 15:41:16,64996.77,10742901.02
"5294",2017-06-12 15:41:16,403447.06,11146348.08
"5295",2017-06-12 15:54:27,139747.31,11286095.39
"5296",2017-06-12 15:59:18,58961.18,11345056.57
"5297",2017-06-12 16:25:57,95504.34,11440560.91
"5298",2017-06-12 16:33:03,292161.05,11732721.96
"5299",2017-06-12 16:33:03,117301.54,11850023.5
"5300",2017-06-12 16:38:48,60607.59,11910631.09
"5301",2017-06-12 16:53:55,88715.28,11999346.37
"5302",2017-06-12 16:53:55,139645.82,12138992.19
"5303",2017-06-12 17:07:33,157878.54,12296870.73
"5304",2017-06-12 17:07:33,165835.29,12462706.02
"5305",2017-06-12 17:18:51,107967.24,12570673.26
"5306",2017-06-12 17:34:04,206653.9,12777327.16
"5307",2017-06-12 17:34:04,131914.23,12909241.39
"5308",2017-06-12 17:47:31,107683.24,13016924.63
"5309",2017-06-12 18:16:12,188479.37,13205404
"5310",2017-06-12 18:16:12,151477.96,13356881.96
"5311",2017-06-12 18:24:05,120031.47,13476913.43
"5312",2017-06-12 18:42:36,300665.6,13777579.03
"5313",2017-06-12 18:42:36,143934.88,13921513.91
"5314",2017-06-12 19:38:21,83305.65,14004819.56
"5315",2017-06-12 19:38:21,107581.34,14112400.9
"5316",2017-06-12 19:57:17,15801.79,14128202.69
"5317",2017-06-12 22:41:54,72741.45,14200944.14
"5318",2017-06-12 22:46:09,521151.9,14722096.04
"5319",2017-06-12 23:11:18,82674.88,14804770.92
"5320",2017-06-12 23:11:18,253242.42,15058013.34
"5321",2017-06-12 23:11:18,32366.08,15090379.42
"5322",2017-06-12 23:11:18,66199.26,15156578.68
"5323",2017-06-12 23:11:18,126179.53,15282758.21
"5324",2017-06-12 23:35:36,98804.32,15381562.53
"5325",2017-06-12 23:35:36,472846.79,15854409.32
"5326",2017-06-12 23:35:36,13823.98,15868233.3
"5327",2017-06-13 00:22:05,129448.45,15997681.75
"5328",2017-06-13 00:22:05,65196.98,16062878.73
"5329",2017-06-13 00:22:05,91057.15,16153935.88
"5330",2017-06-13 00:22:05,13285.17,16167221.05
"5331",2017-06-13 00:25:15,74346.17,16241567.22
"5332",2017-06-13 00:25:15,147434.09,16389001.31
"5333",2017-06-13 02:02:22,67371.93,16456373.24
"5334",2017-06-13 03:29:01,87607.87,16543981.11
"5335",2017-06-13 03:29:01,60249.93,16604231.04
"5336",2017-06-13 03:29:01,60343.2,16664574.24
"5337",2017-06-13 03:29:01,101279.99,16765854.23
"5338",2017-06-13 04:07:40,82570.09,16848424.32
"5339",2017-06-13 04:07:40,63260.14,16911684.46
"5340",2017-06-13 04:07:40,78048.75,16989733.21
"5341",2017-06-13 04:07:40,84673.59,17074406.8
"5342",2017-06-13 04:07:40,66159.79,17140566.59
"5343",2017-06-13 07:58:25,-17140566.59,0
"5344",2017-06-13 11:00:01,7146.74,7146.74
"5345",2017-06-13 11:18:15,-7146.74,0
"5346",2017-06-13 11:42:14,109231.72,109231.72
"5347",2017-06-13 12:09:31,-109231.72,0
"5348",2017-06-13 12:23:09,84564.88,84564.88
"5349",2017-06-13 12:23:09,140875.39,225440.27
"5350",2017-06-13 12:33:59,78445.22,303885.49
"5351",2017-06-13 12:33:59,-225440.27,78445.22
"5352",2017-06-13 12:38:41,97031.36,175476.58
"5353",2017-06-13 12:38:41,-78445.22,97031.36
"5354",2017-06-13 12:38:41,-78445.22,18586.14
"5355",2017-06-13 13:01:46,63777.54,82363.68
"5356",2017-06-13 13:01:46,91248.85,173612.53
"5357",2017-06-13 13:01:46,-18586.14,155026.39
"5358",2017-06-13 13:11:01,-155026.39,0
"5359",2017-06-13 13:47:39,100678.8,100678.8
"5360",2017-06-13 13:58:13,-100678.8,0
"5361",2017-06-13 14:02:53,48912.25,48912.25
"5362",2017-06-13 14:33:39,-48912.25,0
"5363",2017-06-13 17:48:14,93969.16,93969.16
"5364",2017-06-13 18:23:10,-93969.16,0
"5365",2017-06-13 19:30:22,22452.5,22452.5
"5366",2017-06-13 19:32:52,-22452.5,0
"5367",2017-06-13 20:34:37,18737.59,18737.59
"5368",2017-06-13 20:55:55,-18737.59,0
"5369",2017-06-13 21:35:31,19007.76,19007.76
"5370",2017-06-13 21:39:27,-19007.76,0
"5371",2017-06-14 01:21:26,77822.04,77822.04
"5372",2017-06-14 08:47:49,205658.55,283480.59
"5373",2017-06-14 08:47:49,100045.21,383525.8
"5374",2017-06-14 08:55:19,371821.13,755346.93
"5375",2017-06-14 09:32:40,190750.59,946097.52
"5376",2017-06-14 14:24:35,239032.97,1185130.49
"5377",2017-06-14 15:40:52,87845.27,1272975.76
"5378",2017-06-14 16:18:38,77166.64,1350142.4
"5379",2017-06-14 16:52:21,165289.34,1515431.74
"5380",2017-06-14 16:59:35,70045.67,1585477.41
"5381",2017-06-14 17:10:25,80045.68,1665523.09
"5382",2017-06-14 17:13:54,236206.99,1901730.08
"5383",2017-06-14 17:41:24,101093.79,2002823.87
"5384",2017-06-14 17:41:24,145279.7,2148103.57
"5385",2017-06-14 17:41:24,80045.7,2228149.27
"5386",2017-06-14 17:41:24,50027.3,2278176.57
"5387",2017-06-14 17:41:24,17193.98,2295370.55
"5388",2017-06-14 17:59:13,130045.76,2425416.31
"5389",2017-06-14 17:59:13,84672.76,2510089.07
"5390",2017-06-14 17:59:13,10339.02,2520428.09
"5391",2017-06-14 18:11:57,134121.83,2654549.92
"5392",2017-06-14 18:11:57,88380.56,2742930.48
"5393",2017-06-14 18:11:57,75098.47,2818028.95
"5394",2017-06-14 18:18:10,90013.56,2908042.51
"5395",2017-06-14 18:38:42,105207.62,3013250.13
"5396",2017-06-14 18:38:42,95957.26,3109207.39
"5397",2017-06-14 18:38:42,69548.98,3178756.37
"5398",2017-06-14 18:54:27,60361.69,3239118.06
"5399",2017-06-14 18:54:27,167139.8,3406257.86
"5400",2017-06-14 19:11:31,157521.42,3563779.28
"5401",2017-06-14 19:11:31,55312.36,3619091.64
"5402",2017-06-14 19:11:31,45753.15,3664844.79
"5403",2017-06-14 19:11:31,4328,3669172.79
"5404",2017-06-14 19:22:36,53277.79,3722450.58
"5405",2017-06-14 19:35:45,54400.49,3776851.07
"5406",2017-06-14 19:35:45,60550.91,3837401.98
"5407",2017-06-14 19:35:45,119027.8,3956429.78
"5408",2017-06-14 19:35:45,77173.73,4033603.51
"5409",2017-06-14 20:01:23,119695.82,4153299.33
"5410",2017-06-14 20:01:23,54453.47,4207752.8
"5411",2017-06-14 20:01:23,55033.95,4262786.75
"5412",2017-06-14 20:01:23,88357.04,4351143.79
"5413",2017-06-14 20:01:23,87551.43,4438695.22
"5414",2017-06-14 20:01:23,15429.89,4454125.11
"5415",2017-06-14 20:14:32,52806.87,4506931.98
"5416",2017-06-14 20:14:32,71481.51,4578413.49
"5417",2017-06-14 20:32:02,74681.32,4653094.81
"5418",2017-06-14 20:40:07,96272.13,4749366.94
"5419",2017-06-14 20:49:06,84063.76,4833430.7
"5420",2017-06-14 21:13:15,74288.3,4907719
"5421",2017-06-14 21:25:18,77514.44,4985233.44
"5422",2017-06-14 21:45:19,231704.73,5216938.17
"5423",2017-06-14 21:51:09,152702.45,5369640.62
"5424",2017-06-14 22:09:57,59963.67,5429604.29
"5425",2017-06-14 22:09:57,210901.26,5640505.55
"5426",2017-06-14 22:09:57,93598.15,5734103.7
"5427",2017-06-14 22:12:33,73217.78,5807321.48
"5428",2017-06-14 22:45:46,77823.28,5885144.76
"5429",2017-06-14 22:45:46,145050,6030194.76
"5430",2017-06-14 22:45:46,343855.83,6374050.59
"5431",2017-06-14 23:22:12,70365.42,6444416.01
"5432",2017-06-14 23:22:12,132098.81,6576514.82
"5433",2017-06-14 23:22:12,88934.34,6665449.16
"5434",2017-06-14 23:22:12,4728.73,6670177.89
"5435",2017-06-14 23:26:15,50410.76,6720588.65
"5436",2017-06-14 23:46:01,88934.41,6809523.06
"5437",2017-06-14 23:46:01,253333.9,7062856.96
"5438",2017-06-15 00:00:00,104925.29,7167782.25
"5439",2017-06-15 00:07:39,44644.44,7212426.69
"5440",2017-06-15 00:07:39,92126.65,7304553.34
"5441",2017-06-15 00:07:39,3054.72,7307608.06
"5442",2017-06-15 00:08:53,99029.89,7406637.95
"5443",2017-06-15 00:18:40,128416,7535053.95
"5444",2017-06-15 00:18:40,177823.5,7712877.45
"5445",2017-06-15 01:01:08,81973.29,7794850.74
"5446",2017-06-15 01:01:08,188934.55,7983785.29
"5447",2017-06-15 01:01:08,61429.2,8045214.49
"5448",2017-06-15 01:01:08,180046.56,8225261.05
"5449",2017-06-15 01:01:08,91380.07,8316641.12
"5450",2017-06-15 01:25:46,155229.19,8471870.31
"5451",2017-06-15 01:25:46,50274.43,8522144.74
"5452",2017-06-15 01:25:46,89203.85,8611348.59
"5453",2017-06-15 01:37:26,153176.87,8764525.46
"5454",2017-06-15 01:37:26,104546.36,8869071.82
"5455",2017-06-15 01:48:59,86213.1,8955284.92
"5456",2017-06-15 01:48:59,35953.26,8991238.18
"5457",2017-06-15 02:12:22,119865.25,9111103.43
"5458",2017-06-15 02:50:59,43927.81,9155031.24
"5459",2017-06-15 03:41:24,53403.39,9208434.63
"5460",2017-06-15 03:55:49,23488.32,9231922.95
"5461",2017-06-15 04:17:03,80985.66,9312908.61
"5462",2017-06-15 04:17:03,50385,9363293.61
"5463",2017-06-15 04:26:36,157460.38,9520753.99
"5464",2017-06-15 04:33:27,104753.43,9625507.42
"5465",2017-06-15 04:33:27,130108.18,9755615.6
"5466",2017-06-15 04:33:27,30305.46,9785921.06
"5467",2017-06-15 04:54:07,247910.02,10033831.08
"5468",2017-06-15 04:54:07,124101.43,10157932.51
"5469",2017-06-15 04:54:07,88618.92,10246551.43
"5470",2017-06-15 04:54:07,72886.85,10319438.28
"5471",2017-06-15 05:00:41,124164.98,10443603.26
"5472",2017-06-15 05:10:19,177983.41,10621586.67
"5473",2017-06-15 05:34:00,258615.11,10880201.78
"5474",2017-06-15 05:34:00,112294.31,10992496.09
"5475",2017-06-15 05:34:00,68330.03,11060826.12
"5476",2017-06-15 05:34:00,35870.66,11096696.78
"5477",2017-06-15 06:02:57,58075.86,11154772.64
"5478",2017-06-15 06:02:57,127841.63,11282614.27
"5479",2017-06-15 06:02:57,400269.4,11682883.67
"5480",2017-06-15 06:22:58,383507.9,12066391.57
"5481",2017-06-15 06:22:58,14480.05,12080871.62
"5482",2017-06-15 07:04:33,188148.65,12269020.27
"5483",2017-06-15 07:04:33,97940.9,12366961.17
"5484",2017-06-15 07:06:48,280377.41,12647338.58
"5485",2017-06-15 07:56:46,134848.61,12782187.19
"5486",2017-06-15 07:56:46,162489.15,12944676.34
"5487",2017-06-15 07:56:46,83413.37,13028089.71
"5488",2017-06-15 07:56:46,60457.56,13088547.27
"5489",2017-06-15 07:56:46,26960.66,13115507.93
"5490",2017-06-15 08:03:09,70351.88,13185859.81
"5491",2017-06-15 08:03:09,130047.23,13315907.04
"5492",2017-06-15 08:23:27,85682.4,13401589.44
"5493",2017-06-15 08:26:52,84892.44,13486481.88
"5494",2017-06-15 08:26:52,86588.33,13573070.21
"5495",2017-06-15 09:06:37,104385.51,13677455.72
"5496",2017-06-15 09:06:37,62922.58,13740378.3
"5497",2017-06-15 09:06:37,131376.26,13871754.56
"5498",2017-06-15 09:06:37,17483.74,13889238.3
"5499",2017-06-15 09:30:19,77192.52,13966430.82
"5500",2017-06-15 09:39:21,62096.2,14028527.02
"5501",2017-06-15 10:07:08,81979.57,14110506.59
"5502",2017-06-15 10:07:08,66737.7,14177244.29
"5503",2017-06-15 10:07:08,150065.3,14327309.59
"5504",2017-06-15 10:07:08,122924.97,14450234.56
"5505",2017-06-15 10:27:32,177824.44,14628059
"5506",2017-06-15 10:29:40,80338.58,14708397.58
"5507",2017-06-15 10:31:38,38122.48,14746520.06
"5508",2017-06-15 10:49:14,135138.99,14881659.05
"5509",2017-06-15 10:49:14,79846.85,14961505.9
"5510",2017-06-15 11:25:52,133495.89,15095001.79
"5511",2017-06-15 11:25:52,195080.08,15290081.87
"5512",2017-06-15 11:25:52,125512.97,15415594.84
"5513",2017-06-15 11:25:52,177935.55,15593530.39
"5514",2017-06-15 13:19:25,384566.49,15978096.88
"5515",2017-06-15 13:19:25,300048.54,16278145.42
"5516",2017-06-15 13:19:25,70048.53,16348193.95
"5517",2017-06-15 13:19:25,177824.57,16526018.52
"5518",2017-06-15 13:49:04,177825.58,16703844.1
"5519",2017-06-15 13:51:18,300048.6,17003892.7
"5520",2017-06-15 14:05:04,93527.4,17097420.1
"5521",2017-06-15 14:26:03,370048.62,17467468.72
"5522",2017-06-15 14:38:01,170242.11,17637710.83
"5523",2017-06-15 14:38:01,71322.12,17709032.95
"5524",2017-06-15 14:57:03,74620.53,17783653.48
"5525",2017-06-15 14:57:03,171673.87,17955327.35
"5526",2017-06-15 14:57:03,101298.96,18056626.31
"5527",2017-06-15 15:03:27,95841.75,18152468.06
"5528",2017-06-15 15:18:05,83067.27,18235535.33
"5529",2017-06-15 15:18:05,177825.74,18413361.07
"5530",2017-06-15 15:18:05,245764.13,18659125.2
"5531",2017-06-15 15:37:36,191022.12,18850147.32
"5532",2017-06-15 15:37:36,3103.56,18853250.88
"5533",2017-06-15 15:37:36,36831.05,18890081.93
"5534",2017-06-15 16:14:34,32652.24,18922734.17
"5535",2017-06-15 16:14:34,35567.67,18958301.84
"5536",2017-06-15 16:14:34,31648.44,18989950.28
"5537",2017-06-15 16:14:34,37041.27,19026991.55
"5538",2017-06-15 16:14:34,42489.51,19069481.06
"5539",2017-06-15 16:14:34,77233.98,19146715.04
"5540",2017-06-15 16:14:34,35650.69,19182365.73
"5541",2017-06-15 16:14:34,28265.3,19210631.03
"5542",2017-06-15 16:21:44,177825.94,19388456.97
"5543",2017-06-15 23:30:36,-19388456.97,1.11758708953857e-08
"5544",2017-06-15 23:59:32,4604.33,4604.33000001118
"5545",2017-06-16 00:03:27,-4604.33,1.11758708953857e-08
"5546",2017-06-16 00:11:05,111144.25,111144.250000011
"5547",2017-06-16 00:19:47,-111144.25,1.11758708953857e-08
"5548",2017-06-16 01:35:46,97434.47,97434.4700000112
"5549",2017-06-16 01:43:08,-97434.47,1.11758708953857e-08
"5550",2017-06-16 02:18:50,105087.37,105087.370000011
"5551",2017-06-16 02:18:50,60435.33,165522.700000011
"5552",2017-06-16 02:18:50,4258.1,169780.800000011
"5553",2017-06-16 02:36:27,-169780.8,1.12049747258425e-08
"5554",2017-06-16 02:36:27,113169.8,113169.800000011
"5555",2017-06-16 03:08:15,68418.64,181588.440000011
"5556",2017-06-16 03:08:15,96892.23,278480.670000011
"5557",2017-06-16 03:08:15,122695.16,401175.830000011
"5558",2017-06-16 03:08:15,96363.61,497539.440000011
"5559",2017-06-16 03:08:15,-113169.8,384369.640000011
"5560",2017-06-16 03:08:15,3552.21,387921.850000011
"5561",2017-06-16 03:22:29,-387921.85,1.12922862172127e-08
"5562",2017-06-16 03:22:29,27217.8,27217.8000000113
"5563",2017-06-16 03:22:29,106778.65,133996.450000011
"5564",2017-06-16 03:36:05,67698.52,201694.970000011
"5565",2017-06-16 03:36:05,-133996.45,67698.5200000113
"5566",2017-06-16 03:36:05,8718.01,76416.5300000112
"5567",2017-06-16 03:51:49,58586.84,135003.370000011
"5568",2017-06-16 03:51:49,-76416.53,58586.8400000112
"5569",2017-06-16 04:21:29,78405.92,136992.760000011
"5570",2017-06-16 04:21:29,-58586.84,78405.9200000112
"5571",2017-06-16 04:27:42,-78405.92,1.12486304715276e-08
"5572",2017-06-16 04:41:08,25135.25,25135.2500000112
"5573",2017-06-16 04:47:43,-25135.25,1.12486304715276e-08
"5574",2017-06-16 05:49:11,39023.25,39023.2500000112
"5575",2017-06-16 05:52:06,-39023.25,1.12486304715276e-08
"5576",2017-06-16 08:17:04,66771.07,66771.0700000113
"5577",2017-06-16 08:17:04,19668.32,86439.3900000112
"5578",2017-06-16 08:17:04,141640.82,228080.210000011
"5579",2017-06-16 08:30:51,-228080.21,1.12631823867559e-08
"5580",2017-06-16 08:48:16,21602.54,21602.5400000113
"5581",2017-06-16 09:00:10,-21602.54,1.12631823867559e-08
"5582",2017-06-16 10:07:18,261604.77,261604.770000011
"5583",2017-06-16 10:15:25,-261604.77,1.12631823867559e-08
"5584",2017-06-16 11:55:34,172751.6,172751.600000011
"5585",2017-06-16 11:57:01,3593.11,176344.710000011
"5586",2017-06-16 11:57:01,-172751.6,3593.11000001125
"5587",2017-06-16 12:05:13,55365.12,58958.2300000113
"5588",2017-06-16 12:05:13,-3593.11,55365.1200000113
"5589",2017-06-16 12:05:13,-3593.11,51772.0100000113
"5590",2017-06-16 12:05:13,69681.46,121453.470000011
"5591",2017-06-16 12:05:13,104523.08,225976.550000011
"5592",2017-06-16 12:28:34,62064.06,288040.610000011
"5593",2017-06-16 12:28:34,60677.43,348718.040000011
"5594",2017-06-16 12:28:34,56194.41,404912.450000011
"5595",2017-06-16 12:28:34,-225976.55,178935.900000011
"5596",2017-06-16 12:34:46,74548.33,253484.230000011
"5597",2017-06-16 12:34:46,-178935.9,74548.3300000113
"5598",2017-06-16 12:54:32,125214.79,199763.120000011
"5599",2017-06-16 12:54:32,63543.57,263306.690000011
"5600",2017-06-16 12:54:32,58928.61,322235.300000011
"5601",2017-06-16 12:54:32,-74548.33,247686.970000011
"5602",2017-06-16 12:54:32,53996.82,301683.790000011
"5603",2017-06-16 13:07:04,97412.97,399096.760000011
"5604",2017-06-16 13:07:04,94527.54,493624.300000011
"5605",2017-06-16 13:07:04,66996.1,560620.400000011
"5606",2017-06-16 13:07:04,104006.19,664626.590000011
"5607",2017-06-16 13:07:04,-301683.79,362942.800000011
"5608",2017-06-16 13:24:25,134731.92,497674.720000011
"5609",2017-06-16 13:24:25,77839.6,575514.320000011
"5610",2017-06-16 13:24:25,-362942.8,212571.520000011
"5611",2017-06-16 13:24:25,4007.96,216579.480000011
"5612",2017-06-16 13:38:16,65397.98,281977.460000011
"5613",2017-06-16 13:38:16,11272.93,293250.390000011
"5614",2017-06-16 13:38:16,-216579.48,76670.9100000112
"5615",2017-06-16 13:54:33,60158.66,136829.570000011
"5616",2017-06-16 13:54:33,101236.47,238066.040000011
"5617",2017-06-16 13:54:33,125508.88,363574.920000011
"5618",2017-06-16 13:54:33,-76670.91,286904.010000011
"5619",2017-06-16 13:54:33,-76670.91,210233.100000011
"5620",2017-06-16 14:07:02,-210233.1,1.11758708953857e-08
"5621",2017-06-16 14:07:02,19153.24,19153.2400000112
"5622",2017-06-16 14:15:56,70375.13,89528.3700000112
"5623",2017-06-16 14:15:56,-19153.24,70375.1300000112
"5624",2017-06-16 14:19:48,-70375.13,1.11758708953857e-08
"5625",2017-06-16 14:25:07,65876.35,65876.3500000112
"5626",2017-06-16 14:39:01,-65876.35,1.11758708953857e-08
"5627",2017-06-16 14:39:01,63234.86,63234.8600000112
"5628",2017-06-16 14:46:15,-63234.86,1.11758708953857e-08
"5629",2017-06-16 14:59:43,93911.88,93911.8800000112
"5630",2017-06-16 15:09:49,-93911.88,1.11758708953857e-08
"5631",2017-06-16 18:05:03,89641.71,89641.7100000112
"5632",2017-06-16 18:16:50,25673.46,115315.170000011
"5633",2017-06-16 19:02:13,102649.76,217964.930000011
"5634",2017-06-16 19:41:28,80314.2,298279.130000011
"5635",2017-06-16 19:45:08,163842.38,462121.510000011
"5636",2017-06-16 20:34:48,83613.19,545734.700000011
"5637",2017-06-16 20:34:48,95526.24,641260.940000011
"5638",2017-06-16 20:34:48,4312.43,645573.370000011
"5639",2017-06-16 20:56:45,77885.71,723459.080000011
"5640",2017-06-16 20:56:45,16391.79,739850.870000011
"5641",2017-06-16 21:25:04,105043.14,844894.010000011
"5642",2017-06-16 22:07:13,104449.06,949343.070000011
"5643",2017-06-16 22:07:13,116244.47,1065587.54000001
"5644",2017-06-16 22:07:13,65131.24,1130718.78000001
"5645",2017-06-16 22:07:13,92642.94,1223361.72000001
"5646",2017-06-16 22:07:13,11894.13,1235255.85000001
"5647",2017-06-17 07:48:24,11623.67,1246879.52000001
"5648",2017-06-17 07:51:16,70882.92,1317762.44000001
"5649",2017-06-17 08:05:32,96804.3,1414566.74000001
"5650",2017-06-17 08:42:17,91857.83,1506424.57000001
"5651",2017-06-17 09:19:36,90632.7,1597057.27000001
"5652",2017-06-17 09:30:49,112112.45,1709169.72000001
"5653",2017-06-17 09:30:49,12660.31,1721830.03000001
"5654",2017-06-17 09:47:55,96378.39,1818208.42000001
"5655",2017-06-17 09:47:55,137385.91,1955594.33000001
"5656",2017-06-17 09:57:31,17175.89,1972770.22000001
"5657",2017-06-17 11:42:27,37659.72,2010429.94000001
"5658",2017-06-17 15:34:21,115743.82,2126173.76000001
"5659",2017-06-17 16:42:23,23528.57,2149702.33000001
"5660",2017-06-17 22:33:08,91838.86,2241541.19000001
"5661",2017-06-18 00:06:44,97158.83,2338700.02000001
"5662",2017-06-18 00:06:44,107299.41,2445999.43000001
"5663",2017-06-18 00:19:04,147041.65,2593041.08000001
"5664",2017-06-18 00:33:44,169886.79,2762927.87000001
"5665",2017-06-18 00:33:44,114530.39,2877458.26000001
"5666",2017-06-18 00:52:16,28911.32,2906369.58000001
"5667",2017-06-18 01:03:29,126252.41,3032621.99000001
"5668",2017-06-18 01:37:28,158469.65,3191091.64000001
"5669",2017-06-18 03:10:09,124227.19,3315318.83000001
"5670",2017-06-18 03:10:09,79101.54,3394420.37000001
"5671",2017-06-18 05:04:35,212987.31,3607407.68000001
"5672",2017-06-18 06:22:52,112834.71,3720242.39000001
"5673",2017-06-18 06:22:52,154974.3,3875216.69000001
"5674",2017-06-18 06:22:52,88155.09,3963371.78000001
"5675",2017-06-18 08:11:10,352641.98,4316013.76000001
"5676",2017-06-18 08:16:11,52237.05,4368250.81000001
"5677",2017-06-18 08:39:21,170748.38,4538999.19000001
"5678",2017-06-18 09:22:43,12265.99,4551265.18000001
"5679",2017-06-18 10:43:18,77830.37,4629095.55000001
"5680",2017-06-18 10:43:18,77830.39,4706925.94000001
"5681",2017-06-18 11:00:51,118244.89,4825170.83000001
"5682",2017-06-18 11:44:40,111872.82,4937043.65000001
"5683",2017-06-18 12:01:18,122994.3,5060037.95000001
"5684",2017-06-18 12:27:26,69107.24,5129145.19000001
"5685",2017-06-18 12:40:00,147444.43,5276589.62000001
"5686",2017-06-18 12:40:52,109498.8,5386088.42000001
"5687",2017-06-18 13:05:29,142011.82,5528100.24000001
"5688",2017-06-18 13:19:03,90524.09,5618624.33000001
"5689",2017-06-18 13:19:03,126522.23,5745146.56000001
"5690",2017-06-18 13:35:59,176630.27,5921776.83000001
"5691",2017-06-18 13:38:20,214557.59,6136334.42000001
"5692",2017-06-18 13:40:49,190225.42,6326559.84000001
"5693",2017-06-18 14:05:34,82598.94,6409158.78000001
"5694",2017-06-18 14:05:34,80823.53,6489982.31000001
"5695",2017-06-18 14:14:34,100176.45,6590158.76000001
"5696",2017-06-18 14:14:34,160749.25,6750908.01000001
"5697",2017-06-18 14:33:31,126778.08,6877686.09000001
"5698",2017-06-18 14:33:31,154440.85,7032126.94000001
"5699",2017-06-18 14:49:08,115506.45,7147633.39000001
"5700",2017-06-18 14:49:08,111595.59,7259228.98000001
"5701",2017-06-18 19:28:52,111160.64,7370389.62000001
"5702",2017-06-18 20:20:58,242089.46,7612479.08000001
"5703",2017-06-18 20:20:58,136211.79,7748690.87000001
"5704",2017-06-18 20:42:22,93387.71,7842078.58000001
"5705",2017-06-18 21:07:51,13019.57,7855098.15000001
"5706",2017-06-18 21:29:22,88652.22,7943750.37000001
"5707",2017-06-18 22:38:14,94519.12,8038269.49000001
"5708",2017-06-18 22:38:14,144446.48,8182715.97000001
"5709",2017-06-19 00:06:34,70898.4,8253614.37000001
"5710",2017-06-19 00:48:33,91255.8,8344870.17000001
"5711",2017-06-19 00:48:33,60306.87,8405177.04000001
"5712",2017-06-19 01:10:44,70058.68,8475235.72000001
"5713",2017-06-19 02:56:24,101941.37,8577177.09000001
"5714",2017-06-19 03:11:41,131401.28,8708578.37000001
"5715",2017-06-19 07:27:05,-8708578.37,9.31322574615479e-09
"5716",2017-06-19 08:53:30,21979.38,21979.3800000093
"5717",2017-06-19 08:56:32,-21979.38,9.31322574615479e-09
"5718",2017-06-19 09:11:48,33732.82,33732.8200000093
"5719",2017-06-19 09:20:11,-33732.82,9.31322574615479e-09
"5720",2017-06-19 09:35:25,85495.27,85495.2700000093
"5721",2017-06-19 09:50:33,-85495.27,9.31322574615479e-09
"5722",2017-06-19 09:55:57,44501,44501.0000000093
"5723",2017-06-19 10:04:23,-44501,9.31322574615479e-09
"5724",2017-06-19 10:04:23,17628.7,17628.7000000093
"5725",2017-06-19 10:15:59,124534.73,142163.430000009
"5726",2017-06-19 10:15:59,-17628.7,124534.730000009
"5727",2017-06-19 10:38:40,-124534.73,9.31322574615479e-09
"5728",2017-06-19 13:50:32,88990.14,88990.1400000093
"5729",2017-06-19 13:50:32,73888.74,162878.880000009
"5730",2017-06-19 13:56:58,-162878.88,9.31322574615479e-09
"5731",2017-06-19 14:12:51,74762.65,74762.6500000093
"5732",2017-06-19 14:33:28,-74762.65,9.31322574615479e-09
"5733",2017-06-19 17:23:38,74455.58,74455.5800000093
"5734",2017-06-19 17:36:01,-74455.58,9.31322574615479e-09
"5735",2017-06-20 02:07:08,89491.95,89491.9500000093
"5736",2017-06-20 02:07:08,95363.54,184855.490000009
"5737",2017-06-20 02:11:56,-184855.49,9.31322574615479e-09
"5738",2017-06-20 02:15:00,92741.72,92741.7200000093
"5739",2017-06-20 02:20:22,-92741.72,9.31322574615479e-09
"5740",2017-06-20 04:28:28,25668.1,25668.1000000093
"5741",2017-06-20 04:31:47,-25668.1,9.31322574615479e-09
"5742",2017-06-20 04:35:41,16914.55,16914.5500000093
"5743",2017-06-20 04:54:13,-16914.55,9.31322574615479e-09
"5744",2017-06-20 05:25:12,96497.73,96497.7300000093
"5745",2017-06-20 05:25:12,86711.77,183209.500000009
"5746",2017-06-20 05:25:12,112915.84,296125.340000009
"5747",2017-06-20 05:25:12,138961.45,435086.790000009
"5748",2017-06-20 05:27:46,-435086.79,9.31322574615479e-09
"5749",2017-06-20 07:23:09,13652.15,13652.1500000093
"5750",2017-06-20 07:23:09,88654.05,102306.200000009
"5751",2017-06-20 07:33:41,-102306.2,9.31322574615479e-09
"5752",2017-06-20 09:55:12,125053.96,125053.960000009
"5753",2017-06-20 09:55:12,32971.72,158025.680000009
"5754",2017-06-20 10:02:20,-158025.68,9.31322574615479e-09
"5755",2017-06-20 10:41:51,100585.13,100585.130000009
"5756",2017-06-20 10:41:51,30729.92,131315.050000009
"5757",2017-06-20 10:46:31,-131315.05,9.31322574615479e-09
"5758",2017-06-20 11:41:13,37683.47,37683.4700000093
"5759",2017-06-20 11:41:40,132319.69,170003.160000009
"5760",2017-06-20 11:44:48,14190.52,184193.680000009
"5761",2017-06-20 11:44:48,-170003.16,14190.5200000093
"5762",2017-06-20 11:57:57,-14190.52,9.30231180973351e-09
"5763",2017-06-20 12:01:46,116379.24,116379.240000009
"5764",2017-06-20 12:08:39,-116379.24,9.29867383092642e-09
"5765",2017-06-20 12:27:44,92091.17,92091.1700000093
"5766",2017-06-20 12:27:44,94055.94,186147.110000009
"5767",2017-06-20 12:39:22,-186147.11,9.31322574615479e-09
"5768",2017-06-20 13:28:48,21961.68,21961.6800000093
"5769",2017-06-20 13:28:48,104632.06,126593.740000009
"5770",2017-06-20 13:46:15,-126593.74,9.29867383092642e-09
"5771",2017-06-20 13:46:15,74972.55,74972.5500000093
"5772",2017-06-20 13:50:34,-74972.55,9.29867383092642e-09
"5773",2017-06-20 14:44:13,108626.93,108626.930000009
"5774",2017-06-20 14:44:13,132473.54,241100.470000009
"5775",2017-06-20 14:54:21,79121.3,320221.770000009
"5776",2017-06-20 15:29:16,103487.07,423708.840000009
"5777",2017-06-20 15:42:39,-423708.84,9.25501808524132e-09
"5778",2017-06-20 21:38:03,164130.62,164130.620000009
"5779",2017-06-20 22:33:59,208632.71,372763.330000009
"5780",2017-06-20 23:49:13,117570.64,490333.970000009
"5781",2017-06-21 00:04:22,93399.75,583733.720000009
"5782",2017-06-21 00:04:22,124558.96,708292.680000009
"5783",2017-06-21 00:11:12,76614.6,784907.280000009
"5784",2017-06-21 00:35:55,121581.35,906488.630000009
"5785",2017-06-21 06:36:29,219671.14,1126159.77000001
"5786",2017-06-21 06:36:29,222745.86,1348905.63000001
"5787",2017-06-21 06:36:29,219412.76,1568318.39000001
"5788",2017-06-21 06:52:02,225190.91,1793509.30000001
"5789",2017-06-21 07:22:20,228038.29,2021547.59000001
"5790",2017-06-21 10:36:47,198483.64,2220031.23000001
"5791",2017-06-21 13:08:35,85927.04,2305958.27000001
"5792",2017-06-21 21:26:01,-2305958.27,9.31322574615479e-09
"5793",2017-06-21 21:39:46,84825.11,84825.1100000093
"5794",2017-06-21 21:39:46,81133.86,165958.970000009
"5795",2017-06-21 21:39:46,101577.46,267536.430000009
"5796",2017-06-21 21:48:30,-267536.43,9.31322574615479e-09
"5797",2017-06-21 22:33:22,18183.55,18183.5500000093
"5798",2017-06-21 22:44:22,-18183.55,9.31322574615479e-09
"5799",2017-06-21 22:44:22,752007.25,752007.250000009
"5800",2017-06-21 22:56:12,-752007.25,9.31322574615479e-09
"5801",2017-06-21 22:56:12,451923.83,451923.830000009
"5802",2017-06-21 23:15:07,-451923.83,9.31322574615479e-09
"5803",2017-06-21 23:19:14,134922.35,134922.350000009
"5804",2017-06-21 23:29:27,-134922.35,9.31322574615479e-09
"5805",2017-06-21 23:29:27,145982.45,145982.450000009
"5806",2017-06-21 23:38:46,-145982.45,9.31322574615479e-09
"5807",2017-06-21 23:46:59,278081.25,278081.250000009
"5808",2017-06-21 23:52:53,-278081.25,9.31322574615479e-09
"5809",2017-06-22 01:50:12,135992.73,135992.730000009
"5810",2017-06-22 02:04:50,-135992.73,9.31322574615479e-09
"5811",2017-06-22 04:48:16,221740.5,221740.500000009
"5812",2017-06-22 04:50:32,-221740.5,9.31322574615479e-09
"5813",2017-06-22 06:14:50,299239.93,299239.930000009
"5814",2017-06-22 06:14:50,137251.07,436491.000000009
"5815",2017-06-22 07:04:39,-436491,9.31322574615479e-09
"5816",2017-06-22 08:39:56,154200.74,154200.740000009
"5817",2017-06-22 08:39:56,190458.03,344658.770000009
"5818",2017-06-22 08:39:56,210204.4,554863.170000009
"5819",2017-06-22 08:46:43,-554863.17,9.31322574615479e-09
"5820",2017-06-22 08:46:43,169927.44,169927.440000009
"5821",2017-06-22 09:11:22,-169927.44,9.31322574615479e-09
"5822",2017-06-22 09:30:34,24896.38,24896.3800000093
"5823",2017-06-22 09:36:22,-24896.38,9.31322574615479e-09
"5824",2017-06-22 09:36:22,162325.94,162325.940000009
"5825",2017-06-22 09:36:22,88664.08,250990.020000009
"5826",2017-06-22 10:09:36,-250990.02,9.34232957661152e-09
"5827",2017-06-22 10:28:44,37093.48,37093.4800000093
"5828",2017-06-22 10:28:44,189043.29,226136.770000009
"5829",2017-06-22 10:28:44,229701.12,455837.890000009
"5830",2017-06-22 10:28:44,201024.57,656862.460000009
"5831",2017-06-22 10:31:34,-656862.46,9.31322574615479e-09
"5832",2017-06-22 14:03:21,153962.36,153962.360000009
"5833",2017-06-22 14:16:51,-153962.36,9.31322574615479e-09
"5834",2017-06-22 15:53:37,136542.59,136542.590000009
"5835",2017-06-22 16:00:50,-136542.59,9.31322574615479e-09
"5836",2017-06-22 16:45:28,107229.29,107229.290000009
"5837",2017-06-22 16:51:22,-107229.29,9.31322574615479e-09
"5838",2017-06-22 17:02:29,125840.93,125840.930000009
"5839",2017-06-22 17:32:42,-125840.93,9.31322574615479e-09
"5840",2017-06-22 18:08:07,91298.89,91298.8900000093
"5841",2017-06-22 18:13:36,-91298.89,9.31322574615479e-09
"5842",2017-06-23 17:03:37,39264.96,39264.9600000093
"5843",2017-06-23 17:13:58,-39264.96,9.31322574615479e-09
"5844",2017-06-23 18:05:39,117548.11,117548.110000009
"5845",2017-06-23 18:05:39,279305.96,396854.070000009
"5846",2017-06-23 18:31:38,-396854.07,9.31322574615479e-09
"5847",2017-06-23 21:34:36,119556.27,119556.270000009
"5848",2017-06-23 21:34:36,123317.16,242873.430000009
"5849",2017-06-23 21:39:47,-242873.43,9.31322574615479e-09
"5850",2017-06-23 21:54:33,155352.89,155352.890000009
"5851",2017-06-23 22:17:15,-155352.89,9.31322574615479e-09
"5852",2017-06-24 00:28:29,21628.9,21628.9000000093
"5853",2017-06-24 01:03:49,-21628.9,9.31322574615479e-09
"5854",2017-06-24 04:25:56,135250.61,135250.610000009
"5855",2017-06-24 04:28:17,-135250.61,9.31322574615479e-09
"5856",2017-06-24 05:08:14,92132.27,92132.2700000093
"5857",2017-06-24 05:47:00,-92132.27,9.31322574615479e-09
"5858",2017-06-24 05:47:00,125360.45,125360.450000009
"5859",2017-06-24 05:47:00,69603.75,194964.200000009
"5860",2017-06-24 06:21:00,-194964.2,9.31322574615479e-09
"5861",2017-06-24 06:21:00,182184.22,182184.220000009
"5862",2017-06-24 06:21:00,158454.41,340638.630000009
"5863",2017-06-24 06:25:25,-340638.63,9.31322574615479e-09
"5864",2017-06-24 06:29:00,157343,157343.000000009
"5865",2017-06-24 06:37:39,-157343,9.31322574615479e-09
"5866",2017-06-24 08:24:13,81558.6,81558.6000000093
"5867",2017-06-24 08:36:51,-81558.6,9.31322574615479e-09
"5868",2017-06-24 08:59:53,100328.51,100328.510000009
"5869",2017-06-24 11:24:11,153263.12,253591.630000009
"5870",2017-06-24 13:44:15,430514.16,684105.790000009
"5871",2017-06-24 13:44:15,203838.48,887944.270000009
"5872",2017-06-24 13:44:15,204218.93,1092163.20000001
"5873",2017-06-24 14:05:11,308832.22,1400995.42000001
"5874",2017-06-24 14:05:11,315711.72,1716707.14000001
"5875",2017-06-24 14:05:11,350560.55,2067267.69000001
"5876",2017-06-24 14:33:02,254104.31,2321372.00000001
"5877",2017-06-24 14:33:02,259095.76,2580467.76000001
"5878",2017-06-24 14:49:12,137798.9,2718266.66000001
"5879",2017-06-24 15:09:34,150182.82,2868449.48000001
"5880",2017-06-24 15:34:19,100058.33,2968507.81000001
"5881",2017-06-24 16:41:23,145038.37,3113546.18000001
"5882",2017-06-24 16:41:23,242920.94,3356467.12000001
"5883",2017-06-24 17:26:15,70058.87,3426525.99000001
"5884",2017-06-24 17:38:26,488925.07,3915451.06000001
"5885",2017-06-24 17:38:26,103975.51,4019426.57000001
"5886",2017-06-24 17:38:26,104662.19,4124088.76000001
"5887",2017-06-24 17:51:38,164506.06,4288594.82000001
"5888",2017-06-24 18:35:16,227096.77,4515691.59000001
"5889",2017-06-24 18:58:57,160212.89,4675904.48000001
"5890",2017-06-24 19:06:07,135853,4811757.48000001
"5891",2017-06-24 19:30:32,180860.27,4992617.75000001
"5892",2017-06-24 22:42:02,928682.54,5921300.29000001
"5893",2017-06-24 23:11:31,164366.78,6085667.07000001
"5894",2017-06-24 23:42:06,170375.1,6256042.17000001
"5895",2017-06-25 00:25:26,103175.91,6359218.08000001
"5896",2017-06-25 00:54:25,154318.31,6513536.39000001
"5897",2017-06-25 00:54:25,98266.61,6611803.00000001
"5898",2017-06-25 01:28:30,127977.55,6739780.55000001
"5899",2017-06-25 01:28:30,150435.4,6890215.95000001
"5900",2017-06-25 01:28:30,85510.92,6975726.87000001
"5901",2017-06-25 01:28:30,120486.97,7096213.84000001
"5902",2017-06-25 01:28:30,119103.19,7215317.03000001
"5903",2017-06-25 02:20:35,159107.8,7374424.83000001
"5904",2017-06-25 02:20:35,185910.26,7560335.09000001
"5905",2017-06-25 02:20:35,164045.22,7724380.31000001
"5906",2017-06-25 02:20:35,278402.99,8002783.30000001
"5907",2017-06-25 02:43:11,50060.09,8052843.39000001
"5908",2017-06-25 02:43:11,-8002783.3,50060.0900000073
"5909",2017-06-25 02:43:11,198603.98,248664.070000007
"5910",2017-06-25 02:43:11,141643.32,390307.390000007
"5911",2017-06-25 02:43:11,154167.61,544475.000000007
"5912",2017-06-25 02:55:17,-544475,7.33416527509689e-09
"5913",2017-06-25 02:55:17,140133.57,140133.570000007
"5914",2017-06-25 03:15:43,-140133.57,7.33416527509689e-09
"5915",2017-06-25 03:15:43,189753.37,189753.370000007
"5916",2017-06-25 03:24:20,-189753.37,7.33416527509689e-09
"5917",2017-06-25 03:29:27,170524.76,170524.760000007
"5918",2017-06-25 03:40:24,-170524.76,7.33416527509689e-09
"5919",2017-06-25 04:17:09,186840.37,186840.370000007
"5920",2017-06-25 04:17:09,118121.77,304962.140000007
"5921",2017-06-25 04:17:09,182568.42,487530.560000007
"5922",2017-06-25 04:17:09,170365.28,657895.840000007
"5923",2017-06-25 04:20:18,-657895.84,7.45058059692383e-09
"5924",2017-06-25 06:29:54,65247.48,65247.4800000075
"5925",2017-06-25 06:34:59,-65247.48,7.45058059692383e-09
"5926",2017-06-25 07:11:48,117315.89,117315.890000007
"5927",2017-06-25 07:46:31,-117315.89,7.45058059692383e-09
"5928",2017-06-25 07:46:31,151037.28,151037.280000007
"5929",2017-06-25 07:57:09,-151037.28,7.45058059692383e-09
"5930",2017-06-25 07:57:09,123530.84,123530.840000007
"5931",2017-06-25 08:08:21,-123530.84,7.45058059692383e-09
"5932",2017-06-25 09:20:00,150338.02,150338.020000007
"5933",2017-06-25 09:33:09,-150338.02,7.45058059692383e-09
"5934",2017-06-25 16:30:38,113317.88,113317.880000007
"5935",2017-06-25 16:43:58,-113317.88,7.45058059692383e-09
"5936",2017-06-25 17:15:39,89594.19,89594.1900000075
"5937",2017-06-25 17:44:13,-89594.19,7.45058059692383e-09
"5938",2017-06-25 18:26:02,97193.71,97193.7100000075
"5939",2017-06-25 18:26:02,88740.61,185934.320000007
"5940",2017-06-25 18:34:30,-185934.32,7.45058059692383e-09
"5941",2017-06-25 18:34:30,81158.43,81158.4300000074
"5942",2017-06-25 18:45:41,-81158.43,7.45058059692383e-09
"5943",2017-06-25 20:03:33,169407.32,169407.320000007
"5944",2017-06-25 20:11:16,-169407.32,7.45058059692383e-09
"5945",2017-06-25 20:19:21,189137.34,189137.340000007
"5946",2017-06-25 20:23:53,-189137.34,7.45058059692383e-09
"5947",2017-06-25 20:36:29,297175.49,297175.490000007
"5948",2017-06-25 21:00:54,-297175.49,7.45058059692383e-09
"5949",2017-06-25 21:00:54,128817.37,128817.370000007
"5950",2017-06-25 21:00:54,244895.86,373713.230000007
"5951",2017-06-25 21:32:03,-373713.23,7.45058059692383e-09
"5952",2017-06-25 22:06:23,183118.53,183118.530000007
"5953",2017-06-25 22:06:23,262254.06,445372.590000007
"5954",2017-06-25 22:06:23,215771.64,661144.230000007
"5955",2017-06-25 22:06:23,212242.49,873386.720000007
"5956",2017-06-25 22:16:59,-873386.72,7.45058059692383e-09
"5957",2017-06-25 22:16:59,169895.26,169895.260000007
"5958",2017-06-25 22:21:03,-169895.26,7.45058059692383e-09
"5959",2017-06-25 23:35:22,244977.54,244977.540000007
"5960",2017-06-25 23:35:22,90789,335766.540000007
"5961",2017-06-25 23:56:13,-335766.54,7.50878825783730e-09
"5962",2017-06-26 01:33:54,144257.68,144257.680000008
"5963",2017-06-26 01:48:36,-144257.68,7.50878825783730e-09
"5964",2017-06-26 01:48:36,154265.4,154265.400000008
"5965",2017-06-26 01:55:01,-154265.4,7.50878825783730e-09
"5966",2017-06-26 01:55:01,187355.22,187355.220000008
"5967",2017-06-26 02:17:50,-187355.22,7.50878825783730e-09
"5968",2017-06-26 04:48:09,168221.4,168221.400000008
"5969",2017-06-26 04:48:09,120442.96,288664.360000007
"5970",2017-06-26 04:48:09,130784.9,419449.260000007
"5971",2017-06-26 04:48:09,161668.08,581117.340000007
"5972",2017-06-26 05:00:09,-581117.34,7.45058059692383e-09
"5973",2017-06-26 05:01:33,163000.88,163000.880000007
"5974",2017-06-26 05:30:47,-163000.88,7.45058059692383e-09
"5975",2017-06-26 05:30:47,100498.29,100498.290000007
"5976",2017-06-26 05:47:33,-100498.29,7.45058059692383e-09
"5977",2017-06-26 06:19:47,100061.64,100061.640000007
"5978",2017-06-26 06:38:18,-100061.64,7.45058059692383e-09
"5979",2017-06-26 07:01:52,50061.85,50061.8500000074
"5980",2017-06-26 07:04:30,-50061.85,7.45058059692383e-09
"5981",2017-06-26 08:12:49,100061.84,100061.840000007
"5982",2017-06-26 08:12:49,980476.63,1080538.47000001
"5983",2017-06-26 08:16:53,-1080538.47,7.45058059692383e-09
"5984",2017-06-26 08:23:44,245282.75,245282.750000007
"5985",2017-06-26 08:32:57,-245282.75,7.45058059692383e-09
"5986",2017-06-26 08:32:57,158722.7,158722.700000007
"5987",2017-06-26 08:48:37,-158722.7,7.45058059692383e-09
"5988",2017-06-26 08:48:37,202248.76,202248.760000007
"5989",2017-06-26 08:52:59,-202248.76,7.45058059692383e-09
"5990",2017-06-26 09:38:33,206107.87,206107.870000007
"5991",2017-06-26 09:38:33,234393.29,440501.160000007
"5992",2017-06-26 09:38:33,218133.36,658634.520000007
"5993",2017-06-26 09:38:33,221311.14,879945.660000007
"5994",2017-06-26 10:07:29,300062.49,1180008.15000001
"5995",2017-06-26 10:16:59,-1180008.15,7.45058059692383e-09
"5996",2017-06-26 10:55:17,255760.91,255760.910000007
"5997",2017-06-26 11:16:41,-255760.91,7.45058059692383e-09
"5998",2017-06-26 11:19:42,97278.31,97278.3100000074
"5999",2017-06-26 11:34:35,-97278.31,7.45058059692383e-09
"6000",2017-06-26 11:34:35,89339.71,89339.7100000075
"6001",2017-06-26 11:49:56,-89339.71,7.45058059692383e-09
"6002",2017-06-26 11:49:56,147226.33,147226.330000007
"6003",2017-06-26 11:52:21,-147226.33,7.45058059692383e-09
"6004",2017-06-26 12:12:24,266533.09,266533.090000007
"6005",2017-06-26 12:20:13,-266533.09,7.45058059692383e-09
"6006",2017-06-26 14:43:46,304454.35,304454.350000007
"6007",2017-06-26 14:52:39,-304454.35,7.45058059692383e-09
"6008",2017-06-26 15:59:33,399353.94,399353.940000007
"6009",2017-06-26 16:26:02,-399353.94,7.45058059692383e-09
"6010",2017-06-26 16:28:12,524054.08,524054.080000007
"6011",2017-06-26 16:28:12,252027.64,776081.720000007
"6012",2017-06-26 16:28:12,213729.66,989811.380000007
"6013",2017-06-26 16:43:42,-989811.38,7.45058059692383e-09
"6014",2017-06-26 16:43:42,300062.66,300062.660000007
"6015",2017-06-26 16:52:27,-300062.66,7.45058059692383e-09
"6016",2017-06-26 17:02:04,240592.76,240592.760000007
"6017",2017-06-26 17:17:44,-240592.76,7.45058059692383e-09
"6018",2017-06-26 17:17:44,496736.49,496736.490000007
"6019",2017-06-26 17:17:44,404620.17,901356.660000007
"6020",2017-06-26 17:35:29,-901356.66,7.33416527509689e-09
"6021",2017-06-26 17:45:01,122256.66,122256.660000007
"6022",2017-06-26 17:58:42,-122256.66,7.33416527509689e-09
"6023",2017-06-26 17:58:42,104124.53,104124.530000007
"6024",2017-06-26 17:58:42,193763.91,297888.440000007
"6025",2017-06-26 18:33:46,-297888.44,7.33416527509689e-09
"6026",2017-06-26 20:20:14,334706.28,334706.280000007
"6027",2017-06-26 20:20:14,300063.05,634769.330000007
"6028",2017-06-26 20:20:14,772803.11,1407572.44000001
"6029",2017-06-26 20:45:27,-1407572.44,7.45058059692383e-09
"6030",2017-06-26 21:02:33,161067.64,161067.640000007
"6031",2017-06-26 21:02:33,286460.46,447528.100000007
"6032",2017-06-26 21:02:33,451555.91,899084.010000007
"6033",2017-06-26 21:07:14,-899084.01,7.45058059692383e-09
"6034",2017-06-26 21:07:14,300063.12,300063.120000007
"6035",2017-06-26 21:16:42,-300063.12,7.45058059692383e-09
"6036",2017-06-26 22:22:49,175383.89,175383.890000007
"6037",2017-06-26 22:22:49,221052.66,396436.550000007
"6038",2017-06-26 22:32:28,-396436.55,7.50878825783730e-09
"6039",2017-06-26 23:52:35,197548.6,197548.600000008
"6040",2017-06-27 00:34:06,-197548.6,7.50878825783730e-09
"6041",2017-06-27 00:38:27,373161.11,373161.110000007
"6042",2017-06-27 00:38:27,254364.75,627525.860000008
"6043",2017-06-27 00:38:27,167694.17,795220.030000008
"6044",2017-06-27 00:42:12,-795220.03,7.56699591875076e-09
"6045",2017-06-27 00:42:12,200550.5,200550.500000008
"6046",2017-06-27 00:53:25,-200550.5,7.56699591875076e-09
"6047",2017-06-27 01:08:46,226295.54,226295.540000008
"6048",2017-06-27 01:08:46,201276.98,427572.520000008
"6049",2017-06-27 01:47:22,-427572.52,7.56699591875076e-09
"6050",2017-06-27 02:12:18,168482.52,168482.520000008
"6051",2017-06-27 02:22:11,-168482.52,7.56699591875076e-09
"6052",2017-06-27 02:24:33,188794.54,188794.540000008
"6053",2017-06-27 02:49:17,-188794.54,7.56699591875076e-09
"6054",2017-06-27 03:43:09,26036.56,26036.5600000076
"6055",2017-06-27 03:47:07,-26036.56,7.56699591875076e-09
"6056",2017-06-27 04:17:14,161355.73,161355.730000008
"6057",2017-06-27 04:22:31,-161355.73,7.56699591875076e-09
"6058",2017-06-27 04:40:53,207471.57,207471.570000008
"6059",2017-06-27 05:01:30,-207471.57,7.56699591875076e-09
"6060",2017-06-27 05:33:03,223798.1,223798.100000008
"6061",2017-06-27 05:35:58,-223798.1,7.56699591875076e-09
"6062",2017-06-27 06:58:26,205665.43,205665.430000008
"6063",2017-06-27 06:58:26,848825.98,1054491.41000001
"6064",2017-06-27 07:39:11,-1054491.41,7.6834112405777e-09
"6065",2017-06-27 07:55:15,411597.89,411597.890000008
"6066",2017-06-27 07:55:15,388161.44,799759.330000008
"6067",2017-06-27 08:10:23,-799759.33,7.79982656240463e-09
"6068",2017-06-27 08:31:17,148563.22,148563.220000008
"6069",2017-06-27 08:33:34,-148563.22,7.79982656240463e-09
"6070",2017-06-27 13:44:20,300064.68,300064.680000008
"6071",2017-06-27 14:01:08,-300064.68,7.79982656240463e-09
"6072",2017-06-27 14:01:08,300064.71,300064.710000008
"6073",2017-06-27 14:01:08,866828.46,1166893.17000001
"6074",2017-06-27 14:10:45,-1166893.17,7.91624188423157e-09
"6075",2017-06-27 14:24:48,427284.81,427284.810000008
"6076",2017-06-27 14:24:48,367966.32,795251.130000008
"6077",2017-06-27 14:32:19,-795251.13,7.91624188423157e-09
"6078",2017-06-27 14:54:35,350696.87,350696.870000008
"6079",2017-06-27 15:02:07,-350696.87,7.91624188423157e-09
"6080",2017-06-27 15:41:35,345175.55,345175.550000008
"6081",2017-06-27 15:41:35,329614.82,674790.370000008
"6082",2017-06-27 15:41:35,191393.71,866184.080000008
"6083",2017-06-27 15:43:12,-866184.08,7.91624188423157e-09
"6084",2017-06-27 16:05:38,295243.66,295243.660000008
"6085",2017-06-27 16:05:38,296399.61,591643.270000008
"6086",2017-06-27 16:09:15,-591643.27,7.91624188423157e-09
"6087",2017-06-27 17:11:08,252199.66,252199.660000008
"6088",2017-06-27 17:11:08,231949.96,484149.620000008
"6089",2017-06-27 17:14:45,-484149.62,7.91624188423157e-09
"6090",2017-06-27 17:14:45,222889.5,222889.500000008
"6091",2017-06-27 17:14:45,312460.74,535350.240000008
"6092",2017-06-27 17:22:47,-535350.24,7.91624188423157e-09
"6093",2017-06-27 18:31:56,286491.39,286491.390000008
"6094",2017-06-27 18:37:33,-286491.39,7.91624188423157e-09
"6095",2017-06-27 19:46:36,160374.95,160374.950000008
"6096",2017-06-27 19:46:36,340956.77,501331.720000008
"6097",2017-06-27 19:46:36,295703.4,797035.120000008
"6098",2017-06-27 19:46:36,177870.28,974905.400000008
"6099",2017-06-27 20:07:44,-974905.4,8.0326572060585e-09
"6100",2017-06-27 20:22:01,126002.08,126002.080000008
"6101",2017-06-27 21:04:06,-126002.08,8.0326572060585e-09
"6102",2017-06-27 21:40:36,187556.97,187556.970000008
"6103",2017-06-27 21:46:12,-187556.97,8.0326572060585e-09
"6104",2017-06-27 22:07:30,137754.65,137754.650000008
"6105",2017-06-27 22:09:31,-137754.65,8.0326572060585e-09
"6106",2017-06-27 22:27:02,228266.16,228266.160000008
"6107",2017-06-27 22:37:49,-228266.16,8.0326572060585e-09
"6108",2017-06-27 22:37:49,186624.4,186624.400000008
"6109",2017-06-27 22:42:56,-186624.4,8.0326572060585e-09
"6110",2017-06-27 23:54:30,189582.57,189582.570000008
"6111",2017-06-28 01:24:16,255352.99,444935.560000008
"6112",2017-06-28 01:24:16,274544.02,719479.580000008
"6113",2017-06-28 01:59:59,268754.49,988234.070000008
"6114",2017-06-28 03:04:49,187981.93,1176216.00000001
"6115",2017-06-28 03:24:06,152870.19,1329086.19000001
"6116",2017-06-28 05:34:52,253121.45,1582207.64000001
"6117",2017-06-28 06:10:20,151888.12,1734095.76000001
"6118",2017-06-28 06:10:20,178454.63,1912550.39000001
"6119",2017-06-28 07:13:55,104613.92,2017164.31000001
"6120",2017-06-28 16:56:15,144348.64,2161512.95000001
"6121",2017-06-28 16:56:15,171351.67,2332864.62000001
"6122",2017-06-28 16:56:15,200099.85,2532964.47000001
"6123",2017-06-28 17:43:41,186496.5,2719460.97000001
"6124",2017-06-28 17:43:41,140771.89,2860232.86000001
"6125",2017-06-28 18:10:09,125186.21,2985419.07000001
"6126",2017-06-28 19:01:17,211832.33,3197251.40000001
"6127",2017-06-28 19:05:11,256638.43,3453889.83000001
"6128",2017-06-28 19:09:08,131372.62,3585262.45000001
"6129",2017-06-28 20:04:47,331973.33,3917235.78000001
"6130",2017-06-28 20:40:16,198350.11,4115585.89000001
"6131",2017-06-28 20:40:16,238784.61,4354370.50000001
"6132",2017-06-28 20:40:16,165584.1,4519954.60000001
"6133",2017-06-28 21:05:04,249258.45,4769213.05000001
"6134",2017-06-29 01:56:34,231707.77,5000920.82000001
"6135",2017-06-29 02:35:20,188498.71,5189419.53000001
"6136",2017-06-29 04:06:28,22929.32,5212348.85000001
"6137",2017-06-29 08:47:11,146366.43,5358715.28000001
"6138",2017-06-29 08:47:11,79082.23,5437797.51000001
"6139",2017-06-29 08:58:38,187256.32,5625053.83000001
"6140",2017-06-29 10:00:50,272834.79,5897888.62000001
"6141",2017-06-29 10:00:50,245774.8,6143663.42000001
"6142",2017-06-29 10:14:37,264026.67,6407690.09000001
"6143",2017-06-29 10:14:37,373864.04,6781554.13000001
"6144",2017-06-29 10:32:48,389323.35,7170877.48000001
"6145",2017-06-29 10:36:41,257472.03,7428349.51000001
"6146",2017-06-29 10:41:26,470381.49,7898731.00000001
"6147",2017-06-29 11:20:32,328756.3,8227487.30000001
"6148",2017-06-29 11:45:01,249336.83,8476824.13000001
"6149",2017-06-29 12:58:55,165024.06,8641848.19000001
"6150",2017-06-29 13:15:15,114782.01,8756630.20000001
"6151",2017-06-29 14:47:54,156659.81,8913290.01000001
"6152",2017-06-29 15:43:48,233795.41,9147085.42000001
"6153",2017-06-29 15:43:48,262861.35,9409946.77000001
"6154",2017-06-29 17:57:49,148874.61,9558821.38000001
"6155",2017-06-29 18:23:33,202213.17,9761034.55000001
"6156",2017-06-29 18:46:45,217833.39,9978867.94000001
"6157",2017-06-29 20:04:57,159834.38,10138702.32
"6158",2017-06-29 20:04:57,118055.15,10256757.47
"6159",2017-06-29 20:47:28,108078.13,10364835.6
"6160",2017-06-29 22:06:15,96380.89,10461216.49
"6161",2017-06-29 22:15:39,215098.14,10676314.63
"6162",2017-06-29 23:29:30,272060.85,10948375.48
"6163",2017-06-30 03:49:37,246522.38,11194897.86
"6164",2017-06-30 07:34:27,-11194897.86,1.30385160446167e-08
"6165",2017-06-30 10:08:38,128480.34,128480.340000013
"6166",2017-06-30 10:12:49,-128480.34,1.30385160446167e-08
"6167",2017-06-30 11:43:18,114159.1,114159.100000013
"6168",2017-06-30 11:53:03,-114159.1,1.30385160446167e-08
"6169",2017-06-30 12:11:12,189820.36,189820.360000013
"6170",2017-06-30 12:11:12,133583.87,323404.230000013
"6171",2017-06-30 12:14:16,-323404.23,1.30385160446167e-08
"6172",2017-06-30 12:39:35,145910.9,145910.900000013
"6173",2017-06-30 12:45:17,-145910.9,1.30385160446167e-08
"6174",2017-06-30 13:23:45,180573.02,180573.020000013
"6175",2017-06-30 13:53:36,-180573.02,1.30385160446167e-08
"6176",2017-06-30 13:53:36,137704.74,137704.740000013
"6177",2017-06-30 13:55:42,-137704.74,1.30385160446167e-08
"6178",2017-06-30 14:50:58,237390.26,237390.260000013
"6179",2017-06-30 15:07:48,-237390.26,1.30385160446167e-08
"6180",2017-06-30 22:37:05,222894.26,222894.260000013
"6181",2017-06-30 22:46:48,-222894.26,1.30385160446167e-08
"6182",2017-07-01 00:56:11,191710.51,191710.510000013
"6183",2017-07-01 00:56:11,115356.83,307067.340000013
"6184",2017-07-01 00:56:11,240595.98,547663.320000013
"6185",2017-07-01 00:56:11,325470.31,873133.630000013
"6186",2017-07-01 00:56:11,234669.98,1107803.61000001
"6187",2017-07-01 01:17:21,-1107803.61,1.30385160446167e-08
"6188",2017-07-01 01:44:28,303124.51,303124.510000013
"6189",2017-07-01 01:44:28,232177.87,535302.380000013
"6190",2017-07-01 01:44:28,210949.58,746251.960000013
"6191",2017-07-01 01:44:28,156355.01,902606.970000013
"6192",2017-07-01 01:51:52,-902606.97,1.30385160446167e-08
"6193",2017-07-01 01:51:52,184334.84,184334.840000013
"6194",2017-07-01 01:56:28,-184334.84,1.30385160446167e-08
"6195",2017-07-01 02:07:15,208905.48,208905.480000013
"6196",2017-07-01 02:38:41,-208905.48,1.30385160446167e-08
"6197",2017-07-01 03:03:04,336188.9,336188.900000013
"6198",2017-07-01 03:03:04,236203.39,572392.290000013
"6199",2017-07-01 03:19:06,-572392.29,1.30385160446167e-08
"6200",2017-07-01 04:26:09,169421.97,169421.970000013
"6201",2017-07-01 04:44:36,-169421.97,1.30385160446167e-08
"6202",2017-07-01 13:52:04,177416.43,177416.430000013
"6203",2017-07-01 13:56:49,-177416.43,1.30385160446167e-08
"6204",2017-07-01 14:20:17,154870.18,154870.180000013
"6205",2017-07-01 14:27:31,-154870.18,1.30385160446167e-08
"6206",2017-07-01 14:51:22,263189.23,263189.230000013
"6207",2017-07-01 14:54:25,-263189.23,1.30385160446167e-08
"6208",2017-07-01 16:05:32,231268,231268.000000013
"6209",2017-07-01 16:16:20,-231268,1.30385160446167e-08
"6210",2017-07-01 18:01:03,347765.54,347765.540000013
"6211",2017-07-01 18:05:53,-347765.54,1.30385160446167e-08
"6212",2017-07-01 19:35:26,302907.12,302907.120000013
"6213",2017-07-01 19:35:26,342921.44,645828.560000013
"6214",2017-07-01 20:16:48,-645828.56,1.30385160446167e-08
"6215",2017-07-01 20:16:48,246836.57,246836.570000013
"6216",2017-07-01 20:26:15,-246836.57,1.30385160446167e-08
"6217",2017-07-01 20:26:15,251444.64,251444.640000013
"6218",2017-07-01 20:26:15,468586.01,720030.650000013
"6219",2017-07-01 20:36:33,-720030.65,1.30385160446167e-08
"6220",2017-07-01 21:24:42,223752.03,223752.030000013
"6221",2017-07-01 21:27:37,-223752.03,1.30385160446167e-08
"6222",2017-07-01 22:48:49,174326.29,174326.290000013
"6223",2017-07-01 22:55:49,-174326.29,1.30385160446167e-08
"6224",2017-07-02 02:49:10,209635.38,209635.380000013
"6225",2017-07-02 02:49:10,134077.33,343712.710000013
"6226",2017-07-02 03:01:30,-343712.71,1.29803083837032e-08
"6227",2017-07-02 03:01:30,240119.27,240119.270000013
"6228",2017-07-02 03:04:29,224108.65,464227.920000013
"6229",2017-07-02 03:09:07,-464227.92,1.29803083837032e-08
"6230",2017-07-02 03:14:27,181514.88,181514.880000013
"6231",2017-07-02 03:43:40,-181514.88,1.29803083837032e-08
"6232",2017-07-02 03:43:40,237554.52,237554.520000013
"6233",2017-07-02 03:52:34,-237554.52,1.29803083837032e-08
"6234",2017-07-02 06:26:44,177845.98,177845.980000013
"6235",2017-07-02 06:30:06,-177845.98,1.29803083837032e-08
"6236",2017-07-02 07:38:01,177846.67,177846.670000013
"6237",2017-07-02 07:45:16,-177846.67,1.29803083837032e-08
"6238",2017-07-02 08:17:36,50069.98,50069.980000013
"6239",2017-07-02 08:27:56,-50069.98,1.29803083837032e-08
"6240",2017-07-02 08:34:35,50070.21,50070.210000013
"6241",2017-07-02 08:39:50,-50070.21,1.29803083837032e-08
"6242",2017-07-02 11:25:38,173926.22,173926.220000013
"6243",2017-07-02 11:25:38,102113.64,276039.860000013
"6244",2017-07-02 11:31:44,-276039.86,1.29803083837032e-08
"6245",2017-07-02 12:01:11,199620.47,199620.470000013
"6246",2017-07-02 12:23:39,-199620.47,1.29803083837032e-08
"6247",2017-07-02 19:39:59,165024.47,165024.470000013
"6248",2017-07-02 19:43:21,-165024.47,1.29803083837032e-08
"6249",2017-07-03 00:09:22,195298.44,195298.440000013
"6250",2017-07-03 00:09:22,209658.69,404957.130000013
"6251",2017-07-03 00:30:53,-404957.13,1.29803083837032e-08
"6252",2017-07-03 00:30:53,245157.37,245157.370000013
"6253",2017-07-03 00:38:46,-245157.37,1.29803083837032e-08
"6254",2017-07-03 00:53:52,258431.8,258431.800000013
"6255",2017-07-03 00:58:53,-258431.8,1.29803083837032e-08
"6256",2017-07-03 02:20:37,175217.33,175217.330000013
"6257",2017-07-03 02:28:32,-175217.33,1.29803083837032e-08
"6258",2017-07-03 03:06:06,231668.66,231668.660000013
"6259",2017-07-03 03:52:17,-231668.66,1.29803083837032e-08
"6260",2017-07-03 03:52:17,114554.23,114554.230000013
"6261",2017-07-03 04:34:07,-114554.23,1.29803083837032e-08
"6262",2017-07-03 05:28:00,172472.32,172472.320000013
"6263",2017-07-03 05:34:59,-172472.32,1.29803083837032e-08
"6264",2017-07-03 14:51:58,132454.14,132454.140000013
"6265",2017-07-03 14:56:19,-132454.14,1.29803083837032e-08
"6266",2017-07-03 15:25:19,146264.09,146264.090000013
"6267",2017-07-04 15:52:57,119917.91,266182.000000013
"6268",2017-07-04 15:52:57,120620.47,386802.470000013
"6269",2017-07-05 08:17:49,193934.13,580736.600000013
"6270",2017-07-05 08:26:17,209236.58,789973.180000013
"6271",2017-07-05 08:26:17,204824.11,994797.290000013
"6272",2017-07-05 08:26:17,129296.88,1124094.17000001
"6273",2017-07-05 11:09:36,131187.57,1255281.74000001
"6274",2017-07-05 11:09:36,48242.85,1303524.59000001
"6275",2017-07-05 12:18:21,160342.54,1463867.13000001
"6276",2017-07-05 12:25:41,126123.18,1589990.31000001
"6277",2017-07-05 12:49:44,126757.47,1716747.78000001
"6278",2017-07-05 13:40:30,188027.39,1904775.17000001
"6279",2017-07-05 14:02:56,36565.82,1941340.99000001
"6280",2017-07-05 15:30:30,195553.41,2136894.40000001
"6281",2017-07-05 15:59:23,180161.71,2317056.11000001
"6282",2017-07-05 17:46:44,302883.5,2619939.61000001
"6283",2017-07-05 19:07:17,155620.14,2775559.75000001
"6284",2017-07-05 19:19:55,203833.34,2979393.09000001
"6285",2017-07-05 20:15:16,144667.14,3124060.23000001
"6286",2017-07-06 03:27:21,-3124060.23,1.30385160446167e-08
"6287",2017-07-06 14:16:00,185968.85,185968.850000013
"6288",2017-07-06 14:16:00,34068.18,220037.030000013
"6289",2017-07-06 15:05:09,-220037.03,1.30385160446167e-08
"6290",2017-07-06 15:37:12,298819.49,298819.490000013
"6291",2017-07-06 15:56:44,-298819.49,1.30385160446167e-08
"6292",2017-07-06 23:02:15,135161.65,135161.650000013
"6293",2017-07-06 23:02:15,117974.89,253136.540000013
"6294",2017-07-06 23:28:05,-253136.54,1.300941221416e-08
"6295",2017-07-06 23:49:03,91471.9,91471.900000013
"6296",2017-07-07 00:12:37,-91471.9,1.300941221416e-08
"6297",2017-07-07 00:55:11,121103.83,121103.830000013
"6298",2017-07-07 01:16:30,-121103.83,1.300941221416e-08
"6299",2017-07-07 03:57:13,105662.38,105662.380000013
"6300",2017-07-07 04:03:49,-105662.38,1.300941221416e-08
"6301",2017-07-07 07:14:31,238695.27,238695.270000013
"6302",2017-07-07 07:42:13,-238695.27,1.300941221416e-08
"6303",2017-07-07 08:05:33,167537.05,167537.050000013
"6304",2017-07-07 08:05:33,272711.17,440248.220000013
"6305",2017-07-07 08:24:17,-440248.22,1.30385160446167e-08
"6306",2017-07-07 08:36:28,219496.27,219496.270000013
"6307",2017-07-07 08:41:13,-219496.27,1.30385160446167e-08
"6308",2017-07-07 08:42:40,197948.63,197948.630000013
"6309",2017-07-07 09:05:02,-197948.63,1.30385160446167e-08
"6310",2017-07-07 10:07:09,203398.53,203398.530000013
"6311",2017-07-07 10:16:53,-203398.53,1.30385160446167e-08
"6312",2017-07-07 11:36:00,321040.37,321040.370000013
"6313",2017-07-07 11:56:39,-321040.37,1.30385160446167e-08
"6314",2017-07-07 12:13:21,235259.52,235259.520000013
"6315",2017-07-07 12:19:58,-235259.52,1.30385160446167e-08
"6316",2017-07-07 12:19:58,249127.88,249127.880000013
"6317",2017-07-07 12:34:41,-249127.88,1.30385160446167e-08
"6318",2017-07-07 12:34:41,292985.28,292985.280000013
"6319",2017-07-07 12:56:00,-292985.28,1.30385160446167e-08
"6320",2017-07-07 12:56:00,300971.05,300971.050000013
"6321",2017-07-07 12:56:00,250420.82,551391.870000013
"6322",2017-07-07 12:56:00,285681.76,837073.630000013
"6323",2017-07-07 13:04:54,-837073.63,1.30385160446167e-08
"6324",2017-07-07 13:06:06,243769.4,243769.400000013
"6325",2017-07-07 13:15:47,-243769.4,1.30385160446167e-08
"6326",2017-07-07 13:46:19,302761.85,302761.850000013
"6327",2017-07-07 13:49:47,-302761.85,1.30385160446167e-08
"6328",2017-07-07 14:10:26,243775.17,243775.170000013
"6329",2017-07-07 14:19:39,-243775.17,1.30385160446167e-08
"6330",2017-07-07 14:38:26,269606.65,269606.650000013
"6331",2017-07-07 15:14:38,-269606.65,1.30385160446167e-08
"6332",2017-07-07 15:22:06,249331.01,249331.010000013
"6333",2017-07-07 15:22:06,256940.68,506271.690000013
"6334",2017-07-07 15:58:20,-506271.69,1.30385160446167e-08
"6335",2017-07-07 16:06:19,181035.51,181035.510000013
"6336",2017-07-07 16:09:15,-181035.51,1.30385160446167e-08
"6337",2017-07-07 19:19:24,183892.06,183892.060000013
"6338",2017-07-07 19:23:44,-183892.06,1.30385160446167e-08
"6339",2017-07-07 20:04:45,231913.16,231913.160000013
"6340",2017-07-07 20:19:30,-231913.16,1.30385160446167e-08
"6341",2017-07-07 21:16:27,215612.94,215612.940000013
"6342",2017-07-07 21:44:19,-215612.94,1.30385160446167e-08
"6343",2017-07-07 22:16:11,235272.49,235272.490000013
"6344",2017-07-07 22:18:44,-235272.49,1.30385160446167e-08
"6345",2017-07-07 23:05:35,205252.7,205252.700000013
"6346",2017-07-07 23:05:35,181328.03,386580.730000013
"6347",2017-07-07 23:18:40,-386580.73,1.30385160446167e-08
"6348",2017-07-07 23:18:40,180925.87,180925.870000013
"6349",2017-07-08 00:02:45,-180925.87,1.30385160446167e-08
"6350",2017-07-08 00:30:42,221317.79,221317.790000013
"6351",2017-07-08 00:30:42,201496.86,422814.650000013
"6352",2017-07-08 00:30:42,173104.1,595918.750000013
"6353",2017-07-08 00:30:42,251576.58,847495.330000013
"6354",2017-07-08 00:38:49,-847495.33,1.30385160446167e-08
"6355",2017-07-08 00:38:42,186505.29,186505.290000013
"6356",2017-07-08 00:55:38,-186505.29,1.30385160446167e-08
"6357",2017-07-08 00:55:38,210791.55,210791.550000013
"6358",2017-07-08 01:03:02,-210791.55,1.30385160446167e-08
"6359",2017-07-08 01:39:35,306711.94,306711.940000013
"6360",2017-07-08 01:54:46,-306711.94,1.30385160446167e-08
"6361",2017-07-08 01:54:46,231947.68,231947.680000013
"6362",2017-07-08 02:02:05,-231947.68,1.30385160446167e-08
"6363",2017-07-08 02:08:26,231292.59,231292.590000013
"6364",2017-07-08 02:22:51,-231292.59,1.30385160446167e-08
"6365",2017-07-08 02:22:51,196953.99,196953.990000013
"6366",2017-07-08 02:44:36,-196953.99,1.30385160446167e-08
"6367",2017-07-08 02:44:36,220660.57,220660.570000013
"6368",2017-07-08 02:44:36,214150.86,434811.430000013
"6369",2017-07-08 02:51:32,-434811.43,1.30385160446167e-08
"6370",2017-07-08 02:51:32,221619.7,221619.700000013
"6371",2017-07-08 02:58:07,-221619.7,1.30385160446167e-08
"6372",2017-07-08 02:58:07,187962.47,187962.470000013
"6373",2017-07-08 03:03:53,-187962.47,1.30385160446167e-08
"6374",2017-07-08 03:26:21,168226.44,168226.440000013
"6375",2017-07-08 03:33:02,-168226.44,1.30385160446167e-08
"6376",2017-07-08 06:40:21,106027.29,106027.290000013
"6377",2017-07-08 06:44:46,-106027.29,1.30385160446167e-08
"6378",2017-07-08 06:44:46,145521.51,145521.510000013
"6379",2017-07-08 06:53:06,-145521.51,1.30385160446167e-08
"6380",2017-07-08 18:58:02,126339.18,126339.180000013
"6381",2017-07-08 19:09:37,-126339.18,1.30385160446167e-08
"6382",2017-07-09 05:11:24,17897.65,17897.650000013
"6383",2017-07-09 05:29:35,-17897.65,1.30385160446167e-08
"6384",2017-07-09 05:29:35,105144.14,105144.140000013
"6385",2017-07-09 05:32:54,-105144.14,1.30385160446167e-08
"6386",2017-07-09 06:10:02,162646.61,162646.610000013
"6387",2017-07-09 06:21:01,-162646.61,1.30385160446167e-08
"6388",2017-07-09 06:28:04,190560.83,190560.830000013
"6389",2017-07-09 06:49:25,-190560.83,1.30385160446167e-08
"6390",2017-07-09 07:00:17,173845.72,173845.720000013
"6391",2017-07-09 07:15:37,-173845.72,1.30385160446167e-08
"6392",2017-07-09 09:13:09,186744.44,186744.440000013
"6393",2017-07-09 09:19:45,-186744.44,1.30385160446167e-08
"6394",2017-07-09 09:58:18,162078.96,162078.960000013
"6395",2017-07-09 10:16:29,-162078.96,1.30385160446167e-08
"6396",2017-07-09 11:45:23,123488.71,123488.710000013
"6397",2017-07-09 11:48:40,-123488.71,1.30385160446167e-08
"6398",2017-07-09 11:53:26,22213.57,22213.570000013
"6399",2017-07-09 12:17:32,-22213.57,1.30385160446167e-08
"6400",2017-07-09 15:09:41,196692.11,196692.110000013
"6401",2017-07-09 15:17:24,-196692.11,1.30385160446167e-08
"6402",2017-07-09 15:55:21,235174.25,235174.250000013
"6403",2017-07-09 16:01:29,-235174.25,1.30385160446167e-08
"6404",2017-07-09 17:13:25,192476.95,192476.950000013
"6405",2017-07-09 17:43:09,-192476.95,1.30385160446167e-08
"6406",2017-07-09 18:47:27,254512.38,254512.380000013
"6407",2017-07-09 19:04:22,-254512.38,1.30385160446167e-08
"6408",2017-07-09 21:03:12,262820.54,262820.540000013
"6409",2017-07-09 21:09:16,-262820.54,1.30385160446167e-08
"6410",2017-07-09 21:49:13,252127.05,252127.050000013
"6411",2017-07-09 21:55:52,-252127.05,1.30385160446167e-08
"6412",2017-07-09 22:51:52,266959.38,266959.380000013
"6413",2017-07-09 22:58:48,-266959.38,1.30385160446167e-08
"6414",2017-07-10 00:06:19,302019.14,302019.140000013
"6415",2017-07-10 00:06:19,267768.32,569787.460000013
"6416",2017-07-10 00:11:28,-569787.46,1.30385160446167e-08
"6417",2017-07-10 00:43:01,288594.8,288594.800000013
"6418",2017-07-10 00:51:22,-288594.8,1.30385160446167e-08
"6419",2017-07-10 01:01:38,299082.07,299082.070000013
"6420",2017-07-10 01:06:52,-299082.07,1.30385160446167e-08
"6421",2017-07-10 01:20:13,244645.97,244645.970000013
"6422",2017-07-10 01:29:03,-244645.97,1.30385160446167e-08
"6423",2017-07-10 01:53:09,322630.87,322630.870000013
"6424",2017-07-10 01:56:29,-322630.87,1.30385160446167e-08
"6425",2017-07-10 02:33:26,249808.34,249808.340000013
"6426",2017-07-10 02:38:25,-249808.34,1.30385160446167e-08
"6427",2017-07-10 04:38:51,335784.36,335784.360000013
"6428",2017-07-10 05:02:16,278959.85,614744.210000013
"6429",2017-07-10 06:11:44,167919.18,782663.390000013
"6430",2017-07-10 07:45:27,242047.68,1024711.07000001
"6431",2017-07-10 11:51:43,256223.35,1280934.42000001
"6432",2017-07-10 12:09:25,325833.28,1606767.70000001
"6433",2017-07-10 12:38:04,345949.92,1952717.62000001
"6434",2017-07-10 12:38:04,221558.23,2174275.85000001
"6435",2017-07-10 15:11:40,1294439.45,3468715.30000001
"6436",2017-07-10 15:45:36,419903.72,3888619.02000001
"6437",2017-07-10 17:24:18,50076.29,3938695.31000001
"6438",2017-07-10 17:52:48,832210.98,4770906.29000001
"6439",2017-07-10 18:07:46,252287.82,5023194.11000001
"6440",2017-07-10 18:32:00,263453.68,5286647.79000001
"6441",2017-07-10 18:54:30,256101.42,5542749.21000001
"6442",2017-07-10 19:20:04,296786.72,5839535.93000001
"6443",2017-07-10 20:01:19,270061.3,6109597.23000001
"6444",2017-07-10 20:01:19,269540.54,6379137.77000001
"6445",2017-07-10 20:15:33,465256.94,6844394.71000001
"6446",2017-07-10 20:35:01,267709.46,7112104.17000001
"6447",2017-07-10 20:57:38,196421.56,7308525.73000001
"6448",2017-07-10 20:57:38,182025.64,7490551.37000001
"6449",2017-07-10 20:57:38,329939,7820490.37000001
"6450",2017-07-10 21:42:26,225623.92,8046114.29000001
"6451",2017-07-10 21:42:26,292284.06,8338398.35000001
"6452",2017-07-10 21:42:26,302135.21,8640533.56000001
"6453",2017-07-10 21:45:32,318880.33,8959413.89000001
"6454",2017-07-10 22:00:00,477937.32,9437351.21000001
"6455",2017-07-10 22:15:14,309903.79,9747255.00000001
"6456",2017-07-10 22:42:53,155457.25,9902712.25000001
"6457",2017-07-10 22:42:53,257885.13,10160597.38
"6458",2017-07-10 22:42:53,315602.67,10476200.05
"6459",2017-07-10 22:55:38,320734.37,10796934.42
"6460",2017-07-11 00:07:50,866987.64,11663922.06
"6461",2017-07-11 01:36:26,341983.55,12005905.61
"6462",2017-07-11 03:08:21,322090.32,12327995.93
"6463",2017-07-11 03:08:21,261312.44,12589308.37
"6464",2017-07-11 03:08:21,316340.31,12905648.68
"6465",2017-07-11 03:35:44,261802.85,13167451.53
"6466",2017-07-11 04:03:32,301488.52,13468940.05
"6467",2017-07-11 04:14:39,312635.57,13781575.62
"6468",2017-07-11 04:30:07,313757.43,14095333.05
"6469",2017-07-11 04:52:13,335715.44,14431048.49
"6470",2017-07-11 05:07:57,313512.03,14744560.52
"6471",2017-07-11 05:34:16,216271.58,14960832.1
"6472",2017-07-11 05:51:19,245842.78,15206674.88
"6473",2017-07-11 06:27:07,307750.59,15514425.47
"6474",2017-07-11 07:13:26,253591.62,15768017.09
"6475",2017-07-11 07:47:18,413093.57,16181110.66
"6476",2017-07-11 08:42:14,213032.01,16394142.67
"6477",2017-07-11 08:55:38,161861.35,16556004.02
"6478",2017-07-11 09:07:13,331457.13,16887461.15
"6479",2017-07-11 09:27:40,368800.39,17256261.54
"6480",2017-07-11 09:48:03,260971.11,17517232.65
"6481",2017-07-11 12:22:19,170657.22,17687889.87
"6482",2017-07-11 12:22:41,182139.72,17870029.59
"6483",2017-07-11 12:38:26,163806.87,18033836.46
"6484",2017-07-11 12:38:26,138297.16,18172133.62
"6485",2017-07-11 12:53:58,160665.32,18332798.94
"6486",2017-07-11 13:33:22,328740.77,18661539.71
"6487",2017-07-11 14:03:38,401205.4,19062745.11
"6488",2017-07-11 14:55:44,331658.95,19394404.06
"6489",2017-07-11 16:39:12,295898.19,19690302.25
"6490",2017-07-11 17:50:37,330299.33,20020601.58
"6491",2017-07-11 18:05:54,377494.74,20398096.32
"6492",2017-07-11 19:16:38,287917.62,20686013.94
"6493",2017-07-11 19:51:15,326492.14,21012506.08
"6494",2017-07-11 20:14:16,241456.7,21253962.78
"6495",2017-07-11 20:14:16,265353.14,21519315.92
"6496",2017-07-11 20:29:11,416294.78,21935610.7
"6497",2017-07-11 20:52:09,258034.53,22193645.23
"6498",2017-07-11 21:10:39,346435.08,22540080.31
"6499",2017-07-11 21:29:22,305908.7,22845989.01
"6500",2017-07-11 22:20:04,291310.78,23137299.79
"6501",2017-07-11 22:20:04,266136.55,23403436.34
"6502",2017-07-11 22:28:20,232134.97,23635571.31
"6503",2017-07-11 22:41:00,206125.76,23841697.07
"6504",2017-07-11 22:56:56,279530.74,24121227.81
"6505",2017-07-12 00:07:59,387964.55,24509192.36
"6506",2017-07-12 01:05:15,255128.14,24764320.5
"6507",2017-07-12 01:32:05,343351.4,25107671.9
"6508",2017-07-12 01:43:06,362983.93,25470655.83
"6509",2017-07-12 02:01:56,386079.72,25856735.55
"6510",2017-07-12 03:10:56,368039.99,26224775.54
"6511",2017-07-12 05:29:01,181963.12,26406738.66
"6512",2017-07-12 05:54:36,216288.76,26623027.42
"6513",2017-07-12 11:38:33,713371.89,27336399.31
"6514",2017-07-12 13:28:11,311151.94,27647551.25
"6515",2017-07-12 13:28:11,298130.58,27945681.83
"6516",2017-07-12 13:50:27,301045.48,28246727.31
"6517",2017-07-12 21:05:42,332796.64,28579523.95
"6518",2017-07-12 21:54:43,155630.27,28735154.22
"6519",2017-07-12 21:54:43,125769.45,28860923.67
"6520",2017-07-12 21:54:43,145118.64,29006042.31
"6521",2017-07-12 21:54:43,127201.93,29133244.24
"6522",2017-07-12 22:22:35,205735.71,29338979.95
"6523",2017-07-12 22:40:33,-29338979.95,7.45058059692383e-09
"6524",2017-07-13 00:30:52,306673.92,306673.920000007
"6525",2017-07-13 00:33:51,-306673.92,7.45058059692383e-09
"6526",2017-07-13 05:41:37,387886.35,387886.350000007
"6527",2017-07-13 05:41:37,377231.86,765118.210000007
"6528",2017-07-13 05:41:37,351213.47,1116331.68000001
"6529",2017-07-13 06:19:17,326170.32,1442502.00000001
"6530",2017-07-13 07:07:43,359058.22,1801560.22000001
"6531",2017-07-13 07:54:47,269430.06,2070990.28000001
"6532",2017-07-13 08:07:33,439056.05,2510046.33000001
"6533",2017-07-13 13:38:40,277536.29,2787582.62000001
"6534",2017-07-13 14:38:14,301620.5,3089203.12000001
"6535",2017-07-13 15:18:07,-3089203.12,7.45058059692383e-09
"6536",2017-07-13 15:18:07,240631.92,240631.920000007
"6537",2017-07-13 15:40:20,-240631.92,7.45058059692383e-09
"6538",2017-07-13 16:20:32,100081.87,100081.870000007
"6539",2017-07-13 16:33:23,-100081.87,7.45058059692383e-09
"6540",2017-07-13 16:50:43,50082.08,50082.0800000075
"6541",2017-07-13 17:09:32,-50082.08,7.45058059692383e-09
"6542",2017-07-13 17:09:32,100082.09,100082.090000007
"6543",2017-07-13 17:27:15,-100082.09,7.45058059692383e-09
"6544",2017-07-13 17:31:57,500082.11,500082.110000007
"6545",2017-07-13 17:50:53,-500082.11,7.45058059692383e-09
"6546",2017-07-13 18:18:02,500082.12,500082.120000007
"6547",2017-07-13 18:18:02,934176.82,1434258.94000001
"6548",2017-07-13 18:30:14,-1434258.94,7.45058059692383e-09
"6549",2017-07-13 18:46:52,357871.39,357871.390000007
"6550",2017-07-13 18:56:43,-357871.39,7.45058059692383e-09
"6551",2017-07-13 22:46:10,850863.01,850863.010000007
"6552",2017-07-13 22:49:58,-850863.01,7.45058059692383e-09
"6553",2017-07-13 23:28:14,170264.82,170264.820000007
"6554",2017-07-13 23:43:52,-170264.82,7.45058059692383e-09
"6555",2017-07-14 04:34:55,449465.19,449465.190000007
"6556",2017-07-14 07:05:42,433076.16,882541.350000007
"6557",2017-07-14 11:41:43,271191.18,1153732.53000001
"6558",2017-07-14 12:47:53,210035.72,1363768.25000001
"6559",2017-07-14 12:47:53,234963.21,1598731.46000001
"6560",2017-07-14 14:24:59,390496.7,1989228.16000001
"6561",2017-07-14 14:58:38,353048.22,2342276.38000001
"6562",2017-07-14 16:07:00,355454.08,2697730.46000001
"6563",2017-07-14 16:15:19,554958.73,3252689.19000001
"6564",2017-07-14 17:35:31,267633.28,3520322.47000001
"6565",2017-07-14 17:53:55,360638.32,3880960.79000001
"6566",2017-07-14 18:33:49,334421.66,4215382.45000001
"6567",2017-07-14 19:38:09,422600.21,4637982.66000001
"6568",2017-07-14 22:43:50,273324,4911306.66000001
"6569",2017-07-14 23:28:29,220630.27,5131936.93000001
"6570",2017-07-14 23:28:29,257754.64,5389691.57000001
"6571",2017-07-15 04:32:52,-5389691.57,5.58793544769287e-09
"6572",2017-07-15 12:31:46,323802.34,323802.340000006
"6573",2017-07-15 12:36:22,-323802.34,5.58793544769287e-09
"6574",2017-07-15 13:42:30,356403.74,356403.740000006
"6575",2017-07-15 13:57:51,-356403.74,5.58793544769287e-09
"6576",2017-07-15 14:24:42,205629.33,205629.330000006
"6577",2017-07-15 14:24:42,211374.65,417003.980000006
"6578",2017-07-15 14:26:58,-417003.98,5.58793544769287e-09
"6579",2017-07-15 14:26:58,244413.7,244413.700000006
"6580",2017-07-15 14:46:50,-244413.7,5.58793544769287e-09
"6581",2017-07-15 14:46:50,360459.76,360459.760000006
"6582",2017-07-15 14:46:50,285952.33,646412.090000006
"6583",2017-07-15 14:49:12,-646412.09,5.70435076951981e-09
"6584",2017-07-15 16:13:01,463227.8,463227.800000006
"6585",2017-07-15 16:13:01,309425.65,772653.450000006
"6586",2017-07-15 17:38:32,342877.59,1115531.04000001
"6587",2017-07-15 20:40:41,292076.18,1407607.22000001
"6588",2017-07-15 20:40:41,260376.41,1667983.63000001
"6589",2017-07-15 21:29:51,344130.32,2012113.95000001
"6590",2017-07-15 21:40:08,309517.35,2321631.30000001
"6591",2017-07-15 22:54:30,244643.66,2566274.96000001
"6592",2017-07-16 00:56:29,300102.79,2866377.75000001
"6593",2017-07-16 10:23:13,304736.07,3171113.82000001
"6594",2017-07-16 14:58:43,365202.8,3536316.62000001
"6595",2017-07-16 15:20:34,272985.49,3809302.11000001
"6596",2017-07-16 18:39:45,428231.27,4237533.38000001
"6597",2017-07-16 19:39:06,340182.43,4577715.81000001
"6598",2017-07-16 20:16:17,321812.53,4899528.34000001
"6599",2017-07-16 21:02:00,389765.98,5289294.32000001
"6600",2017-07-17 06:55:48,277830.3,5567124.62000001
"6601",2017-07-17 08:14:04,220031.12,5787155.74000001
"6602",2017-07-17 08:58:41,188409.17,5975564.91000001
"6603",2017-07-17 10:17:55,387188.81,6362753.72000001
"6604",2017-07-17 10:40:28,490595.68,6853349.40000001
"6605",2017-07-17 10:40:28,286533.23,7139882.63
"6606",2017-07-17 12:11:04,453894.43,7593777.06
"6607",2017-07-17 14:51:10,256620.05,7850397.11
"6608",2017-07-17 14:51:10,329516.39,8179913.5
"6609",2017-07-17 15:07:14,201976.69,8381890.19
"6610",2017-07-17 16:23:21,-8381890.19,3.72529029846191e-09
"6611",2017-07-17 17:55:00,394928.15,394928.150000004
"6612",2017-07-17 18:00:28,-394928.15,3.72529029846191e-09
"6613",2017-07-17 18:23:59,135156.07,135156.070000004
"6614",2017-07-17 18:23:59,184722.95,319879.020000004
"6615",2017-07-17 18:39:27,-319879.02,3.72529029846191e-09
"6616",2017-07-17 18:39:27,215647.63,215647.630000004
"6617",2017-07-17 18:45:07,-215647.63,3.72529029846191e-09
"6618",2017-07-17 19:07:31,169120.91,169120.910000004
"6619",2017-07-17 19:07:31,180868.63,349989.540000004
"6620",2017-07-17 19:14:03,-349989.54,3.78349795937538e-09
"6621",2017-07-17 22:47:25,171643.2,171643.200000004
"6622",2017-07-17 23:12:50,-171643.2,3.78349795937538e-09
"6623",2017-07-17 23:12:50,212325.94,212325.940000004
"6624",2017-07-17 23:27:20,-212325.94,3.78349795937538e-09
"6625",2017-07-18 02:48:53,77867.12,77867.1200000038
"6626",2017-07-18 02:52:18,-77867.12,3.78349795937538e-09
"6627",2017-07-18 03:32:04,77004.59,77004.5900000038
"6628",2017-07-18 03:32:04,777867.58,854872.170000004
"6629",2017-07-18 03:32:04,777867.57,1632739.74
"6630",2017-07-18 03:43:01,-1632739.74,3.72529029846191e-09
"6631",2017-07-18 05:52:46,278024.35,278024.350000004
"6632",2017-07-18 06:01:02,-278024.35,3.72529029846191e-09
"6633",2017-07-18 17:15:40,379488.77,379488.770000004
"6634",2017-07-18 17:57:36,512851.93,892340.700000004
"6635",2017-07-18 17:57:36,319320.41,1211661.11
"6636",2017-07-18 18:31:06,299881.9,1511543.01
"6637",2017-07-18 18:55:51,329845.81,1841388.82
"6638",2017-07-18 18:55:51,255715.46,2097104.28
"6639",2017-07-18 19:10:50,274806.61,2371910.89
"6640",2017-07-18 19:23:57,353130.23,2725041.12
"6641",2017-07-18 19:31:34,170162.89,2895204.01
"6642",2017-07-18 23:02:25,247376.56,3142580.57
"6643",2017-07-18 23:37:10,184926.7,3327507.27
"6644",2017-07-18 23:50:56,407739.71,3735246.98
"6645",2017-07-18 23:50:56,193296.66,3928543.64
"6646",2017-07-18 23:55:48,411223.54,4339767.18
"6647",2017-07-19 00:01:32,313220.95,4652988.13
"6648",2017-07-19 01:49:58,332125.7,4985113.83
"6649",2017-07-19 02:50:40,305572.4,5290686.23
"6650",2017-07-19 03:22:23,272382.54,5563068.77
"6651",2017-07-19 03:47:48,247077.92,5810146.69
"6652",2017-07-19 04:02:03,329361.77,6139508.46
"6653",2017-07-19 09:57:24,204109.08,6343617.54
"6654",2017-07-19 13:53:21,391996.04,6735613.58
"6655",2017-07-19 13:53:21,278376.89,7013990.47
"6656",2017-07-19 14:10:15,361256.75,7375247.22
"6657",2017-07-19 15:49:24,391167.67,7766414.89
"6658",2017-07-19 20:04:53,407072.27,8173487.16
"6659",2017-07-19 20:15:47,463631.97,8637119.13
"6660",2017-07-19 20:21:10,377273.88,9014393.01000001
"6661",2017-07-19 20:28:06,311522.03,9325915.04
"6662",2017-07-19 21:09:05,356278.06,9682193.10000001
"6663",2017-07-19 22:33:59,385471.29,10067664.39
"6664",2017-07-19 23:45:43,437218.1,10504882.49
"6665",2017-07-19 23:45:43,338583.93,10843466.42
"6666",2017-07-20 07:56:40,246239.37,11089705.79
"6667",2017-07-20 08:38:31,224963.86,11314669.65
"6668",2017-07-20 14:00:31,271769.37,11586439.02
"6669",2017-07-20 14:00:31,281392.98,11867832
"6670",2017-07-20 18:15:34,427049.27,12294881.27
"6671",2017-07-20 22:25:10,162049.13,12456930.4
"6672",2017-07-20 23:20:49,359732.24,12816662.64
"6673",2017-07-20 23:38:10,308766.18,13125428.82
"6674",2017-07-21 00:03:06,277136.89,13402565.71
"6675",2017-07-21 01:33:57,359954.69,13762520.4
"6676",2017-07-21 01:33:57,420719.02,14183239.42
"6677",2017-07-21 02:24:37,198939.19,14382178.61
"6678",2017-07-21 05:50:09,311948.09,14694126.7
"6679",2017-07-21 06:16:45,162883.58,14857010.28
"6680",2017-07-21 06:16:45,252329,15109339.28
"6681",2017-07-21 06:52:17,-15109339.28,1.86264514923096e-09
"6682",2017-07-21 11:53:13,160705.11,160705.110000002
"6683",2017-07-21 11:53:13,58212.91,218918.020000002
"6684",2017-07-21 12:37:51,173870.14,392788.160000002
"6685",2017-07-21 12:37:51,-218918.02,173870.140000002
"6686",2017-07-21 12:51:26,-173870.14,1.89174897968769e-09
"6687",2017-07-21 13:34:18,239272.99,239272.990000002
"6688",2017-07-21 13:45:09,-239272.99,1.89174897968769e-09
"6689",2017-07-21 14:36:57,170313.65,170313.650000002
"6690",2017-07-21 14:47:11,-170313.65,1.89174897968769e-09
"6691",2017-07-22 01:40:03,186769.9,186769.900000002
"6692",2017-07-22 01:45:36,-186769.9,1.89174897968769e-09
"6693",2017-07-22 02:42:22,293924.98,293924.980000002
"6694",2017-07-22 02:56:01,-293924.98,1.86264514923096e-09
"6695",2017-07-22 11:36:44,364226.12,364226.120000002
"6696",2017-07-22 11:36:44,483623.23,847849.350000002
"6697",2017-07-22 11:44:04,-847849.35,1.86264514923096e-09
"6698",2017-07-22 11:59:29,310084.27,310084.270000002
"6699",2017-07-22 12:06:34,-310084.27,1.86264514923096e-09
"6700",2017-07-22 22:02:12,273990.29,273990.290000002
"6701",2017-07-22 22:35:55,345290.27,619280.560000002
"6702",2017-07-23 07:23:56,464440.15,1083720.71
"6703",2017-07-23 08:40:29,376167.24,1459887.95
"6704",2017-07-23 12:46:30,276145.9,1736033.85
"6705",2017-07-23 13:07:28,269947.14,2005980.99
"6706",2017-07-23 13:25:50,370943.12,2376924.11
"6707",2017-07-23 14:06:51,236417.29,2613341.4
"6708",2017-07-23 14:29:18,297145.25,2910486.65
"6709",2017-07-23 14:59:21,280118.8,3190605.45
"6710",2017-07-24 11:59:22,306877.69,3497483.14
"6711",2017-07-25 07:21:21,492944.36,3990427.5
"6712",2017-07-25 07:41:40,466813.72,4457241.22
"6713",2017-07-25 08:07:57,526965.04,4984206.26
"6714",2017-07-25 08:07:57,380531.45,5364737.71
"6715",2017-07-25 08:58:20,456206.83,5820944.54
"6716",2017-07-25 08:58:20,435483.97,6256428.51
"6717",2017-07-25 11:05:56,520255.75,6776684.26
"6718",2017-07-25 11:33:51,514470.42,7291154.68
"6719",2017-07-25 11:44:33,748492.22,8039646.9
"6720",2017-07-25 12:00:33,537282.39,8576929.29
"6721",2017-07-25 12:42:58,557513.67,9134442.96
"6722",2017-07-25 12:54:03,658185.11,9792628.07
"6723",2017-07-25 13:31:21,390822.99,10183451.06
"6724",2017-07-25 13:54:47,473144.74,10656595.8
"6725",2017-07-25 16:26:00,386209.52,11042805.32
"6726",2017-07-25 16:47:41,480125.79,11522931.11
"6727",2017-07-25 19:31:31,562085.46,12085016.57
"6728",2017-07-25 19:44:30,593484.25,12678500.82
"6729",2017-07-25 20:06:24,433947.84,13112448.66
"6730",2017-07-25 20:06:24,445569.03,13558017.69
"6731",2017-07-25 20:25:36,482057.6,14040075.29
"6732",2017-07-25 20:39:23,368852.56,14408927.85
"6733",2017-07-25 20:58:05,538986.21,14947914.06
"6734",2017-07-25 20:58:05,378135.65,15326049.71
"6735",2017-07-25 21:12:08,449449.64,15775499.35
"6736",2017-07-25 23:30:20,255803.57,16031302.92
"6737",2017-07-26 06:18:30,411437.36,16442740.28
"6738",2017-07-26 07:08:57,358953.55,16801693.83
"6739",2017-07-26 17:51:24,345570.59,17147264.42
"6740",2017-07-26 23:16:41,383174.19,17530438.61
"6741",2017-07-27 00:20:40,390698.56,17921137.17
"6742",2017-07-27 01:02:25,235034.51,18156171.68
"6743",2017-07-27 02:00:41,212462.06,18368633.74
"6744",2017-07-27 09:00:58,201346.54,18569980.28
"6745",2017-07-27 09:32:29,248742.8,18818723.08
"6746",2017-07-27 09:50:18,316241.72,19134964.8
"6747",2017-07-27 10:44:14,222625.41,19357590.21
"6748",2017-07-27 10:46:19,218871.65,19576461.86
"6749",2017-07-27 14:57:52,423500.09,19999961.95
"6750",2017-07-27 21:10:52,275844.22,20275806.17
"6751",2017-07-27 22:04:43,266932.38,20542738.55
"6752",2017-07-28 17:39:10,-20542738.55,-7.45058059692383e-09
"6753",2017-07-29 11:31:50,153579.68,153579.679999993
"6754",2017-07-29 11:38:46,-153579.68,-7.45058059692383e-09
"6755",2017-07-29 12:06:45,107247.75,107247.749999993
"6756",2017-07-29 12:06:45,212627.77,319875.519999993
"6757",2017-07-29 12:06:45,125786.44,445661.959999993
"6758",2017-07-29 12:08:43,-445661.96,-7.45058059692383e-09
"6759",2017-07-29 17:28:34,263608.9,263608.899999993
"6760",2017-07-29 18:06:11,-263608.9,-7.45058059692383e-09
"6761",2017-07-29 18:55:36,178595.11,178595.109999993
"6762",2017-07-29 19:04:38,-178595.11,-7.45058059692383e-09
"6763",2017-07-29 19:04:38,272722.44,272722.439999993
"6764",2017-07-29 19:07:25,-272722.44,-7.45058059692383e-09
"6765",2017-07-29 19:28:54,219460.07,219460.069999993
"6766",2017-07-29 19:33:07,-219460.07,-7.45058059692383e-09
"6767",2017-07-29 20:17:13,380132.91,380132.909999993
"6768",2017-07-29 23:25:06,367343.33,747476.239999993
"6769",2017-07-29 23:37:24,412833.18,1160309.41999999
"6770",2017-07-29 23:48:40,438719.66,1599029.07999999
"6771",2017-07-30 17:29:18,121994.54,1721023.61999999
"6772",2017-07-30 19:24:50,181031.55,1902055.16999999
"6773",2017-07-31 05:31:03,220801.95,2122857.11999999
"6774",2017-08-01 04:29:28,221074.58,2343931.69999999
"6775",2017-08-01 04:29:28,199268.23,2543199.92999999
"6776",2017-08-01 08:17:28,352286.95,2895486.87999999
"6777",2017-08-01 10:08:40,343194.41,3238681.28999999
"6778",2017-08-01 10:16:16,339747.02,3578428.30999999
"6779",2017-08-01 12:37:28,393830.7,3972259.00999999
"6780",2017-08-01 15:04:43,91786.15,4064045.15999999
"6781",2017-08-02 05:34:28,-4064045.16,-6.98491930961609e-09
"6782",2017-08-03 09:47:04,266267.33,266267.329999993
"6783",2017-08-03 21:09:00,376640.11,642907.439999993
"6784",2017-08-04 02:26:49,239763.24,882670.679999993
"6785",2017-08-05 02:35:43,415818.42,1298489.09999999
"6786",2017-08-05 04:03:47,432970.32,1731459.41999999
"6787",2017-08-05 04:03:47,291378.12,2022837.53999999
"6788",2017-08-05 04:03:47,155842.56,2178680.09999999
"6789",2017-08-05 04:03:47,336516.46,2515196.55999999
"6790",2017-08-05 04:03:47,235998.89,2751195.44999999
"6791",2017-08-05 04:35:29,462935.33,3214130.77999999
"6792",2017-08-05 04:35:29,627184.65,3841315.42999999
"6793",2017-08-05 06:32:36,498115.34,4339430.76999999
"6794",2017-08-05 06:32:36,287456.3,4626887.06999999
"6795",2017-08-05 06:32:36,270079.06,4896966.12999999
"6796",2017-08-05 06:32:36,486539.25,5383505.37999999
"6797",2017-08-05 09:11:17,366570.02,5750075.39999999
"6798",2017-08-05 13:31:26,273944.03,6024019.42999999
"6799",2017-08-05 15:02:26,568101.3,6592120.72999999
"6800",2017-08-05 16:55:17,448745.1,7040865.82999999
"6801",2017-08-05 16:55:17,457641.92,7498507.74999999
"6802",2017-08-06 01:36:45,591123.27,8089631.01999999
"6803",2017-08-06 02:14:13,322370.8,8412001.81999999
"6804",2017-08-06 08:00:09,138852.23,8550854.04999999
"6805",2017-08-06 08:18:34,12775.78,8563629.82999999
"6806",2017-08-06 08:27:21,139102.77,8702732.59999999
"6807",2017-08-06 08:27:21,424111.35,9126843.94999999
"6808",2017-08-06 09:26:09,394813.37,9521657.31999999
"6809",2017-08-06 10:34:34,344833.45,9866490.76999999
"6810",2017-08-06 18:23:46,311334.76,10177825.53
"6811",2017-08-06 19:40:49,239129.12,10416954.65
"6812",2017-08-06 19:40:49,231374.76,10648329.41
"6813",2017-08-06 19:44:27,315636.8,10963966.21
"6814",2017-08-06 20:17:13,270048.92,11234015.13
"6815",2017-08-06 20:33:02,263004.98,11497020.11
"6816",2017-08-06 21:01:10,265305.7,11762325.81
"6817",2017-08-07 04:07:07,371104.39,12133430.2
"6818",2017-08-07 11:24:34,462268.64,12595698.84
"6819",2017-08-07 11:35:10,496162.18,13091861.02
"6820",2017-08-07 11:36:13,478820.05,13570681.07
"6821",2017-08-07 12:33:43,402707.27,13973388.34
"6822",2017-08-07 23:21:11,-13973388.34,-9.31322574615479e-09
"6823",2017-08-08 08:17:20,199410.61,199410.609999991
"6824",2017-08-08 08:21:44,-199410.61,-9.31322574615479e-09
"6825",2017-08-08 08:32:54,128236.53,128236.529999991
"6826",2017-08-08 08:45:42,-128236.53,-9.31322574615479e-09
"6827",2017-08-08 08:58:19,288401.54,288401.539999991
"6828",2017-08-08 09:03:23,-288401.54,-9.31322574615479e-09
"6829",2017-08-08 09:06:37,317776.79,317776.789999991
"6830",2017-08-08 09:11:17,-317776.79,-9.31322574615479e-09
"6831",2017-08-08 09:11:17,328466.34,328466.339999991
"6832",2017-08-08 09:20:51,-328466.34,-9.31322574615479e-09
"6833",2017-08-08 19:05:58,160213.74,160213.739999991
"6834",2017-08-08 19:39:33,-160213.74,-9.31322574615479e-09
"6835",2017-08-08 19:39:33,158359.27,158359.269999991
"6836",2017-08-08 19:46:03,-158359.27,-9.31322574615479e-09
"6837",2017-08-08 20:10:42,243307.31,243307.309999991
"6838",2017-08-08 20:21:41,-243307.31,-9.31322574615479e-09
"6839",2017-08-08 20:21:41,242337.69,242337.689999991
"6840",2017-08-08 20:24:50,-242337.69,-9.31322574615479e-09
"6841",2017-08-08 20:36:41,202486.67,202486.669999991
"6842",2017-08-08 20:53:53,-202486.67,-9.31322574615479e-09
"6843",2017-08-08 21:22:13,221474.64,221474.639999991
"6844",2017-08-08 21:36:51,-221474.64,-9.31322574615479e-09
"6845",2017-08-08 21:36:51,169182.02,169182.019999991
"6846",2017-08-08 21:55:37,-169182.02,-9.31322574615479e-09
"6847",2017-08-08 21:55:37,143166.85,143166.849999991
"6848",2017-08-08 22:20:12,-143166.85,-9.31322574615479e-09
"6849",2017-08-08 22:20:12,164705.24,164705.239999991
"6850",2017-08-08 22:59:29,-164705.24,-9.31322574615479e-09
"6851",2017-08-08 23:13:40,166996.57,166996.569999991
"6852",2017-08-08 23:26:18,-166996.57,-9.31322574615479e-09
"6853",2017-08-09 00:01:19,217609.18,217609.179999991
"6854",2017-08-09 00:15:31,-217609.18,-9.31322574615479e-09
"6855",2017-08-09 00:52:31,278228.14,278228.139999991
"6856",2017-08-09 01:20:16,-278228.14,-9.31322574615479e-09
"6857",2017-08-09 05:42:22,184838.33,184838.329999991
"6858",2017-08-09 06:17:49,198637.61,383475.939999991
"6859",2017-08-09 07:58:41,131791.16,515267.099999991
"6860",2017-08-09 08:07:14,117749.67,633016.769999991
"6861",2017-08-09 08:23:01,115225.56,748242.329999991
"6862",2017-08-09 08:38:40,145427.39,893669.719999991
"6863",2017-08-09 09:49:47,48145.58,941815.299999991
"6864",2017-08-09 09:49:47,111521.59,1053336.88999999
"6865",2017-08-09 10:24:47,260780.72,1314117.60999999
"6866",2017-08-09 10:24:47,206629.26,1520746.86999999
"6867",2017-08-09 10:45:56,232372.44,1753119.30999999
"6868",2017-08-09 10:55:57,342981.42,2096100.72999999
"6869",2017-08-09 11:10:21,437356,2533456.72999999
"6870",2017-08-09 11:53:48,142642.14,2676098.86999999
"6871",2017-08-09 12:06:00,180951.21,2857050.07999999
"6872",2017-08-09 12:06:00,174024.64,3031074.71999999
"6873",2017-08-09 13:08:34,182130.55,3213205.26999999
"6874",2017-08-09 14:10:43,459546.82,3672752.08999999
"6875",2017-08-09 14:51:31,55171.21,3727923.29999999
"6876",2017-08-09 15:17:14,387539.58,4115462.87999999
"6877",2017-08-09 15:17:14,263911.3,4379374.17999999
"6878",2017-08-09 15:48:42,30598.35,4409972.52999999
"6879",2017-08-09 15:48:42,156901.2,4566873.72999999
"6880",2017-08-09 18:16:54,131758.53,4698632.25999999
"6881",2017-08-09 21:16:46,155316.1,4853948.35999999
"6882",2017-08-10 08:14:53,243410.52,5097358.87999999
"6883",2017-08-11 00:38:29,-5097358.88,-1.02445483207703e-08
"6884",2017-08-11 05:54:13,254319.82,254319.81999999
"6885",2017-08-11 05:54:13,266719.18,521038.99999999
"6886",2017-08-11 05:58:33,-521039,-1.02445483207703e-08
"6887",2017-08-11 22:48:32,229283.9,229283.89999999
"6888",2017-08-11 23:08:56,17845.13,247129.02999999
"6889",2017-08-11 23:08:56,138793.63,385922.65999999
"6890",2017-08-11 23:08:56,256650.6,642573.25999999
"6891",2017-08-11 23:08:56,122090.75,764664.00999999
"6892",2017-08-11 23:08:56,157764.13,922428.13999999
"6893",2017-08-11 23:08:56,223558.24,1145986.37999999
"6894",2017-08-12 00:25:36,120883.14,1266869.51999999
"6895",2017-08-12 00:38:53,246391.93,1513261.44999999
"6896",2017-08-12 00:49:49,344702.99,1857964.43999999
"6897",2017-08-12 07:20:29,9483.88,1867448.31999999
"6898",2017-08-12 07:20:29,89208.48,1956656.79999999
"6899",2017-08-12 07:35:02,242624.71,2199281.50999999
"6900",2017-08-12 08:47:24,70110.36,2269391.86999999
"6901",2017-08-12 11:01:37,182593.4,2451985.26999999
"6902",2017-08-12 13:51:58,226797.04,2678782.30999999
"6903",2017-08-12 14:53:07,79975.53,2758757.83999999
"6904",2017-08-12 14:53:07,177888.08,2936645.91999999
"6905",2017-08-12 14:53:07,160016.24,3096662.15999999
"6906",2017-08-12 14:53:07,277141.58,3373803.73999999
"6907",2017-08-12 14:53:07,250758.84,3624562.57999999
"6908",2017-08-12 16:54:50,320563.6,3945126.17999999
"6909",2017-08-12 18:17:46,570601.43,4515727.60999999
"6910",2017-08-12 18:38:14,315133.97,4830861.57999999
"6911",2017-08-12 19:00:19,235243.29,5066104.86999999
"6912",2017-08-12 19:29:18,279673.19,5345778.05999999
"6913",2017-08-12 21:13:54,250523.21,5596301.26999999
"6914",2017-08-12 22:00:48,360553.27,5956854.53999999
"6915",2017-08-13 00:34:36,193147.6,6150002.13999999
"6916",2017-08-13 00:34:36,183197.25,6333199.38999999
"6917",2017-08-13 00:44:31,136731.94,6469931.32999999
"6918",2017-08-13 01:10:27,315936.87,6785868.19999999
"6919",2017-08-13 01:55:11,160805.52,6946673.71999999
"6920",2017-08-13 02:11:50,42069.11,6988742.82999999
"6921",2017-08-13 05:19:58,158578.59,7147321.41999999
"6922",2017-08-13 07:09:18,288739.74,7436061.15999999
"6923",2017-08-13 08:39:24,-7436061.16,-1.02445483207703e-08
"6924",2017-08-13 08:39:24,472733.48,472733.47999999
"6925",2017-08-13 08:52:58,-472733.48,-1.02445483207703e-08
"6926",2017-08-13 10:19:30,171472.15,171472.14999999
"6927",2017-08-13 10:19:30,137359.42,308831.56999999
"6928",2017-08-13 10:19:30,139700.07,448531.63999999
"6929",2017-08-13 10:19:30,157360.73,605892.36999999
"6930",2017-08-13 10:25:25,-605892.37,-1.02445483207703e-08
"6931",2017-08-13 10:25:25,134170.56,134170.55999999
"6932",2017-08-13 10:39:02,-134170.56,-1.02445483207703e-08
"6933",2017-08-13 10:39:02,481977.09,481977.08999999
"6934",2017-08-13 10:39:02,249925.49,731902.57999999
"6935",2017-08-13 10:47:21,-731902.58,-1.01281329989433e-08
"6936",2017-08-13 11:28:45,329958.94,329958.93999999
"6937",2017-08-13 11:28:45,219368.53,549327.46999999
"6938",2017-08-13 11:42:37,-549327.47,-1.01281329989433e-08
"6939",2017-08-13 12:26:18,332329.09,332329.08999999
"6940",2017-08-13 12:34:49,-332329.09,-1.01281329989433e-08
"6941",2017-08-13 16:51:38,141781.34,141781.33999999
"6942",2017-08-13 16:51:38,139319.4,281100.73999999
"6943",2017-08-13 17:03:30,-281100.74,-1.01281329989433e-08
"6944",2017-08-13 18:55:30,132772.49,132772.48999999
"6945",2017-08-13 18:58:20,-132772.49,-1.01281329989433e-08
"6946",2017-08-13 19:03:02,203727.93,203727.92999999
"6947",2017-08-13 19:09:28,-203727.93,-1.01281329989433e-08
"6948",2017-08-13 20:15:48,372664.41,372664.40999999
"6949",2017-08-13 20:29:47,-372664.41,-1.01281329989433e-08
"6950",2017-08-13 21:37:12,383497.41,383497.40999999
"6951",2017-08-13 21:37:12,156265.18,539762.58999999
"6952",2017-08-13 21:41:40,-539762.59,-1.01281329989433e-08
"6953",2017-08-13 22:01:34,215748.82,215748.81999999
"6954",2017-08-13 22:01:34,356700.75,572449.56999999
"6955",2017-08-13 22:11:07,-572449.57,-1.01281329989433e-08
"6956",2017-08-13 22:14:57,323327.14,323327.13999999
"6957",2017-08-13 22:39:35,-323327.14,-1.01281329989433e-08
"6958",2017-08-13 22:56:44,369629.89,369629.88999999
"6959",2017-08-13 23:34:23,-369629.89,-1.01281329989433e-08
"6960",2017-08-13 23:34:23,273693.82,273693.81999999
"6961",2017-08-13 23:40:58,-273693.82,-1.01281329989433e-08
"6962",2017-08-14 00:02:31,220032.65,220032.64999999
"6963",2017-08-14 00:14:50,-220032.65,-1.01281329989433e-08
"6964",2017-08-14 21:18:56,29164.51,29164.5099999899
"6965",2017-08-14 22:12:13,97555.87,126720.37999999
"6966",2017-08-14 22:56:17,122633.11,249353.48999999
"6967",2017-08-14 23:03:08,132271.72,381625.20999999
"6968",2017-08-14 23:57:04,10889.73,392514.93999999
"6969",2017-08-14 23:57:04,136454.03,528968.96999999
"6970",2017-08-14 23:57:04,95980.04,624949.00999999
"6971",2017-08-15 00:25:02,151935.34,776884.34999999
"6972",2017-08-15 00:49:19,155285.08,932169.42999999
"6973",2017-08-15 02:45:28,251863.53,1184032.95999999
"6974",2017-08-15 08:59:39,206002.29,1390035.24999999
"6975",2017-08-15 09:24:06,210625.3,1600660.54999999
"6976",2017-08-15 09:53:58,111365.22,1712025.76999999
"6977",2017-08-15 10:04:59,70403.1,1782428.86999999
"6978",2017-08-15 10:07:08,154197.64,1936626.50999999
"6979",2017-08-15 10:09:57,258487.16,2195113.66999999
"6980",2017-08-15 10:33:16,10903.25,2206016.91999999
"6981",2017-08-15 10:33:16,237922.16,2443939.07999999
"6982",2017-08-15 12:44:20,236741.97,2680681.04999999
"6983",2017-08-15 12:44:20,391366.3,3072047.34999999
"6984",2017-08-15 12:44:20,191542.45,3263589.79999999
"6985",2017-08-15 13:14:08,50113.28,3313703.07999999
"6986",2017-08-15 13:29:14,201128.75,3514831.82999999
"6987",2017-08-15 13:29:14,182382.7,3697214.52999999
"6988",2017-08-15 13:29:14,217381.95,3914596.47999999
"6989",2017-08-15 14:16:35,173977.65,4088574.12999999
"6990",2017-08-15 14:19:33,116844.75,4205418.87999999
"6991",2017-08-15 14:24:53,22828.73,4228247.60999999
"6992",2017-08-15 14:41:45,62273.99,4290521.59999999
"6993",2017-08-15 15:07:57,383104.09,4673625.68999999
"6994",2017-08-15 15:07:57,285635.92,4959261.60999999
"6995",2017-08-15 15:07:57,116593.26,5075854.86999999
"6996",2017-08-15 15:07:57,267180.09,5343034.95999999
"6997",2017-08-15 15:23:52,255194.26,5598229.21999999
"6998",2017-08-15 16:12:53,208505.13,5806734.34999999
"6999",2017-08-15 17:55:56,231579.49,6038313.83999999
"7000",2017-08-15 18:12:50,200810.25,6239124.08999999
"7001",2017-08-15 18:58:51,184610.37,6423734.45999999
"7002",2017-08-15 19:33:21,112340.09,6536074.54999999
"7003",2017-08-15 20:04:04,152487.66,6688562.20999999
"7004",2017-08-15 20:33:02,273563.75,6962125.95999999
"7005",2017-08-15 21:00:30,121704.78,7083830.73999999
"7006",2017-08-15 21:00:30,119342.34,7203173.07999999
"7007",2017-08-15 21:40:17,122041.53,7325214.60999999
"7008",2017-08-15 21:40:17,198753.07,7523967.67999999
"7009",2017-08-15 21:40:17,116590.88,7640558.55999999
"7010",2017-08-15 21:47:42,130726.64,7771285.19999999
"7011",2017-08-15 21:59:56,140298.46,7911583.65999999
"7012",2017-08-15 21:59:56,116429.14,8028012.79999999
"7013",2017-08-15 23:24:36,257690.14,8285702.93999999
"7014",2017-08-16 00:28:12,147617.52,8433320.45999999
"7015",2017-08-16 00:28:12,136384.97,8569705.42999999
"7016",2017-08-16 00:42:00,126593.26,8696298.68999999
"7017",2017-08-16 04:56:40,248060.55,8944359.23999999
"7018",2017-08-16 07:15:39,252353.92,9196713.15999999
"7019",2017-08-16 08:15:22,222236.53,9418949.68999999
"7020",2017-08-16 08:15:22,228788.31,9647737.99999999
"7021",2017-08-16 08:15:22,116093.74,9763831.73999999
"7022",2017-08-16 08:15:22,187947.92,9951779.65999999
"7023",2017-08-16 08:52:54,144224.17,10096003.83
"7024",2017-08-16 09:30:56,104649.2,10200653.03
"7025",2017-08-16 09:30:56,204862.38,10405515.41
"7026",2017-08-16 09:30:56,236995.93,10642511.34
"7027",2017-08-16 09:30:56,127767.9,10770279.24
"7028",2017-08-16 09:59:19,216897.53,10987176.77
"7029",2017-08-16 11:01:19,184736.93,11171913.7
"7030",2017-08-16 15:38:09,183731.68,11355645.38
"7031",2017-08-16 15:50:03,298766.65,11654412.03
"7032",2017-08-16 16:03:08,170199.7,11824611.73
"7033",2017-08-16 16:12:10,113384.75,11937996.48
"7034",2017-08-16 16:24:15,167118.47,12105114.95
"7035",2017-08-16 17:24:47,284573.74,12389688.69
"7036",2017-08-16 18:50:47,233835.55,12623524.24
"7037",2017-08-16 20:08:57,140521.52,12764045.76
"7038",2017-08-16 21:09:56,141344.64,12905390.4
"7039",2017-08-16 21:28:00,173657.18,13079047.58
"7040",2017-08-16 23:30:55,195241.58,13274289.16
"7041",2017-08-16 23:34:29,126427.85,13400717.01
"7042",2017-08-16 23:46:02,15230.04,13415947.05
"7043",2017-08-16 23:46:02,330991.18,13746938.23
"7044",2017-08-17 00:27:32,500371.13,14247309.36
"7045",2017-08-17 00:48:58,140160.83,14387470.19
"7046",2017-08-17 07:49:11,155980.05,14543450.24
"7047",2017-08-17 07:49:11,154760.31,14698210.55
"7048",2017-08-17 07:49:11,145143.23,14843353.78
"7049",2017-08-17 07:51:53,162819.56,15006173.34
"7050",2017-08-17 08:01:39,367638.27,15373811.61
"7051",2017-08-17 08:01:39,125855.38,15499666.99
"7052",2017-08-17 08:22:18,289588.85,15789255.84
"7053",2017-08-17 08:33:11,264151.89,16053407.73
"7054",2017-08-17 09:27:43,162198.35,16215606.08
"7055",2017-08-17 09:27:43,331971,16547577.08
"7056",2017-08-17 09:27:43,329256.95,16876834.03
"7057",2017-08-17 09:42:28,482324.93,17359158.96
"7058",2017-08-17 09:53:14,397545.56,17756704.52
"7059",2017-08-17 10:06:13,436853.37,18193557.89
"7060",2017-08-17 20:18:56,8980.62,18202538.51
"7061",2017-08-17 20:18:56,-18193557.89,8980.61999999359
"7062",2017-08-17 20:30:05,-8980.62,-6.40829966869205e-09
"7063",2017-08-17 20:58:51,72506.19,72506.1899999936
"7064",2017-08-17 22:49:51,39987.83,112494.019999994
"7065",2017-08-17 23:04:13,5839.94,118333.959999994
"7066",2017-08-17 23:04:13,34724.47,153058.429999994
"7067",2017-08-17 23:14:45,-153058.43,-6.40284270048141e-09
"7068",2017-08-17 23:48:00,86060.64,86060.6399999936
"7069",2017-08-17 23:52:48,79646.01,165706.649999994
"7070",2017-08-17 23:54:58,-165706.65,-6.40284270048141e-09
"7071",2017-08-18 00:47:55,24880.48,24880.4799999936
"7072",2017-08-18 01:09:52,-24880.48,-6.40284270048141e-09
"7073",2017-08-18 01:21:33,86878.31,86878.3099999936
"7074",2017-08-18 02:03:20,-86878.31,-6.40284270048141e-09
"7075",2017-08-18 02:03:20,185411.05,185411.049999994
"7076",2017-08-18 02:03:20,105422.77,290833.819999994
"7077",2017-08-18 02:03:20,101673.65,392507.469999994
"7078",2017-08-18 02:06:44,-392507.47,-6.40284270048141e-09
"7079",2017-08-18 02:16:58,76341.8,76341.7999999936
"7080",2017-08-18 02:26:01,-76341.8,-6.40284270048141e-09
"7081",2017-08-18 02:51:57,11861.74,11861.7399999936
"7082",2017-08-18 03:18:36,-11861.74,-6.40284270048141e-09
"7083",2017-08-18 03:29:02,89196.64,89196.6399999936
"7084",2017-08-18 03:58:42,-89196.64,-6.40284270048141e-09
"7085",2017-08-18 06:14:26,29761.17,29761.1699999936
"7086",2017-08-18 07:55:31,139039.12,168800.289999994
"7087",2017-08-18 08:26:40,54102.24,222902.529999994
"7088",2017-08-18 08:26:40,47770.94,270673.469999994
"7089",2017-08-18 08:31:46,92791.14,363464.609999994
"7090",2017-08-18 09:55:31,72109.45,435574.059999994
"7091",2017-08-18 10:16:16,149058.58,584632.639999994
"7092",2017-08-18 10:28:24,58685.19,643317.829999994
"7093",2017-08-18 10:31:00,121610.23,764928.059999994
"7094",2017-08-18 16:42:59,141665.43,906593.489999993
"7095",2017-08-18 16:55:37,197332.81,1103926.29999999
"7096",2017-08-18 18:02:25,115942.87,1219869.16999999
"7097",2017-08-18 18:02:25,60005.88,1279875.04999999
"7098",2017-08-18 18:02:25,200984.86,1480859.90999999
"7099",2017-08-18 18:09:51,73898.66,1554758.56999999
"7100",2017-08-18 18:19:32,75007.26,1629765.82999999
"7101",2017-08-18 18:19:32,58287.43,1688053.25999999
"7102",2017-08-18 18:19:32,114501.11,1802554.36999999
"7103",2017-08-18 18:34:10,112625.75,1915180.11999999
"7104",2017-08-18 18:34:10,112882.09,2028062.20999999
"7105",2017-08-18 19:13:25,55265.8,2083328.00999999
"7106",2017-08-18 19:21:00,268371.77,2351699.77999999
"7107",2017-08-18 20:53:52,130869.97,2482569.74999999
"7108",2017-08-18 21:23:00,190262.13,2672831.87999999
"7109",2017-08-18 22:50:38,308430.56,2981262.43999999
"7110",2017-08-18 23:02:40,107968.59,3089231.02999999
"7111",2017-08-18 23:22:50,115652.85,3204883.87999999
"7112",2017-08-18 23:45:41,125853.54,3330737.41999999
"7113",2017-08-19 00:01:06,106736.17,3437473.58999999
"7114",2017-08-19 00:45:06,105767.75,3543241.33999999
"7115",2017-08-19 00:45:06,97463.93,3640705.26999999
"7116",2017-08-19 01:06:50,105679.06,3746384.32999999
"7117",2017-08-19 01:18:21,144144.51,3890528.83999999
"7118",2017-08-19 02:22:07,115232.65,4005761.48999999
"7119",2017-08-19 03:54:39,186396.88,4192158.36999999
"7120",2017-08-19 04:27:40,148071.69,4340230.05999999
"7121",2017-08-19 06:06:11,-4340230.06,-6.51925802230835e-09
"7122",2017-08-19 07:34:05,266991.81,266991.809999993
"7123",2017-08-19 07:38:06,-266991.81,-6.51925802230835e-09
"7124",2017-08-19 07:49:41,221400.25,221400.249999993
"7125",2017-08-19 07:49:41,167815.88,389216.129999993
"7126",2017-08-19 08:00:54,-389216.13,-6.51925802230835e-09
"7127",2017-08-19 08:38:55,275211.98,275211.979999993
"7128",2017-08-19 09:00:18,-275211.98,-6.51925802230835e-09
"7129",2017-08-19 09:58:44,233373,233372.999999993
"7130",2017-08-19 10:09:40,-233373,-6.51925802230835e-09
"7131",2017-08-19 10:39:59,223943.58,223943.579999993
"7132",2017-08-19 11:02:30,-223943.58,-6.51925802230835e-09
"7133",2017-08-19 11:02:30,129419.21,129419.209999993
"7134",2017-08-19 11:15:20,-129419.21,-6.51925802230835e-09
"7135",2017-08-19 11:48:36,15076.04,15076.0399999935
"7136",2017-08-19 12:00:29,-15076.04,-6.51925802230835e-09
"7137",2017-08-19 12:53:03,215019.29,215019.289999993
"7138",2017-08-19 13:08:57,-215019.29,-6.51925802230835e-09
"7139",2017-08-19 13:08:57,300118.01,300118.009999993
"7140",2017-08-19 13:24:00,-300118.01,-6.51925802230835e-09
"7141",2017-08-19 13:49:17,316943.14,316943.139999993
"7142",2017-08-19 14:21:20,-316943.14,-6.51925802230835e-09
"7143",2017-08-19 14:39:05,221098.34,221098.339999993
"7144",2017-08-19 14:52:01,-221098.34,-6.51925802230835e-09
"7145",2017-08-19 14:52:01,416467.31,416467.309999993
"7146",2017-08-19 15:07:54,-416467.31,-6.51925802230835e-09
"7147",2017-08-19 15:07:54,402276.93,402276.929999993
"7148",2017-08-19 15:21:49,-402276.93,-6.51925802230835e-09
"7149",2017-08-19 16:01:18,260907.45,260907.449999993
"7150",2017-08-19 16:26:34,-260907.45,-6.51925802230835e-09
"7151",2017-08-19 16:56:23,304931.29,304931.289999993
"7152",2017-08-19 17:00:15,-304931.29,-6.51925802230835e-09
"7153",2017-08-19 17:00:15,350812.32,350812.319999993
"7154",2017-08-19 17:08:04,-350812.32,-6.51925802230835e-09
"7155",2017-08-19 17:21:02,298972.01,298972.009999993
"7156",2017-08-19 17:33:06,-298972.01,-6.51925802230835e-09
"7157",2017-08-19 17:33:06,317564.83,317564.829999993
"7158",2017-08-19 17:38:40,-317564.83,-6.51925802230835e-09
"7159",2017-08-19 18:27:00,254975.42,254975.419999993
"7160",2017-08-19 18:27:00,250903.18,505878.599999993
"7161",2017-08-19 18:31:07,-505878.6,-6.51925802230835e-09
"7162",2017-08-19 18:49:59,225804.02,225804.019999993
"7163",2017-08-19 19:02:19,-225804.02,-6.51925802230835e-09
"7164",2017-08-19 19:02:19,199583.23,199583.229999993
"7165",2017-08-19 19:13:48,-199583.23,-6.51925802230835e-09
"7166",2017-08-19 21:34:34,263075.2,263075.199999993
"7167",2017-08-19 21:34:34,300118.5,563193.699999993
"7168",2017-08-19 22:07:02,-563193.7,-6.51925802230835e-09
"7169",2017-08-20 00:17:25,575081.83,575081.829999993
"7170",2017-08-20 00:22:02,347580.11,922661.939999993
"7171",2017-08-20 00:31:16,24969.98,947631.919999993
"7172",2017-08-20 01:55:42,290146.22,1237778.13999999
"7173",2017-08-20 02:36:57,229079.63,1466857.76999999
"7174",2017-08-20 03:09:21,228798.67,1695656.43999999
"7175",2017-08-20 04:49:15,172044.06,1867700.49999999
"7176",2017-08-20 08:46:37,466281.06,2333981.55999999
"7177",2017-08-20 08:46:37,512462.52,2846444.07999999
"7178",2017-08-20 16:54:06,258991.07,3105435.14999999
"7179",2017-08-20 17:48:17,324861.97,3430297.11999999
"7180",2017-08-20 20:33:51,479098.96,3909396.07999999
"7181",2017-08-20 20:43:06,332526.19,4241922.26999999
"7182",2017-08-21 11:09:33,306401.04,4548323.30999999
"7183",2017-08-21 12:26:15,330545.44,4878868.74999999
"7184",2017-08-21 13:10:16,602894.15,5481762.89999999
"7185",2017-08-21 20:15:48,576045.14,6057808.03999999
"7186",2017-08-21 23:29:00,106114.64,6163922.67999999
"7187",2017-08-21 23:29:00,177895.32,6341817.99999999
"7188",2017-08-21 23:29:00,157489.02,6499307.01999999
"7189",2017-08-21 23:29:00,287632.33,6786939.34999999
"7190",2017-08-21 23:29:00,112041.34,6898980.68999999
"7191",2017-08-22 02:09:50,-6898980.69,-6.51925802230835e-09
"7192",2017-08-22 02:40:06,447665.82,447665.819999993
"7193",2017-08-22 02:54:44,-447665.82,-6.51925802230835e-09
"7194",2017-08-22 04:55:54,411733.42,411733.419999993
"7195",2017-08-22 05:04:46,-411733.42,-6.51925802230835e-09
"7196",2017-08-22 05:46:12,283948.19,283948.189999993
"7197",2017-08-22 06:22:03,-283948.19,-6.51925802230835e-09
"7198",2017-08-22 06:43:00,154905.89,154905.889999993
"7199",2017-08-22 07:00:31,-154905.89,-6.51925802230835e-09
"7200",2017-08-22 07:32:01,194973.97,194973.969999993
"7201",2017-08-22 07:32:01,181681.15,376655.119999993
"7202",2017-08-22 07:45:04,-376655.12,-6.51925802230835e-09
"7203",2017-08-22 10:17:40,157450.04,157450.039999993
"7204",2017-08-22 10:22:20,-157450.04,-6.51925802230835e-09
"7205",2017-08-22 10:22:20,300120.57,300120.569999993
"7206",2017-08-22 10:45:18,-300120.57,-6.51925802230835e-09
"7207",2017-08-22 10:45:18,188456.93,188456.929999993
"7208",2017-08-22 10:55:44,-188456.93,-6.51925802230835e-09
"7209",2017-08-22 18:50:52,200120.65,200120.649999993
"7210",2017-08-22 19:18:11,150120.69,350241.339999993
"7211",2017-08-22 19:18:11,-200120.65,150120.689999993
"7212",2017-08-22 20:00:35,100120.7,250241.389999993
"7213",2017-08-22 21:19:26,-250241.39,-6.57746568322182e-09
"7214",2017-08-22 21:24:44,50120.72,50120.7199999934
"7215",2017-08-22 21:39:07,-50120.72,-6.57746568322182e-09
"7216",2017-08-22 22:31:59,300120.73,300120.729999993
"7217",2017-08-22 22:36:01,-300120.73,-6.57746568322182e-09
"7218",2017-08-22 22:48:34,110082.92,110082.919999993
"7219",2017-08-22 22:48:34,113827.48,223910.399999993
"7220",2017-08-22 23:22:32,158625.86,382536.259999993
"7221",2017-08-22 23:22:32,101053.81,483590.069999993
"7222",2017-08-22 23:30:45,275515.73,759105.799999993
"7223",2017-08-22 23:39:38,298194.9,1057300.69999999
"7224",2017-08-22 23:39:38,-223910.4,833390.299999993
"7225",2017-08-22 23:39:38,-759105.8,74284.4999999931
"7226",2017-08-22 23:50:12,365993.2,440277.699999993
"7227",2017-08-22 23:50:12,-74284.5,365993.199999993
"7228",2017-08-22 23:50:12,155083.3,521076.499999993
"7229",2017-08-22 23:50:12,300120.67,821197.169999993
"7230",2017-08-22 23:50:12,205290.7,1026487.86999999
"7231",2017-08-22 23:50:12,300120.68,1326608.54999999
"7232",2017-08-22 23:57:42,-1326608.55,-6.98491930961609e-09
"7233",2017-08-23 00:04:13,495961.34,495961.339999993
"7234",2017-08-23 00:23:56,440637.5,936598.839999993
"7235",2017-08-23 00:23:56,-495961.34,440637.499999993
"7236",2017-08-23 00:42:46,185826.57,626464.069999993
"7237",2017-08-23 00:42:46,-440637.5,185826.569999993
"7238",2017-08-23 00:56:57,145341.16,331167.729999993
"7239",2017-08-23 00:56:57,246929.67,578097.399999993
"7240",2017-08-23 00:56:57,-185826.57,392270.829999993
"7241",2017-08-23 01:01:59,120928.24,513199.069999993
"7242",2017-08-23 01:01:59,-392270.83,120928.239999993
"7243",2017-08-23 01:17:05,175580.06,296508.299999993
"7244",2017-08-23 01:17:05,184611.22,481119.519999993
"7245",2017-08-23 01:37:56,189690.07,670809.589999993
"7246",2017-08-23 01:41:04,165960.27,836769.859999993
"7247",2017-08-23 02:13:33,198469.22,1035239.07999999
"7248",2017-08-23 02:13:33,209365.82,1244604.89999999
"7249",2017-08-23 02:22:08,176984.73,1421589.62999999
"7250",2017-08-23 03:19:18,292341.88,1713931.50999999
"7251",2017-08-23 03:31:25,159995.19,1873926.69999999
"7252",2017-08-23 03:44:00,191264.61,2065191.30999999
"7253",2017-08-23 03:52:43,218577,2283768.30999999
"7254",2017-08-23 06:55:12,205872.14,2489640.44999999
"7255",2017-08-23 08:11:00,241093.43,2730733.87999999
"7256",2017-08-23 09:31:08,393788.83,3124522.70999999
"7257",2017-08-23 09:31:08,643245.72,3767768.42999999
"7258",2017-08-23 09:48:43,315073.32,4082841.74999999
"7259",2017-08-23 10:42:57,346230.7,4429072.44999999
"7260",2017-08-23 11:09:21,293956.05,4723028.49999999
"7261",2017-08-23 12:55:36,393340.65,5116369.14999999
"7262",2017-08-23 14:16:47,245758.67,5362127.81999999
"7263",2017-08-23 15:43:46,246134.96,5608262.77999999
"7264",2017-08-23 16:30:24,261193.32,5869456.09999999
"7265",2017-08-23 16:52:31,279882.77,6149338.86999999
"7266",2017-08-24 05:29:35,95565.41,6244904.27999999
"7267",2017-08-24 06:08:09,498368.35,6743272.62999999
"7268",2017-08-24 11:32:08,217243.51,6960516.13999999
"7269",2017-08-24 12:09:18,299548.08,7260064.21999999
"7270",2017-08-24 13:53:19,385239.52,7645303.73999999
"7271",2017-08-24 14:27:50,411510.23,8056813.96999999
"7272",2017-08-24 23:20:54,432521.89,8489335.85999999
"7273",2017-08-24 23:20:54,270070.69,8759406.54999999
"7274",2017-08-25 00:24:38,-8759406.55,-7.45058059692383e-09
"7275",2017-08-25 00:52:33,438127.8,438127.799999993
"7276",2017-08-25 00:56:24,-438127.8,-7.45058059692383e-09
"7277",2017-08-25 03:21:14,422030.48,422030.479999993
"7278",2017-08-25 05:02:35,377034.54,799065.019999993
"7279",2017-08-25 05:08:33,-799065.02,-7.45058059692383e-09
"7280",2017-08-25 05:26:41,272325.45,272325.449999993
"7281",2017-08-25 05:44:39,-272325.45,-7.45058059692383e-09
"7282",2017-08-25 07:10:54,258829.83,258829.829999993
"7283",2017-08-25 07:18:32,-258829.83,-7.45058059692383e-09
"7284",2017-08-25 16:14:20,656836.53,656836.529999993
"7285",2017-08-25 16:14:20,253310.81,910147.339999993
"7286",2017-08-25 17:30:20,388879.97,1299027.30999999
"7287",2017-08-25 19:46:42,-1299027.31,-7.45058059692383e-09
"7288",2017-08-25 20:25:09,235353.57,235353.569999993
"7289",2017-08-25 20:27:07,16389.83,251743.399999993
"7290",2017-08-25 20:34:51,304394.39,556137.789999993
"7291",2017-08-25 20:34:51,-251743.4,304394.389999993
"7292",2017-08-25 20:34:51,-251743.4,52650.9899999926
"7293",2017-08-26 03:32:12,170046.13,222697.119999993
"7294",2017-08-26 03:32:12,18964.55,241661.669999993
"7295",2017-08-26 08:01:33,118964.79,360626.459999993
"7296",2017-08-26 18:12:47,77907.83,438534.289999993
"7297",2017-08-26 18:12:47,89018.86,527553.149999993
"7298",2017-08-26 19:27:30,716053.14,1243606.28999999
"7299",2017-08-26 20:14:26,77908.65,1321514.93999999
"7300",2017-08-26 20:14:26,77908.66,1399423.59999999
"7301",2017-08-27 02:09:32,259716.99,1659140.58999999
"7302",2017-08-27 02:09:32,354705.38,2013845.96999999
"7303",2017-08-27 04:11:20,300121.92,2313967.88999999
"7304",2017-08-27 09:09:36,235211.59,2549179.47999999
"7305",2017-08-27 10:22:11,217556.02,2766735.49999999
"7306",2017-08-27 11:32:49,225174.55,2991910.04999999
"7307",2017-08-27 15:00:14,281944.31,3273854.35999999
"7308",2017-08-27 19:55:06,220685.05,3494539.40999999
"7309",2017-08-27 20:53:08,224076.18,3718615.58999999
"7310",2017-08-28 00:17:48,515680.07,4234295.65999999
"7311",2017-08-28 01:07:11,451803.46,4686099.11999999
"7312",2017-08-28 04:33:47,326705.12,5012804.23999999
"7313",2017-08-28 04:33:47,211427.67,5224231.90999999
"7314",2017-08-28 04:56:01,229143.17,5453375.07999999
"7315",2017-08-28 04:56:01,30658.44,5484033.51999999
"7316",2017-08-29 03:34:24,161105.25,5645138.76999999
"7317",2017-08-29 03:34:24,14872.69,5660011.45999999
"7318",2017-08-29 03:42:51,147731.98,5807743.43999999
"7319",2017-08-29 05:21:01,184633.35,5992376.78999999
"7320",2017-08-29 05:47:12,354763.85,6347140.63999999
"7321",2017-08-29 13:54:34,705857.08,7052997.71999999
"7322",2017-08-29 14:37:54,201138.56,7254136.27999999
"7323",2017-08-29 14:47:52,235692.47,7489828.74999999
"7324",2017-08-29 16:50:20,183802.37,7673631.11999999
"7325",2017-08-29 16:50:20,199823.84,7873454.95999999
"7326",2017-08-29 16:50:20,-7489828.75,383626.209999992
"7327",2017-08-29 17:09:21,199533.34,583159.549999992
"7328",2017-08-29 17:09:21,-383626.21,199533.339999992
"7329",2017-08-29 17:40:48,250689.95,450223.289999992
"7330",2017-08-29 17:46:07,-450223.29,-8.44011083245277e-09
"7331",2017-08-29 18:01:24,375002.86,375002.859999992
"7332",2017-08-29 18:13:12,-375002.86,-8.44011083245277e-09
"7333",2017-08-29 21:18:35,335472.59,335472.589999992
"7334",2017-08-29 21:37:24,-335472.59,-8.44011083245277e-09
"7335",2017-08-30 01:29:08,299254.71,299254.709999992
"7336",2017-08-30 01:36:59,-299254.71,-8.44011083245277e-09
"7337",2017-08-30 01:55:15,300196.39,300196.389999992
"7338",2017-08-30 01:59:00,-300196.39,-8.44011083245277e-09
"7339",2017-08-30 03:59:28,271194.7,271194.699999992
"7340",2017-08-30 04:06:57,-271194.7,-8.44011083245277e-09
"7341",2017-08-30 04:26:50,261822.66,261822.659999992
"7342",2017-08-30 04:26:50,25793.74,287616.399999992
"7343",2017-08-30 04:34:34,285564.2,573180.599999992
"7344",2017-08-30 04:34:34,-287616.4,285564.199999992
"7345",2017-08-30 04:55:45,251328.62,536892.819999992
"7346",2017-08-30 04:55:45,-285564.2,251328.619999992
"7347",2017-08-30 04:58:38,-251328.62,-8.44011083245277e-09
"7348",2017-08-30 05:45:26,230417.17,230417.169999992
"7349",2017-08-30 05:45:26,22229.99,252647.159999992
"7350",2017-08-30 05:52:33,567235.14,819882.299999992
"7351",2017-08-30 05:52:33,77916.3,897798.599999992
"7352",2017-08-30 05:52:33,-252647.16,645151.439999992
"7353",2017-08-30 06:10:06,165227.61,810379.049999992
"7354",2017-08-30 06:10:06,-645151.44,165227.609999992
"7355",2017-08-30 06:21:21,-165227.61,-8.38190317153931e-09
"7356",2017-08-30 06:40:01,220715.14,220715.139999992
"7357",2017-08-30 06:59:37,-220715.14,-8.38190317153931e-09
"7358",2017-08-30 06:59:37,673936.7,673936.699999992
"7359",2017-08-30 07:21:47,-673936.7,-8.38190317153931e-09
"7360",2017-08-30 08:11:26,194506.05,194506.049999992
"7361",2017-08-30 08:33:46,-194506.05,-8.38190317153931e-09
"7362",2017-08-30 10:35:37,264348.88,264348.879999992
"7363",2017-08-30 11:01:14,239858.31,504207.189999992
"7364",2017-08-30 11:26:44,285948.16,790155.349999992
"7365",2017-08-30 12:06:33,229482.1,1019637.44999999
"7366",2017-08-30 12:34:40,369373.98,1389011.42999999
"7367",2017-08-30 12:43:49,247779.08,1636790.50999999
"7368",2017-08-30 18:11:14,280698.6,1917489.10999999
"7369",2017-08-30 23:15:14,269179.68,2186668.78999999
"7370",2017-08-31 00:01:58,285811.41,2472480.19999999
"7371",2017-08-31 01:35:21,161761.22,2634241.41999999
"7372",2017-08-31 02:09:07,142455.24,2776696.65999999
"7373",2017-08-31 02:26:48,138011.94,2914708.59999999
"7374",2017-08-31 04:16:00,137639.31,3052347.90999999
"7375",2017-08-31 05:39:47,143374.41,3195722.31999999
"7376",2017-08-31 05:40:29,14473.63,3210195.94999999
"7377",2017-08-31 07:04:48,225461,3435656.94999999
"7378",2017-08-31 07:34:32,149923.33,3585580.27999999
"7379",2017-08-31 07:47:52,122806.14,3708386.41999999
"7380",2017-08-31 08:53:39,124361.12,3832747.53999999
"7381",2017-08-31 09:16:54,125240.86,3957988.39999999
"7382",2017-08-31 09:39:21,126660.62,4084649.01999999
"7383",2017-08-31 10:39:20,143413.48,4228062.49999999
"7384",2017-08-31 10:44:15,325499.62,4553562.11999999
"7385",2017-08-31 11:36:57,130783.98,4684346.09999999
"7386",2017-08-31 12:07:54,119975.42,4804321.51999999
"7387",2017-08-31 12:48:12,114526.39,4918847.90999999
"7388",2017-08-31 12:48:12,11125.5,4929973.40999999
"7389",2017-08-31 13:16:09,227048.63,5157022.03999999
"7390",2017-08-31 13:53:55,151071.3,5308093.33999999
"7391",2017-08-31 13:53:55,155103.14,5463196.47999999
"7392",2017-08-31 13:53:55,306534.28,5769730.75999999
"7393",2017-08-31 14:34:48,241909.71,6011640.46999999
"7394",2017-08-31 16:12:16,199521.01,6211161.47999999
"7395",2017-08-31 16:12:16,184797.41,6395958.88999999
"7396",2017-08-31 17:24:27,131934.03,6527892.91999999
"7397",2017-08-31 17:49:45,163344.49,6691237.40999999
"7398",2017-08-31 18:04:56,97423.33,6788660.73999999
"7399",2017-08-31 19:22:15,153514.27,6942175.00999999
"7400",2017-08-31 19:22:15,89028.33,7031203.33999999
"7401",2017-08-31 19:22:15,130140.34,7161343.67999999
"7402",2017-08-31 20:51:26,146438.97,7307782.64999999
"7403",2017-08-31 20:51:26,191294.26,7499076.90999999
"7404",2017-08-31 22:35:36,112797.82,7611874.72999999
"7405",2017-09-01 00:31:08,111285.02,7723159.74999999
"7406",2017-09-01 00:31:08,102373.79,7825533.53999999
"7407",2017-09-01 00:31:08,113358.77,7938892.30999999
"7408",2017-09-01 00:57:03,236952.86,8175845.16999999
"7409",2017-09-01 00:59:33,111200.42,8287045.58999999
"7410",2017-09-01 01:22:30,104974.55,8392020.13999999
"7411",2017-09-01 01:23:10,108102.3,8500122.43999999
"7412",2017-09-01 01:53:33,108061.58,8608184.01999999
"7413",2017-09-01 01:53:33,107947.42,8716131.43999999
"7414",2017-09-01 02:11:08,108372.39,8824503.82999999
"7415",2017-09-01 03:05:12,101793.24,8926297.06999999
"7416",2017-09-01 03:18:31,159553.72,9085850.78999999
"7417",2017-09-01 03:26:21,111057.07,9196907.85999999
"7418",2017-09-01 03:44:20,124964.42,9321872.27999999
"7419",2017-09-01 04:21:20,115027.17,9436899.44999999
"7420",2017-09-01 04:21:20,112705.05,9549604.49999999
"7421",2017-09-01 08:31:58,187655.56,9737260.05999999
"7422",2017-09-01 08:49:36,196697.01,9933957.06999999
"7423",2017-09-01 09:18:24,111611.29,10045568.36
"7424",2017-09-01 09:41:06,199728.39,10245296.75
"7425",2017-09-01 10:10:33,189028.86,10434325.61
"7426",2017-09-01 10:15:45,181632.33,10615957.94
"7427",2017-09-01 10:40:14,189028.89,10804986.83
"7428",2017-09-01 11:17:12,122793.99,10927780.82
"7429",2017-09-01 11:17:12,110258.05,11038038.87
"7430",2017-09-01 11:24:29,201993.78,11240032.65
"7431",2017-09-01 11:39:51,171320.56,11411353.21
"7432",2017-09-01 12:12:19,148965.51,11560318.72
"7433",2017-09-01 12:12:19,163091.49,11723410.21
"7434",2017-09-01 12:12:19,124257.49,11847667.7
"7435",2017-09-01 12:52:02,498542.52,12346210.22
"7436",2017-09-01 13:29:52,186104.1,12532314.32
"7437",2017-09-01 13:29:52,189029.06,12721343.38
"7438",2017-09-01 13:29:52,191943.88,12913287.26
"7439",2017-09-01 14:11:44,227533.18,13140820.44
"7440",2017-09-01 14:11:44,131233.88,13272054.32
"7441",2017-09-01 14:19:16,172343.44,13444397.76
"7442",2017-09-01 14:39:14,189029.13,13633426.89
"7443",2017-09-01 15:05:28,302794.7,13936221.59
"7444",2017-09-01 15:19:52,129085.79,14065307.38
"7445",2017-09-01 15:46:43,189029.23,14254336.61
"7446",2017-09-01 15:46:43,294735.92,14549072.53
"7447",2017-09-01 16:07:57,321075.52,14870148.05
"7448",2017-09-01 16:20:37,272806.9,15142954.95
"7449",2017-09-01 16:20:37,189029.29,15331984.24
"7450",2017-09-01 16:20:37,170740.3,15502724.54
"7451",2017-09-01 16:20:37,-14870148.05,632576.489999995
"7452",2017-09-01 16:25:26,-632576.49,-5.355104804039e-09
"7453",2017-09-01 16:47:08,189029.33,189029.329999995
"7454",2017-09-01 16:47:08,186983.73,376013.059999995
"7455",2017-09-01 16:47:08,286756.02,662769.079999995
"7456",2017-09-01 16:52:13,-662769.08,-5.23868948221207e-09
"7457",2017-09-01 17:12:45,300141.37,300141.369999995
"7458",2017-09-01 17:12:45,201375.93,501517.299999995
"7459",2017-09-01 17:12:45,188314.31,689831.609999995
"7460",2017-09-01 17:27:43,144162.66,833994.269999995
"7461",2017-09-01 17:27:43,178640.24,1012634.50999999
"7462",2017-09-01 17:27:43,-689831.61,322802.899999995
"7463",2017-09-01 17:45:52,177918.42,500721.319999995
"7464",2017-09-01 17:45:52,300141.43,800862.749999995
"7465",2017-09-01 17:45:52,125642.99,926505.739999995
"7466",2017-09-01 17:45:52,-322802.9,603702.839999995
"7467",2017-09-01 18:18:14,253839.06,857541.899999995
"7468",2017-09-01 18:18:14,117774.35,975316.249999995
"7469",2017-09-01 18:18:14,157879.28,1133195.52999999
"7470",2017-09-01 18:18:14,-603702.84,529492.689999995
"7471",2017-09-01 18:28:47,252888.69,782381.379999995
"7472",2017-09-01 18:28:47,-529492.69,252888.689999995
"7473",2017-09-01 18:32:32,300141.52,553030.209999995
"7474",2017-09-01 18:35:30,-553030.21,-5.12227416038513e-09
"7475",2017-09-01 19:02:42,300141.58,300141.579999995
"7476",2017-09-01 19:02:42,124459.26,424600.839999995
"7477",2017-09-01 19:02:42,328146.31,752747.149999995
"7478",2017-09-01 19:08:08,-752747.15,-5.12227416038513e-09
"7479",2017-09-01 19:24:34,116665.78,116665.779999995
"7480",2017-09-01 19:24:34,300141.62,416807.399999995
"7481",2017-09-01 19:43:38,188725.75,605533.149999995
"7482",2017-09-01 19:43:38,130199.52,735732.669999995
"7483",2017-09-01 19:43:38,-416807.4,318925.269999995
"7484",2017-09-01 20:06:08,142825.43,461750.699999995
"7485",2017-09-01 20:06:08,189398.13,651148.829999995
"7486",2017-09-01 20:21:15,-651148.83,-5.0058588385582e-09
"7487",2017-09-01 20:26:31,200141.74,200141.739999995
"7488",2017-09-01 20:30:01,-200141.74,-5.0058588385582e-09
"7489",2017-09-01 20:30:01,125374.62,125374.619999995
"7490",2017-09-01 20:33:33,300141.76,425516.379999995
"7491",2017-09-01 20:33:33,-125374.62,300141.759999995
"7492",2017-09-01 20:42:00,-300141.76,-5.0058588385582e-09
"7493",2017-09-01 20:49:23,293189.24,293189.239999995
"7494",2017-09-01 20:49:23,113127.16,406316.399999995
"7495",2017-09-01 20:55:44,-406316.4,-5.0058588385582e-09
"7496",2017-09-01 21:05:26,151257.64,151257.639999995
"7497",2017-09-01 21:05:26,200141.83,351399.469999995
"7498",2017-09-01 21:05:26,146332.12,497731.589999995
"7499",2017-09-01 21:18:26,-497731.59,-5.06406649947166e-09
"7500",2017-09-01 21:30:12,217034.3,217034.299999995
"7501",2017-09-01 21:30:12,131723.57,348757.869999995
"7502",2017-09-01 21:34:08,-348757.87,-5.06406649947166e-09
"7503",2017-09-01 21:48:08,300141.86,300141.859999995
"7504",2017-09-01 21:53:23,-300141.86,-5.06406649947166e-09
"7505",2017-09-01 22:06:21,200141.88,200141.879999995
"7506",2017-09-01 22:10:58,-200141.88,-5.06406649947166e-09
"7507",2017-09-01 23:25:11,247418.68,247418.679999995
"7508",2017-09-01 23:36:36,-247418.68,-5.06406649947166e-09
"7509",2017-09-01 23:41:15,117732.68,117732.679999995
"7510",2017-09-01 23:52:27,149119.74,266852.419999995
"7511",2017-09-01 23:52:27,-117732.68,149119.739999995
"7512",2017-09-01 23:56:33,-149119.74,-5.06406649947166e-09
"7513",2017-09-02 00:03:34,278726.7,278726.699999995
"7514",2017-09-02 00:14:40,-278726.7,-5.06406649947166e-09
"7515",2017-09-02 00:22:31,111490.33,111490.329999995
"7516",2017-09-02 00:35:55,129858.28,241348.609999995
"7517",2017-09-02 00:35:55,-111490.33,129858.279999995
"7518",2017-09-02 00:44:01,-129858.28,-5.07861841470003e-09
"7519",2017-09-02 01:09:40,119815.6,119815.599999995
"7520",2017-09-02 01:15:11,-119815.6,-5.07861841470003e-09
"7521",2017-09-02 02:16:47,150142.07,150142.069999995
"7522",2017-09-02 02:16:47,126626.14,276768.209999995
"7523",2017-09-02 02:16:47,257281.15,534049.359999995
"7524",2017-09-02 02:27:35,284769.89,818819.249999995
"7525",2017-09-02 02:27:35,-534049.36,284769.889999995
"7526",2017-09-02 02:30:45,-284769.89,-5.0058588385582e-09
"7527",2017-09-02 02:33:35,145682.47,145682.469999995
"7528",2017-09-02 02:47:56,218252.5,363934.969999995
"7529",2017-09-02 02:47:56,134987.63,498922.599999995
"7530",2017-09-02 02:47:56,130313.21,629235.809999995
"7531",2017-09-02 02:47:56,-145682.47,483553.339999995
"7532",2017-09-02 02:47:56,15344.57,498897.909999995
"7533",2017-09-02 02:53:29,-498897.91,-5.0058588385582e-09
"7534",2017-09-02 03:01:50,259068.95,259068.949999995
"7535",2017-09-02 03:13:38,113863.92,372932.869999995
"7536",2017-09-02 03:13:38,-259068.95,113863.919999995
"7537",2017-09-02 03:19:48,328419.75,442283.669999995
"7538",2017-09-02 03:19:48,-113863.92,328419.749999995
"7539",2017-09-02 03:19:48,-113863.92,214555.829999995
"7540",2017-09-02 03:26:46,-214555.83,-4.97675500810146e-09
"7541",2017-09-02 03:34:24,164188.83,164188.829999995
"7542",2017-09-02 03:40:27,141705.13,305893.959999995
"7543",2017-09-02 03:40:27,-164188.83,141705.129999995
"7544",2017-09-02 03:53:03,-141705.13,-4.97675500810146e-09
"7545",2017-09-02 04:30:22,50142.59,50142.589999995
"7546",2017-09-02 04:32:58,-50142.59,-4.97675500810146e-09
"7547",2017-09-02 09:02:39,441884.68,441884.679999995
"7548",2017-09-02 09:14:27,311250.77,753135.449999995
"7549",2017-09-02 09:14:27,198941.21,952076.659999995
"7550",2017-09-02 10:08:28,180897.05,1132973.71
"7551",2017-09-02 10:50:05,136995.65,1269969.35999999
"7552",2017-09-02 11:47:04,183221.53,1453190.89
"7553",2017-09-02 13:30:32,13004,1466194.89
"7554",2017-09-02 13:56:40,191034.68,1657229.56999999
"7555",2017-09-02 14:32:37,145944.26,1803173.82999999
"7556",2017-09-02 14:46:05,323745.34,2126919.16999999
"7557",2017-09-02 14:54:27,280489.79,2407408.95999999
"7558",2017-09-02 16:17:00,139898.58,2547307.53999999
"7559",2017-09-02 16:17:00,348876.14,2896183.68
"7560",2017-09-02 16:34:50,50144.72,2946328.4
"7561",2017-09-02 16:41:02,187378.87,3133707.27
"7562",2017-09-02 16:41:02,300144.98,3433852.25
"7563",2017-09-02 17:08:49,193511.07,3627363.32
"7564",2017-09-02 17:13:49,405051.66,4032414.98
"7565",2017-09-02 17:32:13,129430.78,4161845.76
"7566",2017-09-02 17:55:19,324462.77,4486308.53
"7567",2017-09-02 18:13:42,150821.89,4637130.42
"7568",2017-09-02 18:27:45,136201.54,4773331.96
"7569",2017-09-02 18:34:20,233829.77,5007161.72999999
"7570",2017-09-02 18:55:48,100145.13,5107306.85999999
"7571",2017-09-02 19:11:50,202173.28,5309480.14
"7572",2017-09-02 19:18:59,140703.26,5450183.39999999
"7573",2017-09-02 19:37:26,300145.2,5750328.59999999
"7574",2017-09-02 21:19:30,630682.83,6381011.43
"7575",2017-09-02 22:19:27,132686.13,6513697.55999999
"7576",2017-09-02 22:28:03,162926.93,6676624.48999999
"7577",2017-09-02 22:50:01,148032.88,6824657.36999999
"7578",2017-09-02 23:06:06,165555.23,6990212.59999999
"7579",2017-09-02 23:15:33,171443.96,7161656.55999999
"7580",2017-09-02 23:15:33,300145.39,7461801.94999999
"7581",2017-09-03 00:02:31,141199.91,7603001.85999999
"7582",2017-09-03 00:02:31,128940.88,7731942.73999999
"7583",2017-09-03 00:02:31,255836.41,7987779.14999999
"7584",2017-09-03 00:48:11,461561.61,8449340.75999999
"7585",2017-09-03 03:50:16,132083.13,8581423.89
"7586",2017-09-03 05:02:05,144662.2,8726086.08999999
"7587",2017-09-03 07:39:14,203346.26,8929432.34999999
"7588",2017-09-03 11:04:45,123762.67,9053195.01999999
"7589",2017-09-03 11:19:05,174798.48,9227993.49999999
"7590",2017-09-03 12:34:31,180467.42,9408460.91999999
"7591",2017-09-03 13:35:01,119437.58,9527898.49999999
"7592",2017-09-03 13:42:12,202941.4,9730839.89999999
"7593",2017-09-03 15:10:51,159724.29,9890564.18999999
"7594",2017-09-03 15:20:28,195645.42,10086209.61
"7595",2017-09-03 17:20:37,149370.53,10235580.14
"7596",2017-09-03 17:20:37,122119.28,10357699.42
"7597",2017-09-03 17:31:05,148942.55,10506641.97
"7598",2017-09-03 18:25:13,181301.26,10687943.23
"7599",2017-09-03 18:25:13,249698.88,10937642.11
"7600",2017-09-03 18:25:13,180424.73,11118066.84
"7601",2017-09-03 18:43:01,121928.14,11239994.98
"7602",2017-09-03 19:45:19,209853.14,11449848.12
"7603",2017-09-03 22:01:17,164874.46,11614722.58
"7604",2017-09-03 22:01:17,204215.25,11818937.83
"7605",2017-09-04 03:48:00,184112.12,12003049.95
"7606",2017-09-04 04:27:59,161394.28,12164444.23
"7607",2017-09-04 05:03:04,158962.74,12323406.97
"7608",2017-09-04 05:51:58,173410.86,12496817.83
"7609",2017-09-04 07:59:22,173566.45,12670384.28
"7610",2017-09-04 08:07:40,143808.56,12814192.84
"7611",2017-09-04 08:37:21,510952.24,13325145.08
"7612",2017-09-04 10:08:49,280727.51,13605872.59
"7613",2017-09-04 10:08:49,324994.29,13930866.88
"7614",2017-09-04 12:50:54,7925.76,13938792.64
"7615",2017-09-04 14:19:59,300148.81,14238941.45
"7616",2017-09-04 14:49:22,300148.85,14539090.3
"7617",2017-09-04 15:46:18,300148.89,14839239.19
"7618",2017-09-04 15:46:18,300148.86,15139388.05
"7619",2017-09-04 15:55:25,-15139388.05,-7.45058059692383e-09
"7620",2017-09-04 16:26:15,200148.92,200148.919999993
"7621",2017-09-04 16:55:16,377925.93,578074.849999993
"7622",2017-09-04 16:55:16,500148.94,1078223.78999999
"7623",2017-09-04 16:55:16,-200148.92,878074.869999993
"7624",2017-09-04 16:55:16,-200148.92,677925.949999993
"7625",2017-09-04 17:05:22,-677925.95,-7.45058059692383e-09
"7626",2017-09-04 17:20:09,500148.96,500148.959999993
"7627",2017-09-04 17:20:09,149998,650146.959999993
"7628",2017-09-04 17:34:26,200148.99,850295.949999993
"7629",2017-09-04 17:34:26,-650146.96,200148.989999993
"7630",2017-09-04 17:51:34,700149,900297.989999993
"7631",2017-09-04 17:51:34,-200148.99,700148.999999993
"7632",2017-09-04 17:58:12,-700149,-7.45058059692383e-09
"7633",2017-09-04 18:02:11,500149.01,500149.009999993
"7634",2017-09-04 18:28:24,77926.08,578075.089999993
"7635",2017-09-04 18:28:24,77926.06,656001.149999992
"7636",2017-09-04 18:28:24,-500149.01,155852.139999992
"7637",2017-09-04 18:31:37,-155852.14,-7.56699591875076e-09
"7638",2017-09-04 18:44:13,778037.12,778037.119999992
"7639",2017-09-04 18:52:14,-778037.12,-7.56699591875076e-09
"7640",2017-09-04 19:25:31,700149.17,700149.169999992
"7641",2017-09-04 19:32:32,-700149.17,-7.56699591875076e-09
"7642",2017-09-04 19:40:22,500149.18,500149.179999992
"7643",2017-09-04 19:52:50,-500149.18,-7.56699591875076e-09
"7644",2017-09-04 20:19:05,273383.41,273383.409999992
"7645",2017-09-04 20:23:27,-273383.41,-7.56699591875076e-09
"7646",2017-09-04 20:43:35,485436.43,485436.429999992
"7647",2017-09-04 20:48:46,-485436.43,-7.56699591875076e-09
"7648",2017-09-04 21:24:14,243206.17,243206.169999992
"7649",2017-09-04 21:48:37,-243206.17,-7.56699591875076e-09
"7650",2017-09-05 00:39:06,193002.95,193002.949999992
"7651",2017-09-05 00:43:57,-193002.95,-7.56699591875076e-09
"7652",2017-09-05 01:21:59,306670.43,306670.429999992
"7653",2017-09-05 01:40:56,203166.72,509837.149999992
"7654",2017-09-05 01:40:56,-306670.43,203166.719999992
"7655",2017-09-05 01:46:24,-203166.72,-7.53789208829403e-09
"7656",2017-09-05 02:44:00,14084.95,14084.9499999925
"7657",2017-09-05 02:58:11,-14084.95,-7.53789208829403e-09
"7658",2017-09-05 03:34:22,77927.22,77927.2199999925
"7659",2017-09-05 03:52:10,-77927.22,-7.53789208829403e-09
"7660",2017-09-05 05:47:35,77927.39,77927.3899999925
"7661",2017-09-05 06:04:02,-77927.39,-7.53789208829403e-09
"7662",2017-09-05 07:00:46,380086.43,380086.429999992
"7663",2017-09-05 07:22:45,154885.11,534971.539999992
"7664",2017-09-05 07:22:45,-380086.43,154885.109999992
"7665",2017-09-05 07:30:06,224432.66,379317.769999992
"7666",2017-09-05 08:03:33,173401.85,552719.619999992
"7667",2017-09-05 08:03:33,-379317.77,173401.849999992
"7668",2017-09-05 08:07:12,-173401.85,-7.5960997492075e-09
"7669",2017-09-05 09:11:14,235635.94,235635.939999992
"7670",2017-09-05 09:25:44,-235635.94,-7.5960997492075e-09
"7671",2017-09-05 09:40:20,232899.75,232899.749999992
"7672",2017-09-05 09:45:57,-232899.75,-7.5960997492075e-09
"7673",2017-09-05 14:29:59,305408.89,305408.889999992
"7674",2017-09-05 14:38:11,151964.61,457373.499999992
"7675",2017-09-05 14:38:11,-305408.89,151964.609999992
"7676",2017-09-05 14:41:23,264525.58,416490.189999992
"7677",2017-09-05 14:41:23,-151964.61,264525.579999992
"7678",2017-09-05 15:28:10,288439.38,552964.959999993
"7679",2017-09-05 15:28:10,190156.48,743121.439999992
"7680",2017-09-05 15:28:10,237548.19,980669.629999992
"7681",2017-09-05 15:28:10,-264525.58,716144.049999992
"7682",2017-09-05 15:39:10,-716144.05,-7.6834112405777e-09
"7683",2017-09-05 17:25:28,195573.28,195573.279999992
"7684",2017-09-05 17:25:28,187985.13,383558.409999992
"7685",2017-09-05 17:25:28,177136.2,560694.609999992
"7686",2017-09-05 17:33:20,-560694.61,-7.56699591875076e-09
"7687",2017-09-05 19:52:41,297603.09,297603.089999992
"7688",2017-09-05 20:15:06,-297603.09,-7.56699591875076e-09
"7689",2017-09-05 22:44:07,169959.76,169959.759999992
"7690",2017-09-05 22:48:18,156843.44,326803.199999992
"7691",2017-09-05 22:48:18,-169959.76,156843.439999992
"7692",2017-09-05 22:59:38,286367.16,443210.599999992
"7693",2017-09-05 22:59:38,-156843.44,286367.159999992
"7694",2017-09-05 22:59:38,-156843.44,129523.719999992
"7695",2017-09-05 23:06:00,-129523.72,-7.5960997492075e-09
"7696",2017-09-05 23:15:43,163877.85,163877.849999992
"7697",2017-09-05 23:15:43,179234.22,343112.069999992
"7698",2017-09-05 23:20:03,-343112.07,-7.62520357966423e-09
"7699",2017-09-05 23:29:47,186416.43,186416.429999992
"7700",2017-09-05 23:54:12,-186416.43,-7.62520357966423e-09
"7701",2017-09-06 01:15:29,215015.77,215015.769999992
"7702",2017-09-06 01:15:29,167587.47,382603.239999992
"7703",2017-09-06 01:28:50,-382603.24,-7.62520357966423e-09
"7704",2017-09-06 01:41:28,236174.65,236174.649999992
"7705",2017-09-06 01:54:56,-236174.65,-7.62520357966423e-09
"7706",2017-09-06 01:54:56,367011.37,367011.369999992
"7707",2017-09-06 02:04:19,-367011.37,-7.62520357966423e-09
"7708",2017-09-06 02:14:57,304830.45,304830.449999992
"7709",2017-09-06 04:19:49,238229.69,543060.139999992
"7710",2017-09-06 04:20:36,158327.95,701388.089999992
"7711",2017-09-06 05:22:17,233912.34,935300.429999992
"7712",2017-09-06 07:09:14,146718.71,1082019.13999999
"7713",2017-09-06 07:22:14,150847.53,1232866.66999999
"7714",2017-09-06 07:45:51,171284.25,1404150.91999999
"7715",2017-09-06 08:02:15,163970.67,1568121.58999999
"7716",2017-09-06 08:05:53,151366.91,1719488.49999999
"7717",2017-09-06 08:27:19,153637.9,1873126.39999999
"7718",2017-09-06 09:13:27,146592.33,2019718.72999999
"7719",2017-09-06 10:42:15,288455.81,2308174.53999999
"7720",2017-09-06 11:10:44,177467.61,2485642.14999999
"7721",2017-09-06 11:32:00,14406.1,2500048.24999999
"7722",2017-09-06 12:24:51,174811.89,2674860.13999999
"7723",2017-09-06 13:38:50,310840.35,2985700.48999999
"7724",2017-09-06 13:45:21,153321.87,3139022.35999999
"7725",2017-09-06 14:52:15,192576.06,3331598.41999999
"7726",2017-09-06 14:58:08,163160.87,3494759.28999999
"7727",2017-09-06 15:24:07,204400.84,3699160.12999999
"7728",2017-09-06 16:02:40,174984.85,3874144.97999999
"7729",2017-09-06 16:02:40,401711,4275855.97999999
"7730",2017-09-06 16:14:55,298653.93,4574509.90999999
"7731",2017-09-06 16:32:21,212445.37,4786955.27999999
"7732",2017-09-06 16:32:21,172770.39,4959725.66999999
"7733",2017-09-06 17:01:58,168744.92,5128470.58999999
"7734",2017-09-06 17:31:28,225452.73,5353923.31999999
"7735",2017-09-06 17:31:28,159995.28,5513918.59999999
"7736",2017-09-06 18:09:13,248277.61,5762196.20999999
"7737",2017-09-06 18:36:44,202694.25,5964890.45999999
"7738",2017-09-06 18:59:21,186585.04,6151475.49999999
"7739",2017-09-06 19:04:51,155708.4,6307183.89999999
"7740",2017-09-06 19:26:15,195502.6,6502686.49999999
"7741",2017-09-06 20:53:52,269289.18,6771975.67999999
"7742",2017-09-06 21:27:33,187212.48,6959188.15999999
"7743",2017-09-06 21:27:33,158288.5,7117476.65999999
"7744",2017-09-06 21:34:44,254509.23,7371985.88999999
"7745",2017-09-06 22:53:56,314337.55,7686323.43999999
"7746",2017-09-06 23:01:49,191839.21,7878162.64999999
"7747",2017-09-06 23:54:55,175229.86,8053392.50999999
"7748",2017-09-07 00:19:11,172502.6,8225895.10999999
"7749",2017-09-07 01:37:09,157277.98,8383173.08999999
"7750",2017-09-07 01:42:52,205617.65,8588790.73999999
"7751",2017-09-07 01:55:34,231751.95,8820542.68999999
"7752",2017-09-07 02:05:57,150123.18,8970665.86999999
"7753",2017-09-07 03:05:39,165862.21,9136528.07999999
"7754",2017-09-07 03:05:39,205582.93,9342111.00999999
"7755",2017-09-07 03:05:39,166740.18,9508851.18999999
"7756",2017-09-07 03:53:07,171723.07,9680574.25999999
"7757",2017-09-07 04:23:42,277660.04,9958234.29999999
"7758",2017-09-07 04:51:00,239150.08,10197384.38
"7759",2017-09-07 08:46:27,208442.11,10405826.49
"7760",2017-09-07 09:11:06,198922.33,10604748.82
"7761",2017-09-07 09:21:05,179657.31,10784406.13
"7762",2017-09-07 09:52:50,77931.61,10862337.74
"7763",2017-09-07 09:52:50,295642.69,11157980.43
"7764",2017-09-07 10:07:09,310366.39,11468346.82
"7765",2017-09-07 11:41:01,165881.99,11634228.81
"7766",2017-09-07 13:08:23,262545.56,11896774.37
"7767",2017-09-07 13:13:52,343738.36,12240512.73
"7768",2017-09-07 16:46:01,-12240512.73,-7.45058059692383e-09
"7769",2017-09-07 20:43:33,295345.9,295345.899999993
"7770",2017-09-07 20:50:40,-295345.9,-7.45058059692383e-09
"7771",2017-09-07 22:08:02,150734.46,150734.459999993
"7772",2017-09-07 22:21:44,261051.99,411786.449999993
"7773",2017-09-07 22:21:44,-150734.46,261051.989999993
"7774",2017-09-07 22:37:39,-261051.99,-7.47968442738056e-09
"7775",2017-09-08 02:39:17,198751.53,198751.529999993
"7776",2017-09-08 07:00:23,137857.46,336608.989999993
"7777",2017-09-08 09:09:08,206263.53,542872.519999993
"7778",2017-09-08 10:03:22,150464.79,693337.309999993
"7779",2017-09-08 13:58:41,206260.76,899598.069999993
"7780",2017-09-08 14:07:49,489735.14,1389333.20999999
"7781",2017-09-08 14:59:42,214268.38,1603601.58999999
"7782",2017-09-08 14:59:42,265320.66,1868922.24999999
"7783",2017-09-08 14:59:42,15657.07,1884579.31999999
"7784",2017-09-08 15:31:39,598441.18,2483020.49999999
"7785",2017-09-08 16:14:04,450840.85,2933861.34999999
"7786",2017-09-08 16:41:05,150857.97,3084719.31999999
"7787",2017-09-08 16:41:05,153216.32,3237935.63999999
"7788",2017-09-08 17:03:31,231653.28,3469588.91999999
"7789",2017-09-08 17:06:38,254832.99,3724421.90999999
"7790",2017-09-08 17:29:33,150155.7,3874577.60999999
"7791",2017-09-08 17:53:41,449030.38,4323607.98999999
"7792",2017-09-08 18:48:34,414707.87,4738315.85999999
"7793",2017-09-08 18:48:34,211317.82,4949633.67999999
"7794",2017-09-08 18:48:34,50155.68,4999789.35999999
"7795",2017-09-08 18:54:03,-4999789.36,-7.45058059692383e-09
"7796",2017-09-08 18:56:00,307809.07,307809.069999993
"7797",2017-09-08 19:16:31,218413.91,526222.979999993
"7798",2017-09-08 19:16:31,-307809.07,218413.909999993
"7799",2017-09-08 19:35:22,389043.83,607457.739999993
"7800",2017-09-08 19:35:22,-218413.91,389043.829999993
"7801",2017-09-08 19:40:18,-389043.83,-7.50878825783730e-09
"7802",2017-09-08 19:46:51,275277.99,275277.989999992
"7803",2017-09-08 19:57:07,-275277.99,-7.50878825783730e-09
"7804",2017-09-08 20:24:40,324634.88,324634.879999992
"7805",2017-09-08 20:24:40,274972.06,599606.939999992
"7806",2017-09-08 20:30:49,-599606.94,-7.45058059692383e-09
"7807",2017-09-08 20:43:41,218192.37,218192.369999993
"7808",2017-09-08 20:47:28,-218192.37,-7.45058059692383e-09
"7809",2017-09-08 21:16:56,185876.83,185876.829999993
"7810",2017-09-08 21:22:58,-185876.83,-7.45058059692383e-09
"7811",2017-09-08 21:39:14,169519.17,169519.169999993
"7812",2017-09-08 21:47:00,-169519.17,-7.45058059692383e-09
"7813",2017-09-08 22:24:40,201555.6,201555.599999993
"7814",2017-09-08 22:24:40,173186.91,374742.509999993
"7815",2017-09-08 22:24:40,193036.35,567778.859999993
"7816",2017-09-08 22:41:50,-567778.86,-7.45058059692383e-09
"7817",2017-09-08 22:57:36,176919.9,176919.899999993
"7818",2017-09-08 23:03:00,-176919.9,-7.45058059692383e-09
"7819",2017-09-08 23:03:00,375220.48,375220.479999993
"7820",2017-09-08 23:19:35,-375220.48,-7.45058059692383e-09
"7821",2017-09-09 02:10:12,304878.64,304878.639999993
"7822",2017-09-09 02:18:23,-304878.64,-7.45058059692383e-09
"7823",2017-09-09 02:43:55,150774.35,150774.349999993
"7824",2017-09-09 02:43:55,153617.56,304391.909999993
"7825",2017-09-09 02:48:42,-304391.91,-7.39237293601036e-09
"7826",2017-09-09 03:24:24,150708.88,150708.879999993
"7827",2017-09-09 03:24:24,139628.7,290337.579999993
"7828",2017-09-09 03:40:01,142264.99,432602.569999993
"7829",2017-09-09 03:40:01,-290337.58,142264.989999993
"7830",2017-09-09 03:57:05,-142264.99,-7.39237293601036e-09
"7831",2017-09-09 05:12:31,240636.13,240636.129999993
"7832",2017-09-09 05:12:31,147820.57,388456.699999993
"7833",2017-09-09 05:22:30,-388456.7,-7.39237293601036e-09
"7834",2017-09-09 05:27:21,296514.22,296514.219999993
"7835",2017-09-09 05:34:41,-296514.22,-7.39237293601036e-09
"7836",2017-09-09 06:06:01,229480.41,229480.409999993
"7837",2017-09-09 06:06:01,220369.9,449850.309999993
"7838",2017-09-09 06:09:56,-449850.31,-7.39237293601036e-09
"7839",2017-09-09 06:11:54,222420.9,222420.899999993
"7840",2017-09-09 06:28:26,-222420.9,-7.39237293601036e-09
"7841",2017-09-09 06:55:52,166223.84,166223.839999993
"7842",2017-09-09 07:04:56,-166223.84,-7.39237293601036e-09
"7843",2017-09-09 07:25:50,150305.11,150305.109999993
"7844",2017-09-09 07:32:25,-150305.11,-7.39237293601036e-09
"7845",2017-09-09 09:56:29,213118.56,213118.559999993
"7846",2017-09-09 10:16:16,146275.68,359394.239999993
"7847",2017-09-09 10:16:16,-213118.56,146275.679999993
"7848",2017-09-09 10:40:09,-146275.68,-7.39237293601036e-09
"7849",2017-09-09 10:56:48,152725.51,152725.509999993
"7850",2017-09-09 11:07:52,-152725.51,-7.39237293601036e-09
"7851",2017-09-09 11:18:35,268089.93,268089.929999993
"7852",2017-09-09 11:23:23,-268089.93,-7.39237293601036e-09
"7853",2017-09-09 11:40:48,172544.42,172544.419999993
"7854",2017-09-09 12:04:07,249078.26,421622.679999993
"7855",2017-09-09 12:04:07,-172544.42,249078.259999993
"7856",2017-09-09 12:04:07,-172544.42,76533.8399999926
"7857",2017-09-09 12:12:36,-76533.84,-7.42147676646709e-09
"7858",2017-09-09 12:46:14,187012.46,187012.459999993
"7859",2017-09-09 12:57:42,-187012.46,-7.42147676646709e-09
"7860",2017-09-09 14:07:06,212570.83,212570.829999993
"7861",2017-09-09 14:23:08,-212570.83,-7.42147676646709e-09
"7862",2017-09-09 17:57:08,275971.62,275971.619999993
"7863",2017-09-09 18:01:22,-275971.62,-7.45058059692383e-09
"7864",2017-09-09 18:54:32,211822.39,211822.389999993
"7865",2017-09-09 18:55:41,-211822.39,-7.45058059692383e-09
"7866",2017-09-09 19:24:21,178944.73,178944.729999993
"7867",2017-09-09 19:34:29,232622.16,411566.889999993
"7868",2017-09-09 19:34:29,-178944.73,232622.159999993
"7869",2017-09-09 19:45:07,-232622.16,-7.45058059692383e-09
"7870",2017-09-09 19:55:23,289829.21,289829.209999993
"7871",2017-09-09 19:59:19,217808.25,507637.459999993
"7872",2017-09-09 19:59:19,-289829.21,217808.249999993
"7873",2017-09-09 20:09:47,-217808.25,-7.45058059692383e-09
"7874",2017-09-09 22:45:58,200737.46,200737.459999993
"7875",2017-09-09 23:12:44,197601.88,398339.339999993
"7876",2017-09-09 23:12:44,-200737.46,197601.879999993
"7877",2017-09-09 23:36:30,-197601.88,-7.47968442738056e-09
"7878",2017-09-10 07:32:49,194378.05,194378.049999993
"7879",2017-09-10 07:32:49,142595.39,336973.439999992
"7880",2017-09-10 07:50:14,171018.44,507991.879999992
"7881",2017-09-10 08:26:44,177048.95,685040.829999993
"7882",2017-09-10 08:57:09,199399.92,884440.749999993
"7883",2017-09-10 09:39:27,322314.35,1206755.09999999
"7884",2017-09-10 10:59:59,249022.54,1455777.63999999
"7885",2017-09-10 11:43:35,272137.63,1727915.26999999
"7886",2017-09-10 11:43:35,210489.85,1938405.11999999
"7887",2017-09-10 13:26:58,412942.8,2351347.91999999
"7888",2017-09-10 14:11:19,279096.4,2630444.31999999
"7889",2017-09-10 15:00:52,356546.49,2986990.80999999
"7890",2017-09-10 17:59:03,269941.28,3256932.08999999
"7891",2017-09-10 17:59:03,250138.59,3507070.67999999
"7892",2017-09-10 17:59:03,233341.92,3740412.59999999
"7893",2017-09-10 18:44:20,318616.29,4059028.88999999
"7894",2017-09-10 19:16:52,202459.91,4261488.79999999
"7895",2017-09-10 21:13:45,309761.85,4571250.64999999
"7896",2017-09-10 22:15:03,181753.5,4753004.14999999
"7897",2017-09-10 23:47:50,193518.23,4946522.37999999
"7898",2017-09-10 23:55:45,307904.2,5254426.57999999
"7899",2017-09-11 01:20:54,197869.98,5452296.55999999
"7900",2017-09-11 01:20:54,339351.8,5791648.35999999
"7901",2017-09-11 02:23:36,200355.25,5992003.60999999
"7902",2017-09-11 06:13:05,300864.92,6292868.52999999
"7903",2017-09-11 12:24:25,391054.48,6683923.00999999
"7904",2017-09-11 13:55:24,433705.86,7117628.86999999
"7905",2017-09-11 17:56:10,377145.31,7494774.17999999
"7906",2017-09-11 19:10:03,27432.84,7522207.01999999
"7907",2017-09-11 21:32:14,150519.15,7672726.16999999
"7908",2017-09-11 21:32:14,111747.98,7784474.14999999
"7909",2017-09-11 22:39:57,111962.9,7896437.04999999
"7910",2017-09-12 01:39:57,202708.19,8099145.23999999
"7911",2017-09-12 02:07:34,142257.96,8241403.19999999
"7912",2017-09-12 02:55:47,332135.53,8573538.72999999
"7913",2017-09-12 03:39:01,265874.43,8839413.15999999
"7914",2017-09-12 03:52:21,200837.25,9040250.40999999
"7915",2017-09-12 04:00:17,211877.35,9252127.75999999
"7916",2017-09-12 04:15:53,260616.19,9512743.94999999
"7917",2017-09-12 05:15:43,470179.06,9982923.00999999
"7918",2017-09-12 05:53:43,353245.09,10336168.1
"7919",2017-09-12 14:23:49,215079.33,10551247.43
"7920",2017-09-12 16:36:07,285859.84,10837107.27
"7921",2017-09-12 17:31:01,251210.21,11088317.48
"7922",2017-09-12 19:21:29,-11088317.48,-7.45058059692383e-09
"7923",2017-09-12 19:32:40,15350.73,15350.7299999925
"7924",2017-09-12 19:48:05,458169.44,473520.169999993
"7925",2017-09-12 19:48:05,-15350.73,458169.439999993
"7926",2017-09-12 19:48:05,-15350.73,442818.709999993
"7927",2017-09-12 19:54:30,-442818.71,-7.45058059692383e-09
"7928",2017-09-12 20:26:16,163376.77,163376.769999993
"7929",2017-09-12 20:36:59,-163376.77,-7.45058059692383e-09
"7930",2017-09-12 20:42:21,211642.97,211642.969999993
"7931",2017-09-12 20:49:08,-211642.97,-7.45058059692383e-09
"7932",2017-09-12 21:43:37,158163.23,158163.229999993
"7933",2017-09-12 22:01:19,-158163.23,-7.45058059692383e-09
"7934",2017-09-12 22:44:55,171777.16,171777.159999993
"7935",2017-09-12 22:55:50,-171777.16,-7.45058059692383e-09
"7936",2017-09-12 23:25:10,151918.38,151918.379999993
"7937",2017-09-12 23:40:59,132915.89,284834.269999993
"7938",2017-09-12 23:40:59,-151918.38,132915.889999993
"7939",2017-09-12 23:49:56,-132915.89,-7.45058059692383e-09
"7940",2017-09-13 00:42:34,157719.26,157719.259999993
"7941",2017-09-13 01:00:34,158771.45,316490.709999993
"7942",2017-09-13 01:00:34,-157719.26,158771.449999993
"7943",2017-09-13 01:00:34,-157719.26,1052.18999999255
"7944",2017-09-13 01:07:07,-1052.19,-7.4483068601694e-09
"7945",2017-09-13 01:25:16,152540.74,152540.739999993
"7946",2017-09-13 01:30:30,-152540.74,-7.45058059692383e-09
"7947",2017-09-13 02:01:20,161412.64,161412.639999993
"7948",2017-09-13 02:08:07,-161412.64,-7.45058059692383e-09
"7949",2017-09-13 03:11:12,286297.23,286297.229999993
"7950",2017-09-13 03:11:12,163663.05,449960.279999993
"7951",2017-09-13 03:22:31,-449960.28,-7.50878825783730e-09
"7952",2017-09-13 04:39:56,28377.76,28377.7599999925
"7953",2017-09-13 04:53:39,201955.96,230333.719999992
"7954",2017-09-13 04:53:39,166085.65,396419.369999992
"7955",2017-09-13 04:53:39,-28377.76,368041.609999992
"7956",2017-09-13 04:53:39,13195.97,381237.579999992
"7957",2017-09-13 04:58:19,-381237.58,-7.56699591875076e-09
"7958",2017-09-13 05:04:22,194779.07,194779.069999992
"7959",2017-09-13 05:10:34,-194779.07,-7.56699591875076e-09
"7960",2017-09-13 05:46:44,321103.45,321103.449999992
"7961",2017-09-13 06:01:17,-321103.45,-7.56699591875076e-09
"7962",2017-09-13 06:13:45,137011.1,137011.099999992
"7963",2017-09-13 06:13:45,145399.6,282410.699999992
"7964",2017-09-13 06:28:02,185910.51,468321.209999992
"7965",2017-09-13 06:28:02,180215.47,648536.679999992
"7966",2017-09-13 06:28:02,-282410.7,366125.979999992
"7967",2017-09-13 06:31:43,208811,574936.979999993
"7968",2017-09-13 06:38:06,-574936.98,-7.45058059692383e-09
"7969",2017-09-13 08:01:38,236234.26,236234.259999993
"7970",2017-09-13 08:12:04,-236234.26,-7.45058059692383e-09
"7971",2017-09-13 09:45:32,630501.25,630501.249999993
"7972",2017-09-13 09:50:30,-630501.25,-7.45058059692383e-09
"7973",2017-09-13 10:19:59,162855.66,162855.659999993
"7974",2017-09-13 10:19:59,147069.84,309925.499999993
"7975",2017-09-13 10:25:22,-309925.5,-7.45058059692383e-09
"7976",2017-09-13 11:40:48,318959.38,318959.379999993
"7977",2017-09-13 11:57:50,-318959.38,-7.45058059692383e-09
"7978",2017-09-13 12:27:39,241808.74,241808.739999993
"7979",2017-09-13 12:44:07,284143.34,525952.079999993
"7980",2017-09-13 13:38:11,297653.77,823605.849999993
"7981",2017-09-13 14:06:07,248445.85,1072051.69999999
"7982",2017-09-13 14:57:35,201504.17,1273555.86999999
"7983",2017-09-13 15:11:58,358454.99,1632010.85999999
"7984",2017-09-13 15:37:20,376435.4,2008446.25999999
"7985",2017-09-13 18:34:11,177851.89,2186298.14999999
"7986",2017-09-13 20:51:57,174213.03,2360511.17999999
"7987",2017-09-13 22:34:20,210175.66,2570686.83999999
"7988",2017-09-13 22:41:01,316562.82,2887249.65999999
"7989",2017-09-14 04:31:12,186039.35,3073289.00999999
"7990",2017-09-14 06:15:30,170624.09,3243913.09999999
"7991",2017-09-14 07:17:06,187565.57,3431478.66999999
"7992",2017-09-14 08:17:07,243443.19,3674921.85999999
"7993",2017-09-14 11:42:05,14787.81,3689709.66999999
"7994",2017-09-14 12:07:11,186008.55,3875718.21999999
"7995",2017-09-14 12:07:11,220660.7,4096378.91999999
"7996",2017-09-14 12:18:07,196687.97,4293066.88999999
"7997",2017-09-14 12:41:01,286782.35,4579849.23999999
"7998",2017-09-14 12:59:49,216039.95,4795889.18999999
"7999",2017-09-14 12:59:49,218511.9,5014401.08999999
"8000",2017-09-14 15:18:27,585363.6,5599764.68999999
"8001",2017-09-14 15:22:18,266315.38,5866080.06999999
"8002",2017-09-14 19:24:03,588649.95,6454730.01999999
"8003",2017-09-14 22:16:46,321821.34,6776551.35999999
"8004",2017-09-14 22:23:04,400105.63,7176656.98999999
"8005",2017-09-15 00:36:46,470461.03,7647118.01999999
"8006",2017-09-15 00:42:52,347963.16,7995081.17999999
"8007",2017-09-15 01:08:05,386106.41,8381187.58999999
"8008",2017-09-15 02:43:24,419682.17,8800869.75999999
"8009",2017-09-15 06:04:29,47178.54,8848048.29999999
"8010",2017-09-15 07:31:34,305174.4,9153222.69999999
"8011",2017-09-15 08:38:28,540396.13,9693618.82999999
"8012",2017-09-15 10:31:16,344042.48,10037661.31
"8013",2017-09-15 11:06:07,356837.54,10394498.85
"8014",2017-09-15 11:06:07,400472.93,10794971.78
"8015",2017-09-15 11:21:34,362991.75,11157963.53
"8016",2017-09-15 12:02:08,457383.75,11615347.28
"8017",2017-09-15 12:55:29,446015.66,12061362.94
"8018",2017-09-15 16:41:19,329905.01,12391267.95
"8019",2017-09-15 17:47:26,215670.75,12606938.7
"8020",2017-09-15 17:47:26,306088.19,12913026.89
"8021",2017-09-15 18:09:50,27986.73,12941013.62
"8022",2017-09-15 18:09:50,31837.99,12972851.61
"8023",2017-09-15 18:18:29,-12972851.61,-7.45058059692383e-09
"8024",2017-09-15 19:39:35,315981.74,315981.739999993
"8025",2017-09-15 19:39:35,360243.88,676225.619999993
"8026",2017-09-15 19:47:44,229797.65,906023.269999993
"8027",2017-09-15 19:47:44,-676225.62,229797.649999993
"8028",2017-09-15 19:59:08,-229797.65,-7.42147676646709e-09
"8029",2017-09-15 20:14:18,213287.86,213287.859999993
"8030",2017-09-15 20:22:16,-213287.86,-7.42147676646709e-09
"8031",2017-09-15 21:41:43,205004.64,205004.639999993
"8032",2017-09-15 21:41:43,348359.84,553364.479999993
"8033",2017-09-15 21:54:23,-553364.48,-7.33416527509689e-09
"8034",2017-09-15 22:55:21,233791.01,233791.009999993
"8035",2017-09-15 23:07:32,-233791.01,-7.33416527509689e-09
"8036",2017-09-16 00:48:35,233138.15,233138.149999993
"8037",2017-09-16 01:09:06,-233138.15,-7.33416527509689e-09
"8038",2017-09-16 01:09:06,248736.51,248736.509999993
"8039",2017-09-16 01:17:19,-248736.51,-7.33416527509689e-09
"8040",2017-09-16 01:33:26,281184.22,281184.219999993
"8041",2017-09-16 01:37:19,-281184.22,-7.33416527509689e-09
"8042",2017-09-16 01:49:53,220663.44,220663.439999993
"8043",2017-09-16 02:04:25,-220663.44,-7.33416527509689e-09
"8044",2017-09-16 03:34:05,544807.71,544807.709999993
"8045",2017-09-16 04:07:38,395898.73,940706.439999993
"8046",2017-09-16 04:07:38,284205.2,1224911.63999999
"8047",2017-09-16 04:07:38,-544807.71,680103.929999993
"8048",2017-09-16 04:07:38,-544807.71,135296.219999993
"8049",2017-09-16 04:21:48,-135296.22,-7.24685378372669e-09
"8050",2017-09-16 06:34:15,777782.11,777782.109999993
"8051",2017-09-16 06:34:15,25951.12,803733.229999993
"8052",2017-09-16 06:34:15,319494.29,1123227.51999999
"8053",2017-09-16 06:41:13,-1123227.52,-7.21774995326996e-09
"8054",2017-09-16 08:36:34,415465.5,415465.499999993
"8055",2017-09-16 09:05:10,-415465.5,-7.21774995326996e-09
"8056",2017-09-16 10:34:57,407957.57,407957.569999993
"8057",2017-09-16 10:34:57,258624.88,666582.449999993
"8058",2017-09-16 10:34:57,336397.03,1002979.47999999
"8059",2017-09-16 10:44:35,316982.56,1319962.03999999
"8060",2017-09-16 10:44:35,-1002979.48,316982.559999993
"8061",2017-09-16 10:51:29,-316982.56,-7.15954229235649e-09
"8062",2017-09-16 11:12:42,397642.82,397642.819999993
"8063",2017-09-16 11:19:13,-397642.82,-7.15954229235649e-09
"8064",2017-09-16 11:58:34,544155.01,544155.009999993
"8065",2017-09-16 12:04:16,-544155.01,-7.21774995326996e-09
"8066",2017-09-16 13:42:50,325727.49,325727.489999993
"8067",2017-09-16 13:53:14,304892.02,630619.509999993
"8068",2017-09-16 13:58:39,324678.16,955297.669999993
"8069",2017-09-16 14:44:14,310359.54,1265657.20999999
"8070",2017-09-16 15:20:14,419094.17,1684751.37999999
"8071",2017-09-16 16:06:03,372838.83,2057590.20999999
"8072",2017-09-16 16:31:25,339150.55,2396740.75999999
"8073",2017-09-16 16:41:39,484357.02,2881097.77999999
"8074",2017-09-16 21:57:21,301450.16,3182547.93999999
"8075",2017-09-17 17:43:03,325561.94,3508109.87999999
"8076",2017-09-17 20:36:58,347846.78,3855956.65999999
"8077",2017-09-18 01:20:26,275747.67,4131704.32999999
"8078",2017-09-18 01:32:05,355356.56,4487060.88999999
"8079",2017-09-18 12:27:14,49538.11,4536598.99999999
"8080",2017-09-18 12:32:43,487909.82,5024508.81999999
"8081",2017-09-18 14:46:26,15410.71,5039919.52999999
"8082",2017-09-18 14:46:26,25817.08,5065736.60999999
"8083",2017-09-18 14:46:26,17137.02,5082873.62999999
"8084",2017-09-18 14:54:10,300593.18,5383466.80999999
"8085",2017-09-18 15:18:19,222965.53,5606432.33999999
"8086",2017-09-18 15:50:31,15738.7,5622171.03999999
"8087",2017-09-18 16:20:51,393699.6,6015870.63999999
"8088",2017-09-18 22:10:53,252213.63,6268084.26999999
"8089",2017-09-18 22:10:53,406234.45,6674318.71999999
"8090",2017-09-19 03:05:47,29884.65,6704203.36999999
"8091",2017-09-19 04:09:37,182804.8,6887008.16999999
"8092",2017-09-19 04:09:37,173592,7060600.16999999
"8093",2017-09-19 04:09:37,188841.36,7249441.52999999
"8094",2017-09-19 05:30:11,324054.19,7573495.71999999
"8095",2017-09-19 05:31:29,266016.6,7839512.31999999
"8096",2017-09-19 05:48:40,226705.84,8066218.15999999
"8097",2017-09-19 06:04:38,215984.38,8282202.53999999
"8098",2017-09-19 06:04:38,83413.35,8365615.88999999
"8099",2017-09-19 06:42:30,221203.99,8586819.87999999
"8100",2017-09-19 06:42:30,309244.14,8896064.01999999
"8101",2017-09-19 06:49:28,313192.21,9209256.22999999
"8102",2017-09-19 07:56:54,190169.35,9399425.57999999
"8103",2017-09-19 07:56:54,192410.37,9591835.94999999
"8104",2017-09-19 08:27:40,268843.9,9860679.84999999
"8105",2017-09-19 09:27:56,10517.63,9871197.47999999
"8106",2017-09-19 15:31:18,10413.12,9881610.59999999
"8107",2017-09-19 15:59:12,319390.05,10201000.65
"8108",2017-09-19 16:43:21,32352.96,10233353.61
"8109",2017-09-19 17:18:48,-10233353.61,-5.58793544769287e-09
"8110",2017-09-19 17:18:48,266690.91,266690.909999994
"8111",2017-09-19 17:38:50,-266690.91,-5.58793544769287e-09
"8112",2017-09-19 20:01:14,460518.6,460518.599999994
"8113",2017-09-19 20:03:09,259098.84,719617.439999994
"8114",2017-09-19 20:07:58,-719617.44,-5.58793544769287e-09
"8115",2017-09-19 21:11:07,228014.57,228014.569999994
"8116",2017-09-19 21:14:13,-228014.57,-5.58793544769287e-09
"8117",2017-09-19 21:25:26,228036.01,228036.009999994
"8118",2017-09-19 21:34:26,-228036.01,-5.58793544769287e-09
"8119",2017-09-19 22:22:45,216112.03,216112.029999994
"8120",2017-09-19 22:45:13,-216112.03,-5.58793544769287e-09
"8121",2017-09-20 05:40:22,319115.42,319115.419999994
"8122",2017-09-20 05:56:18,250896.81,570012.229999994
"8123",2017-09-20 05:56:18,201855.61,771867.839999994
"8124",2017-09-20 05:56:18,31460,803327.839999994
"8125",2017-09-20 06:32:32,316238.43,1119566.26999999
"8126",2017-09-20 06:54:16,-1119566.27,-5.58793544769287e-09
"8127",2017-09-20 07:28:21,215401.79,215401.789999994
"8128",2017-09-20 07:55:14,-215401.79,-5.58793544769287e-09
"8129",2017-09-20 14:23:11,526642.97,526642.969999994
"8130",2017-09-20 14:29:10,-526642.97,-5.58793544769287e-09
"8131",2017-09-21 02:50:07,286573.09,286573.089999994
"8132",2017-09-21 02:50:07,16909.18,303482.269999994
"8133",2017-09-21 15:45:51,180372.64,483854.909999994
"8134",2017-09-21 15:45:51,24977.06,508831.969999994
"8135",2017-09-21 16:00:01,9949.59,518781.559999994
"8136",2017-09-21 16:00:01,10561.27,529342.829999994
"8137",2017-09-21 16:26:10,263981.55,793324.379999995
"8138",2017-09-21 16:26:10,248672.54,1041996.91999999
"8139",2017-09-21 16:56:24,14165.91,1056162.82999999
"8140",2017-09-21 17:11:19,212538.58,1268701.40999999
"8141",2017-09-21 19:01:09,259195.86,1527897.26999999
"8142",2017-09-21 20:51:34,353362.65,1881259.91999999
"8143",2017-09-21 22:01:04,249415.11,2130675.02999999
"8144",2017-09-21 22:47:22,258947.05,2389622.07999999
"8145",2017-09-22 00:23:37,244270.4,2633892.47999999
"8146",2017-09-22 01:52:57,209188.73,2843081.20999999
"8147",2017-09-22 03:46:40,231988.85,3075070.05999999
"8148",2017-09-22 04:24:10,277813.81,3352883.86999999
"8149",2017-09-22 04:53:10,317668.95,3670552.81999999
"8150",2017-09-22 07:56:18,258745.89,3929298.70999999
"8151",2017-09-22 08:51:10,313031.53,4242330.23999999
"8152",2017-09-22 12:31:39,263202.76,4505532.99999999
"8153",2017-09-22 14:02:34,34354.91,4539887.90999999
"8154",2017-09-22 14:18:19,398624.68,4938512.58999999
"8155",2017-09-22 14:39:55,341343.56,5279856.14999999
"8156",2017-09-22 18:03:19,300222.72,5580078.86999999
"8157",2017-09-22 19:19:15,404026.1,5984104.96999999
"8158",2017-09-22 19:55:04,225626.12,6209731.08999999
"8159",2017-09-22 22:12:29,203407.37,6413138.45999999
"8160",2017-09-23 03:04:50,240499.64,6653638.09999999
"8161",2017-09-23 08:50:08,199994.11,6853632.20999999
"8162",2017-09-23 10:54:03,262746.81,7116379.01999999
"8163",2017-09-23 17:58:20,262457.04,7378836.05999999
"8164",2017-09-23 23:17:35,379743.06,7758579.11999999
"8165",2017-09-24 07:54:12,296279.1,8054858.21999999
"8166",2017-09-24 09:45:10,276600.67,8331458.88999999
"8167",2017-09-25 02:36:10,388448.07,8719906.95999999
"8168",2017-09-25 02:55:24,274074.48,8993981.43999999
"8169",2017-09-25 03:08:13,295152.16,9289133.59999999
"8170",2017-09-25 17:28:19,315237.27,9604370.86999999
"8171",2017-09-26 09:55:00,454002.77,10058373.64
"8172",2017-09-26 22:43:47,-10058373.64,-9.31322574615479e-09
"8173",2017-09-27 03:37:07,670415.81,670415.809999991
"8174",2017-09-27 03:41:52,-670415.81,-9.31322574615479e-09
"8175",2017-09-27 10:47:24,659334.54,659334.539999991
"8176",2017-09-27 11:06:36,-659334.54,-9.31322574615479e-09
"8177",2017-09-28 09:03:37,552317.57,552317.569999991
"8178",2017-09-28 09:07:23,-552317.57,-9.31322574615479e-09
"8179",2017-09-28 11:04:09,777790.49,777790.489999991
"8180",2017-09-28 11:04:09,234671.5,1012461.98999999
"8181",2017-09-28 11:14:25,-1012461.99,-9.31322574615479e-09
"8182",2017-09-28 12:31:01,705372.28,705372.279999991
"8183",2017-09-28 12:45:27,-705372.28,-9.31322574615479e-09
"8184",2017-09-28 15:31:58,80013.6,80013.5999999907
"8185",2017-09-28 15:51:55,549693.23,629706.829999991
"8186",2017-09-28 20:29:13,321214.36,950921.189999991
"8187",2017-09-28 22:00:29,612768.09,1563689.27999999
"8188",2017-09-29 03:13:20,62534.97,1626224.24999999
"8189",2017-09-29 03:13:20,88750.34,1714974.58999999
"8190",2017-09-29 03:20:29,281108.95,1996083.53999999
"8191",2017-09-29 03:37:28,690941.35,2687024.88999999
"8192",2017-09-29 03:49:13,163658.56,2850683.44999999
"8193",2017-09-29 04:16:26,157876.78,3008560.22999999
"8194",2017-09-29 04:45:25,757873.59,3766433.81999999
"8195",2017-09-29 05:05:45,777787.86,4544221.67999999
"8196",2017-09-29 05:05:45,117030.87,4661252.54999999
"8197",2017-09-29 05:05:45,700010.89,5361263.43999999
"8198",2017-09-29 10:13:43,77788.43,5439051.86999999
"8199",2017-09-29 11:36:37,777788.61,6216840.47999999
"8200",2017-09-29 11:36:37,671884.62,6888725.09999999
"8201",2017-09-29 15:51:24,515078.88,7403803.97999999
"8202",2017-10-01 03:55:51,746514.85,8150318.82999999
"8203",2017-10-03 11:07:42,447470.05,8597788.87999999
"8204",2017-10-03 16:35:36,241030.03,8838818.90999999
"8205",2017-10-03 22:46:35,316773.6,9155592.50999999
"8206",2017-10-03 23:35:30,365155.34,9520747.84999999
"8207",2017-10-04 00:13:43,309215.16,9829963.00999999
"8208",2017-10-04 14:33:12,186203.61,10016166.62
"8209",2017-10-04 16:40:34,295596.89,10311763.51
"8210",2017-10-04 19:11:23,155170.48,10466933.99
"8211",2017-10-04 19:36:59,155241.33,10622175.32
"8212",2017-10-04 20:59:15,267114.93,10889290.25
"8213",2017-10-04 22:53:58,235591.45,11124881.7
"8214",2017-10-05 03:59:57,-11124881.7,-1.11758708953857e-08
"8215",2017-10-05 06:25:15,214795.56,214795.559999989
"8216",2017-10-05 06:39:30,190581.19,405376.749999989
"8217",2017-10-05 06:39:30,-214795.56,190581.189999989
"8218",2017-10-05 06:47:03,-190581.19,-1.11758708953857e-08
"8219",2017-10-05 09:23:49,143156.26,143156.259999989
"8220",2017-10-05 09:35:42,-143156.26,-1.11758708953857e-08
"8221",2017-10-05 10:08:38,177267.07,177267.069999989
"8222",2017-10-05 10:11:03,-177267.07,-1.11758708953857e-08
"8223",2017-10-05 12:20:25,219162.99,219162.989999989
"8224",2017-10-05 12:33:29,-219162.99,-1.11758708953857e-08
"8225",2017-10-05 23:10:00,269009.33,269009.329999989
"8226",2017-10-05 23:17:23,-269009.33,-1.11758708953857e-08
"8227",2017-10-06 07:03:22,463577.96,463577.959999989
"8228",2017-10-06 07:12:02,-463577.96,-1.11758708953857e-08
"8229",2017-10-06 09:52:43,285671.77,285671.769999989
"8230",2017-10-06 10:02:29,433349.62,719021.389999989
"8231",2017-10-06 10:02:29,-285671.77,433349.619999989
"8232",2017-10-06 10:02:29,-285671.77,147677.849999989
"8233",2017-10-06 10:10:54,-147677.85,-1.12049747258425e-08
"8234",2017-10-06 11:58:54,289234.44,289234.439999989
"8235",2017-10-06 14:14:58,405097.82,694332.259999989
"8236",2017-10-06 23:20:00,448121.4,1142453.65999999
"8237",2017-10-06 23:52:23,549975,1692428.65999999
"8238",2017-10-09 10:01:37,363160.26,2055588.91999999
"8239",2017-10-10 00:35:25,598691.5,2654280.41999999
"8240",2017-10-10 09:15:07,-2654280.42,-1.11758708953857e-08
"8241",2017-10-12 02:34:48,777693.36,777693.359999989
"8242",2017-10-12 08:15:46,535038.98,1312732.33999999
"8243",2017-10-12 08:28:41,497209.14,1809941.47999999
"8244",2017-10-12 08:37:13,567717.3,2377658.77999999
"8245",2017-10-12 10:31:27,724252.19,3101910.96999999
"8246",2017-10-12 12:42:37,664045.34,3765956.30999999
"8247",2017-10-12 16:57:12,578219.73,4344176.03999999
"8248",2017-10-12 17:03:41,501611.35,4845787.38999999
"8249",2017-10-13 02:36:57,777790.86,5623578.24999999
"8250",2017-10-13 02:36:57,236932.87,5860511.11999999
"8251",2017-10-13 03:24:51,77790.88,5938301.99999999
"8252",2017-10-13 03:24:51,777790.9,6716092.89999999
"8253",2017-10-13 04:25:09,635818.82,7351911.71999999
"8254",2017-10-13 05:41:47,478671.17,7830582.88999999
"8255",2017-10-13 05:41:47,358003.18,8188586.06999999
"8256",2017-10-13 06:01:02,402908.86,8591494.92999999
"8257",2017-10-13 07:01:06,382960.28,8974455.20999999
"8258",2017-10-13 12:11:00,699104.56,9673559.76999999
"8259",2017-10-13 12:56:55,602321.51,10275881.28
"8260",2017-10-13 13:41:24,619802.84,10895684.12
"8261",2017-10-13 14:18:02,489512.31,11385196.43
"8262",2017-10-13 14:43:46,563657.11,11948853.54
"8263",2017-10-13 20:25:37,818718.19,12767571.73
"8264",2017-10-14 02:47:09,438751.64,13206323.37
"8265",2017-10-14 06:13:33,-13206323.37,-1.11758708953857e-08
"8266",2017-10-14 23:16:45,517472.82,517472.819999989
"8267",2017-10-15 00:00:08,777791.2,1295264.01999999
"8268",2017-10-15 02:05:10,708429.16,2003693.17999999
"8269",2017-10-15 12:05:34,69504.58,2073197.75999999
"8270",2017-10-15 12:08:07,777791.3,2850989.05999999
"8271",2017-10-15 13:35:00,392231.83,3243220.88999999
"8272",2017-10-15 20:43:42,203361.56,3446582.44999999
"8273",2017-10-15 20:51:41,233077.29,3679659.73999999
"8274",2017-10-15 22:22:10,386800.61,4066460.34999999
"8275",2017-10-15 22:32:51,485043.21,4551503.55999999
"8276",2017-10-16 03:16:47,331756.73,4883260.28999999
"8277",2017-10-16 06:32:40,320063.73,5203324.01999999
"8278",2017-10-16 10:49:35,345668.86,5548992.87999999
"8279",2017-10-16 14:13:21,597439.91,6146432.78999999
"8280",2017-10-16 18:55:06,-6146432.79,-9.31322574615479e-09
"8281",2017-10-17 08:26:53,47784.32,47784.3199999907
"8282",2017-10-17 08:33:43,172454.04,220238.359999991
"8283",2017-10-17 08:33:43,-47784.32,172454.039999991
"8284",2017-10-17 08:49:20,-172454.04,-9.31322574615479e-09
"8285",2017-10-17 09:34:02,303582.76,303582.759999991
"8286",2017-10-17 09:39:40,-303582.76,-9.31322574615479e-09
"8287",2017-10-17 11:45:49,409816.55,409816.549999991
"8288",2017-10-17 11:56:35,-409816.55,-9.31322574615479e-09
"8289",2017-10-17 13:38:17,323367.21,323367.209999991
"8290",2017-10-17 13:51:52,273339.83,596707.039999991
"8291",2017-10-17 13:51:52,-323367.21,273339.829999991
"8292",2017-10-17 14:10:58,-273339.83,-9.31322574615479e-09
"8293",2017-10-17 17:28:34,407166.62,407166.619999991
"8294",2017-10-17 17:38:33,-407166.62,-9.31322574615479e-09
"8295",2017-10-18 02:26:19,18723.92,18723.9199999907
"8296",2017-10-18 02:51:29,174618.67,193342.589999991
"8297",2017-10-18 04:00:30,155401.45,348744.039999991
"8298",2017-10-18 04:12:52,133962.03,482706.069999991
"8299",2017-10-18 07:05:24,150015.38,632721.449999991
"8300",2017-10-18 07:26:50,120782.93,753504.379999991
"8301",2017-10-18 07:26:50,50015.4,803519.779999991
"8302",2017-10-18 07:47:32,109285.48,912805.259999991
"8303",2017-10-18 10:29:42,136704,1049509.25999999
"8304",2017-10-18 11:06:03,13458.72,1062967.97999999
"8305",2017-10-18 11:50:14,224597.32,1287565.29999999
"8306",2017-10-18 11:50:14,144662.63,1432227.92999999
"8307",2017-10-18 12:05:56,182455.94,1614683.86999999
"8308",2017-10-18 12:38:10,50015.61,1664699.47999999
"8309",2017-10-18 14:15:44,150015.7,1814715.17999999
"8310",2017-10-18 14:15:44,161343.93,1976059.10999999
"8311",2017-10-18 14:15:44,150015.69,2126074.79999999
"8312",2017-10-18 14:15:44,88903.68,2214978.47999999
"8313",2017-10-18 14:24:14,133692.74,2348671.21999999
"8314",2017-10-18 14:31:25,337196.98,2685868.19999999
"8315",2017-10-18 15:01:59,199787.24,2885655.43999999
"8316",2017-10-18 15:11:21,88903.76,2974559.19999999
"8317",2017-10-18 15:58:25,232638.76,3207197.95999999
"8318",2017-10-18 15:58:25,235112.59,3442310.54999999
"8319",2017-10-18 21:06:42,253690.22,3696000.76999999
"8320",2017-10-18 21:06:42,147921.98,3843922.74999999
"8321",2017-10-18 22:11:45,141311.73,3985234.47999999
"8322",2017-10-18 22:32:20,11734.08,3996968.55999999
"8323",2017-10-19 00:05:06,136298.28,4133266.83999999
"8324",2017-10-19 00:05:06,129857.15,4263123.98999999
"8325",2017-10-19 00:17:50,142060.2,4405184.18999999
"8326",2017-10-19 00:41:19,123832.11,4529016.29999999
"8327",2017-10-19 00:56:24,121628.94,4650645.23999999
"8328",2017-10-19 01:23:23,274490.14,4925135.37999999
"8329",2017-10-19 02:09:49,14769.93,4939905.30999999
"8330",2017-10-19 03:37:35,163785.13,5103690.43999999
"8331",2017-10-19 04:13:07,296551.76,5400242.19999999
"8332",2017-10-19 04:22:12,10471.4,5410713.59999999
"8333",2017-10-19 04:55:42,337204.97,5747918.56999999
"8334",2017-10-19 06:43:25,190792.98,5938711.54999999
"8335",2017-10-19 09:32:58,190884.44,6129595.98999999
"8336",2017-10-19 12:46:49,217500.42,6347096.40999999
"8337",2017-10-19 13:50:08,240392.32,6587488.72999999
"8338",2017-10-19 14:16:49,180628.51,6768117.23999999
"8339",2017-10-19 21:02:01,148850.03,6916967.26999999
"8340",2017-10-20 03:16:25,-6916967.27,-7.45058059692383e-09
"8341",2017-10-20 05:02:00,364687.85,364687.849999993
"8342",2017-10-20 05:07:32,-364687.85,-7.45058059692383e-09
"8343",2017-10-20 14:43:41,247159.7,247159.699999993
"8344",2017-10-20 14:43:41,193104.42,440264.119999993
"8345",2017-10-20 14:43:41,359298.19,799562.309999993
"8346",2017-10-20 15:01:23,347550.65,1147112.95999999
"8347",2017-10-20 15:17:11,380016.85,1527129.80999999
"8348",2017-10-20 15:44:38,438333.06,1965462.86999999
"8349",2017-10-20 16:32:18,77793.97,2043256.83999999
"8350",2017-10-20 16:34:56,37793.95,2081050.78999999
"8351",2017-10-20 16:54:36,777793.98,2858844.76999999
"8352",2017-10-20 17:00:01,381906.7,3240751.46999999
"8353",2017-10-20 17:00:01,777793.93,4018545.39999999
"8354",2017-10-20 18:31:50,90962.02,4109507.41999999
"8355",2017-10-20 18:31:50,777794.01,4887301.42999999
"8356",2017-10-21 02:30:11,650601.99,5537903.41999999
"8357",2017-10-21 12:02:45,482307.31,6020210.72999999
"8358",2017-10-21 14:33:34,368801.81,6389012.53999999
"8359",2017-10-21 14:33:34,471561.59,6860574.12999999
"8360",2017-10-21 16:56:17,237310.57,7097884.69999999
"8361",2017-10-21 17:06:44,182800.82,7280685.51999999
"8362",2017-10-21 17:22:09,235945.83,7516631.34999999
"8363",2017-10-21 17:29:39,19199.72,7535831.06999999
"8364",2017-10-21 17:48:29,254777.26,7790608.32999999
"8365",2017-10-21 17:58:56,378895.49,8169503.81999999
"8366",2017-10-21 17:58:56,9120.47,8178624.28999999
"8367",2017-10-21 18:22:29,223132.89,8401757.17999999
"8368",2017-10-21 19:20:16,217385.43,8619142.60999999
"8369",2017-10-21 20:08:39,184934.54,8804077.14999999
"8370",2017-10-21 20:08:39,184831.1,8988908.24999999
"8371",2017-10-21 22:30:37,178478.05,9167386.29999999
"8372",2017-10-22 00:38:41,279663.39,9447049.68999999
"8373",2017-10-22 01:19:08,180055.76,9627105.44999999
"8374",2017-10-22 02:16:56,204122.26,9831227.70999999
"8375",2017-10-22 02:35:15,188524.52,10019752.23
"8376",2017-10-22 10:52:14,195600.19,10215352.42
"8377",2017-10-22 11:30:34,240694.99,10456047.41
"8378",2017-10-22 11:52:14,269986.15,10726033.56
"8379",2017-10-22 11:52:14,165960.26,10891993.82
"8380",2017-10-22 12:49:46,547489.64,11439483.46
"8381",2017-10-22 22:18:45,214757.23,11654240.69
"8382",2017-10-22 23:33:20,258024.28,11912264.97
"8383",2017-10-23 15:17:52,-11912264.97,-9.31322574615479e-09
"8384",2017-10-23 15:23:56,7785.8,7785.79999999069
"8385",2017-10-23 15:30:38,-7785.8,-9.31322574615479e-09
"8386",2017-10-23 16:02:38,126654.61,126654.609999991
"8387",2017-10-23 16:02:38,192701.74,319356.349999991
"8388",2017-10-23 16:19:10,-319356.35,-9.31322574615479e-09
"8389",2017-10-23 16:54:19,131140.51,131140.509999991
"8390",2017-10-23 16:59:30,-131140.51,-9.31322574615479e-09
"8391",2017-10-23 17:22:52,221597.3,221597.299999991
"8392",2017-10-23 17:22:52,212349.84,433947.139999991
"8393",2017-10-23 17:29:20,-433947.14,-9.31322574615479e-09
"8394",2017-10-23 18:18:24,125218.56,125218.559999991
"8395",2017-10-23 18:29:30,-125218.56,-9.31322574615479e-09
"8396",2017-10-23 19:57:08,179065.78,179065.779999991
"8397",2017-10-23 19:57:08,330847.35,509913.129999991
"8398",2017-10-23 20:16:22,177795.68,687708.809999991
"8399",2017-10-23 20:16:22,605537.46,1293246.26999999
"8400",2017-10-23 20:16:22,-509913.13,783333.139999991
"8401",2017-10-23 20:23:05,-783333.14,-9.31322574615479e-09
"8402",2017-10-23 20:37:16,194853.72,194853.719999991
"8403",2017-10-23 20:39:23,147047.06,341900.779999991
"8404",2017-10-23 20:52:25,166396.46,508297.239999991
"8405",2017-10-23 20:52:25,-341900.78,166396.459999991
"8406",2017-10-23 20:59:38,-166396.46,-9.34232957661152e-09
"8407",2017-10-23 21:19:02,133582.49,133582.489999991
"8408",2017-10-23 21:30:55,-133582.49,-9.34232957661152e-09
"8409",2017-10-23 21:33:03,179655.81,179655.809999991
"8410",2017-10-23 21:36:34,-179655.81,-9.34232957661152e-09
"8411",2017-10-23 23:18:38,189251.11,189251.109999991
"8412",2017-10-23 23:18:38,338111.37,527362.479999991
"8413",2017-10-23 23:18:38,177795.8,705158.279999991
"8414",2017-10-23 23:31:27,-705158.28,-9.31322574615479e-09
"8415",2017-10-24 00:02:16,343836.99,343836.989999991
"8416",2017-10-24 00:11:30,-343836.99,-9.31322574615479e-09
"8417",2017-10-24 01:34:36,308629.32,308629.319999991
"8418",2017-10-24 01:43:21,-308629.32,-9.31322574615479e-09
"8419",2017-10-24 01:58:10,164056.99,164056.989999991
"8420",2017-10-24 02:11:30,-164056.99,-9.31322574615479e-09
"8421",2017-10-24 02:36:36,120111.32,120111.319999991
"8422",2017-10-24 02:43:25,-120111.32,-9.31322574615479e-09
"8423",2017-10-24 02:53:29,195642.46,195642.459999991
"8424",2017-10-24 03:00:01,167177.02,362819.479999991
"8425",2017-10-24 03:00:01,-195642.46,167177.019999991
"8426",2017-10-24 03:03:35,-167177.02,-9.31322574615479e-09
"8427",2017-10-24 03:21:01,173937.34,173937.339999991
"8428",2017-10-24 03:31:06,-173937.34,-9.31322574615479e-09
"8429",2017-10-24 03:49:32,180327.67,180327.669999991
"8430",2017-10-24 03:53:41,-180327.67,-9.31322574615479e-09
"8431",2017-10-24 04:39:03,191533.79,191533.789999991
"8432",2017-10-24 04:45:51,-191533.79,-9.31322574615479e-09
"8433",2017-10-24 05:32:45,140694.61,140694.609999991
"8434",2017-10-24 05:32:45,134683.21,275377.819999991
"8435",2017-10-24 05:32:45,157119.3,432497.119999991
"8436",2017-10-24 05:32:45,4940.36,437437.479999991
"8437",2017-10-24 05:41:57,10994.26,448431.739999991
"8438",2017-10-24 05:41:57,-437437.48,10994.2599999906
"8439",2017-10-24 05:46:40,-10994.26,-9.36233846005052e-09
"8440",2017-10-24 08:07:07,214850.5,214850.499999991
"8441",2017-10-24 08:07:07,177795.97,392646.469999991
"8442",2017-10-24 08:07:07,188906.82,581553.289999991
"8443",2017-10-24 08:15:27,175641.36,757194.649999991
"8444",2017-10-24 08:15:27,-581553.29,175641.359999991
"8445",2017-10-24 08:24:03,-175641.36,-9.31322574615479e-09
"8446",2017-10-24 09:09:08,366373.19,366373.189999991
"8447",2017-10-24 09:26:56,-366373.19,-9.31322574615479e-09
"8448",2017-10-24 11:36:25,222469.95,222469.949999991
"8449",2017-10-24 12:07:06,-222469.95,-9.31322574615479e-09
"8450",2017-10-24 14:01:37,312133.06,312133.059999991
"8451",2017-10-24 14:27:02,-312133.06,-9.31322574615479e-09
"8452",2017-10-24 15:01:36,194306.87,194306.869999991
"8453",2017-10-24 15:10:19,187569.05,381875.919999991
"8454",2017-10-24 15:10:19,-194306.87,187569.049999991
"8455",2017-10-24 15:14:42,-187569.05,-9.31322574615479e-09
"8456",2017-10-24 16:13:59,311088.33,311088.329999991
"8457",2017-10-24 16:38:57,-311088.33,-9.31322574615479e-09
"8458",2017-10-24 19:10:47,216499.89,216499.889999991
"8459",2017-10-24 19:38:02,-216499.89,-9.31322574615479e-09
"8460",2017-10-24 19:49:32,307481.77,307481.769999991
"8461",2017-10-24 19:55:09,-307481.77,-9.31322574615479e-09
"8462",2017-10-24 21:35:57,218804.51,218804.509999991
"8463",2017-10-24 21:42:34,-218804.51,-9.31322574615479e-09
"8464",2017-10-24 22:39:20,197562.3,197562.299999991
"8465",2017-10-24 22:52:17,-197562.3,-9.31322574615479e-09
"8466",2017-10-25 02:08:04,214466.05,214466.049999991
"8467",2017-10-25 02:22:16,-214466.05,-9.31322574615479e-09
"8468",2017-10-25 03:12:50,220459.55,220459.549999991
"8469",2017-10-25 03:19:55,241097.36,461556.909999991
"8470",2017-10-25 03:19:55,-220459.55,241097.359999991
"8471",2017-10-25 03:32:13,-241097.36,-9.31322574615479e-09
"8472",2017-10-25 04:03:59,230206.88,230206.879999991
"8473",2017-10-25 04:12:07,-230206.88,-9.31322574615479e-09
"8474",2017-10-25 04:52:38,175899.03,175899.029999991
"8475",2017-10-25 05:13:56,-175899.03,-9.31322574615479e-09
"8476",2017-10-25 05:21:16,12894,12893.9999999907
"8477",2017-10-25 05:43:29,-12894,-9.31322574615479e-09
"8478",2017-10-25 05:50:06,170414.08,170414.079999991
"8479",2017-10-25 06:14:57,-170414.08,-9.31322574615479e-09
"8480",2017-10-25 06:51:18,211101.38,211101.379999991
"8481",2017-10-25 14:19:58,172782.64,383884.019999991
"8482",2017-10-25 15:36:23,166804.09,550688.109999991
"8483",2017-10-25 16:04:49,280190.11,830878.219999991
"8484",2017-10-25 21:27:36,169610.62,1000488.83999999
"8485",2017-10-25 21:43:56,221676.11,1222164.94999999
"8486",2017-10-26 00:13:16,201837.11,1424002.05999999
"8487",2017-10-26 04:04:24,174040.75,1598042.80999999
"8488",2017-10-26 06:31:40,182722.72,1780765.52999999
"8489",2017-10-26 09:24:20,192130.64,1972896.16999999
"8490",2017-10-26 11:23:26,199198.24,2172094.40999999
"8491",2017-10-26 11:28:01,188071.19,2360165.59999999
"8492",2017-10-26 12:06:29,210627.93,2570793.52999999
"8493",2017-10-26 12:06:29,171159.65,2741953.17999999
"8494",2017-10-26 12:14:22,226399.63,2968352.80999999
"8495",2017-10-26 12:53:07,166867.08,3135219.88999999
"8496",2017-10-26 13:02:22,289268.36,3424488.24999999
"8497",2017-10-26 13:39:19,209155.29,3633643.53999999
"8498",2017-10-26 13:50:25,282506.63,3916150.16999999
"8499",2017-10-26 13:58:12,264373.2,4180523.36999999
"8500",2017-10-26 14:21:22,300020.65,4480544.01999999
"8501",2017-10-26 19:18:02,219024.71,4699568.72999999
"8502",2017-10-26 21:12:47,314229.77,5013798.49999999
"8503",2017-10-26 21:25:15,268768.36,5282566.85999999
"8504",2017-10-26 22:37:34,219966.55,5502533.40999999
"8505",2017-10-27 01:17:18,301564.65,5804098.05999999
"8506",2017-10-27 01:17:18,264292.45,6068390.50999999
"8507",2017-10-27 01:17:18,193244.38,6261634.88999999
"8508",2017-10-27 05:25:08,257335.87,6518970.75999999
"8509",2017-10-27 05:44:24,163335.53,6682306.28999999
"8510",2017-10-27 09:19:49,172741.59,6855047.87999999
"8511",2017-10-27 09:43:14,155975.1,7011022.97999999
"8512",2017-10-27 12:33:56,161097.52,7172120.49999999
"8513",2017-10-28 11:22:18,201732.02,7373852.51999999
"8514",2017-10-28 21:40:42,-7373852.52,-9.31322574615479e-09
"8515",2017-10-29 05:52:46,199566.51,199566.509999991
"8516",2017-10-29 06:42:54,-199566.51,-9.31322574615479e-09
"8517",2017-10-29 06:51:00,252644.08,252644.079999991
"8518",2017-10-29 06:58:14,-252644.08,-9.31322574615479e-09
"8519",2017-10-29 07:07:10,267095.08,267095.079999991
"8520",2017-10-29 07:09:23,-267095.08,-9.31322574615479e-09
"8521",2017-10-29 07:37:38,156128.13,156128.129999991
"8522",2017-10-29 07:37:38,194982.31,351110.439999991
"8523",2017-10-29 07:41:07,-351110.44,-9.31322574615479e-09
"8524",2017-10-29 09:27:19,170724.34,170724.339999991
"8525",2017-10-29 09:48:50,172668.98,343393.319999991
"8526",2017-10-29 11:05:45,354345.44,697738.759999991
"8527",2017-10-29 11:49:10,563204.49,1260943.24999999
"8528",2017-10-29 11:51:59,188909.89,1449853.13999999
"8529",2017-10-29 13:42:56,535815.72,1985668.85999999
"8530",2017-10-29 16:36:27,777798.98,2763467.83999999
"8531",2017-10-29 16:36:27,777798.96,3541266.79999999
"8532",2017-10-29 17:31:59,559817.44,4101084.23999999
"8533",2017-10-29 17:52:00,615340.33,4716424.56999999
"8534",2017-10-29 20:00:04,351466.99,5067891.55999999
"8535",2017-10-29 20:37:17,50022.32,5117913.87999999
"8536",2017-10-29 21:17:57,300022.92,5417936.79999999
"8537",2017-10-29 21:45:16,177799.34,5595736.13999999
"8538",2017-10-29 21:57:39,771725.35,6367461.48999999
"8539",2017-10-29 21:57:39,777800.34,7145261.82999999
"8540",2017-10-29 22:33:16,777800.37,7923062.19999999
"8541",2017-10-29 22:33:16,102985.38,8026047.57999999
"8542",2017-10-29 23:28:59,88910.29,8114957.86999999
"8543",2017-10-30 04:03:01,612126.82,8727084.68999999
"8544",2017-10-30 05:10:28,597326.21,9324410.89999999
"8545",2017-10-30 13:14:28,522571.01,9846981.90999999
"8546",2017-10-31 14:40:06,579953.59,10426935.5
"8547",2017-10-31 16:24:44,-10426935.5,-9.31322574615479e-09
"8548",2017-10-31 21:02:22,428960.96,428960.959999991
"8549",2017-10-31 21:30:22,293460.48,722421.439999991
"8550",2017-10-31 21:30:22,-428960.96,293460.479999991
"8551",2017-10-31 21:41:39,-293460.48,-9.37143340706825e-09
"8552",2017-11-01 07:05:14,254697.95,254697.949999991
"8553",2017-11-01 07:12:14,-254697.95,-9.37143340706825e-09
"8554",2017-11-01 07:34:07,288861.7,288861.699999991
"8555",2017-11-01 07:47:28,-288861.7,-9.37143340706825e-09
"8556",2017-11-01 08:16:51,464366.54,464366.539999991
"8557",2017-11-01 08:23:18,-464366.54,-9.37143340706825e-09
"8558",2017-11-01 09:46:18,523768.69,523768.689999991
"8559",2017-11-01 09:51:23,-523768.69,-9.37143340706825e-09
"8560",2017-11-01 11:16:47,432395.37,432395.369999991
"8561",2017-11-01 11:22:23,-432395.37,-9.37143340706825e-09
"8562",2017-11-01 20:14:09,193806.07,193806.069999991
"8563",2017-11-02 00:02:35,268160.01,461966.079999991
"8564",2017-11-02 00:41:42,188913.32,650879.399999991
"8565",2017-11-02 00:41:42,88913.33,739792.729999991
"8566",2017-11-02 02:21:17,211410.96,951203.689999991
"8567",2017-11-02 02:25:13,162136.76,1113340.44999999
"8568",2017-11-02 03:18:47,107234.51,1220574.95999999
"8569",2017-11-02 03:44:37,72909.53,1293484.48999999
"8570",2017-11-02 03:44:37,65968.73,1359453.21999999
"8571",2017-11-02 05:03:04,134757.97,1494211.18999999
"8572",2017-11-02 05:30:40,77802.43,1572013.61999999
"8573",2017-11-02 07:29:58,4423.56,1576437.17999999
"8574",2017-11-02 07:29:58,3628.45,1580065.62999999
"8575",2017-11-02 07:48:32,177802.67,1757868.29999999
"8576",2017-11-02 08:12:04,96312.93,1854181.22999999
"8577",2017-11-02 08:39:45,-1854181.23,-9.77888703346252e-09
"8578",2017-11-02 08:54:35,124335.85,124335.84999999
"8579",2017-11-02 08:54:35,100025.71,224361.55999999
"8580",2017-11-02 09:07:14,-224361.56,-9.77888703346252e-09
"8581",2017-11-02 09:07:14,300025.64,300025.63999999
"8582",2017-11-02 09:12:37,-300025.64,-9.77888703346252e-09
"8583",2017-11-02 09:27:29,146141.7,146141.69999999
"8584",2017-11-02 09:28:34,38247.87,184389.56999999
"8585",2017-11-02 09:56:05,-184389.57,-9.77888703346252e-09
"8586",2017-11-02 09:56:05,174077.28,174077.27999999
"8587",2017-11-02 10:00:31,-174077.28,-9.77888703346252e-09
"8588",2017-11-02 10:01:43,55580.72,55580.7199999902
"8589",2017-11-02 10:07:54,-55580.72,-9.77888703346252e-09
"8590",2017-11-02 10:15:38,3686.52,3686.51999999022
"8591",2017-11-02 10:19:35,-3686.52,-9.77888703346252e-09
"8592",2017-11-02 10:29:57,4078.87,4078.86999999022
"8593",2017-11-02 10:29:57,34594.47,38673.3399999902
"8594",2017-11-02 10:43:09,-38673.34,-9.77161107584834e-09
"8595",2017-11-02 11:09:43,37802.92,37802.9199999902
"8596",2017-11-02 11:20:45,935.57,38738.4899999902
"8597",2017-11-02 11:20:45,-37802.92,935.569999990228
"8598",2017-11-02 11:24:21,1939.83,2875.39999999023
"8599",2017-11-02 11:24:21,-935.57,1939.82999999023
"8600",2017-11-02 11:38:05,-1939.83,-9.77206582319923e-09
"8601",2017-11-02 11:50:15,120426.82,120426.81999999
"8602",2017-11-02 11:52:25,-120426.82,-9.77888703346252e-09
"8603",2017-11-02 12:06:38,42566.63,42566.6299999902
"8604",2017-11-02 12:06:38,77803,120369.62999999
"8605",2017-11-02 12:28:36,-120369.63,-9.77888703346252e-09
"8606",2017-11-02 12:28:36,77803.07,77803.0699999902
"8607",2017-11-02 12:28:36,88914.1,166717.16999999
"8608",2017-11-02 12:52:05,82446.22,249163.38999999
"8609",2017-11-02 12:52:05,18582.43,267745.81999999
"8610",2017-11-02 12:52:05,-166717.17,101028.64999999
"8611",2017-11-02 13:02:56,-101028.65,-9.77888703346252e-09
"8612",2017-11-02 13:23:54,178081.52,178081.51999999
"8613",2017-11-02 13:31:11,98942.38,277023.89999999
"8614",2017-11-02 13:31:11,-178081.52,98942.3799999903
"8615",2017-11-02 13:41:02,105873.25,204815.62999999
"8616",2017-11-02 13:41:02,-98942.38,105873.24999999
"8617",2017-11-02 13:45:23,-105873.25,-9.74978320300579e-09
"8618",2017-11-02 13:51:31,205449.43,205449.42999999
"8619",2017-11-02 13:55:24,-205449.43,-9.74978320300579e-09
"8620",2017-11-02 14:08:35,98990.44,98990.4399999903
"8621",2017-11-02 14:08:35,91371.18,190361.61999999
"8622",2017-11-02 14:08:35,3411.36,193772.97999999
"8623",2017-11-02 14:22:56,140647.25,334420.22999999
"8624",2017-11-02 14:22:56,-193772.98,140647.24999999
"8625",2017-11-02 14:34:13,101599.63,242246.87999999
"8626",2017-11-02 14:34:13,-140647.25,101599.62999999
"8627",2017-11-02 14:34:13,77803.12,179402.74999999
"8628",2017-11-02 14:37:11,75904.09,255306.83999999
"8629",2017-11-02 14:44:37,66508.09,321814.92999999
"8630",2017-11-02 14:44:37,102458.58,424273.50999999
"8631",2017-11-02 14:44:37,-255306.84,168966.66999999
"8632",2017-11-02 15:29:50,143811.61,312778.27999999
"8633",2017-11-02 15:29:50,137803.39,450581.66999999
"8634",2017-11-02 15:29:50,-168966.67,281614.99999999
"8635",2017-11-02 15:39:39,21043.8,302658.79999999
"8636",2017-11-02 15:39:39,-281615,21043.7999999901
"8637",2017-11-02 16:05:22,83841.86,104885.65999999
"8638",2017-11-02 16:05:22,139449.53,244335.18999999
"8639",2017-11-02 16:05:22,-21043.8,223291.38999999
"8640",2017-11-02 16:22:57,180581.95,403873.33999999
"8641",2017-11-02 16:22:57,-223291.39,180581.94999999
"8642",2017-11-02 16:46:25,157379.54,337961.48999999
"8643",2017-11-02 16:46:25,81122.12,419083.60999999
"8644",2017-11-02 16:46:25,-180581.95,238501.65999999
"8645",2017-11-02 16:54:46,-238501.66,-9.92440618574619e-09
"8646",2017-11-02 17:08:06,200026.52,200026.51999999
"8647",2017-11-02 17:23:51,84623.1,284649.61999999
"8648",2017-11-02 17:23:51,177803.55,462453.16999999
"8649",2017-11-02 17:23:51,-200026.52,262426.64999999
"8650",2017-11-02 17:40:51,181686.82,444113.46999999
"8651",2017-11-02 17:40:51,-262426.65,181686.81999999
"8652",2017-11-02 17:49:04,85963.1,267649.91999999
"8653",2017-11-02 17:49:04,-181686.82,85963.0999999901
"8654",2017-11-02 18:01:45,-85963.1,-9.86619852483273e-09
"8655",2017-11-02 18:26:30,77803.37,77803.3699999901
"8656",2017-11-02 18:38:53,-77803.37,-9.86619852483273e-09
"8657",2017-11-02 19:06:27,124081.56,124081.55999999
"8658",2017-11-02 19:06:27,118425.82,242507.37999999
"8659",2017-11-02 19:33:03,84003.37,326510.74999999
"8660",2017-11-02 19:33:03,-242507.38,84003.3699999901
"8661",2017-11-02 19:37:27,-84003.37,-9.89530235528946e-09
"8662",2017-11-02 19:45:16,75655.47,75655.4699999901
"8663",2017-11-02 19:45:16,101089.43,176744.89999999
"8664",2017-11-02 20:07:08,123556.9,300301.79999999
"8665",2017-11-02 20:07:08,-176744.9,123556.89999999
"8666",2017-11-02 20:10:14,-123556.9,-9.89530235528946e-09
"8667",2017-11-02 20:17:36,100237.65,100237.64999999
"8668",2017-11-02 20:25:08,265860.44,366098.08999999
"8669",2017-11-02 20:25:08,-100237.65,265860.43999999
"8670",2017-11-02 20:25:08,-100237.65,165622.78999999
"8671",2017-11-02 20:28:31,-165622.79,-9.95351001620293e-09
"8672",2017-11-02 23:06:29,165039.01,165039.00999999
"8673",2017-11-02 23:06:29,180256.97,345295.97999999
"8674",2017-11-02 23:19:01,-345295.98,-9.89530235528946e-09
"8675",2017-11-03 00:11:29,181887.45,181887.44999999
"8676",2017-11-03 00:11:29,115426.21,297313.65999999
"8677",2017-11-03 00:21:51,-297313.66,-9.83709469437599e-09
"8678",2017-11-03 00:27:00,234449.95,234449.94999999
"8679",2017-11-03 00:47:44,163322.54,397772.48999999
"8680",2017-11-03 00:47:44,-234449.95,163322.53999999
"8681",2017-11-03 00:51:26,-163322.54,-9.80799086391926e-09
"8682",2017-11-03 02:18:22,130572.62,130572.61999999
"8683",2017-11-03 03:02:09,-130572.62,-9.80799086391926e-09
"8684",2017-11-03 03:48:27,225231.15,225231.14999999
"8685",2017-11-03 03:48:27,326594.82,551825.96999999
"8686",2017-11-03 04:11:48,-551825.97,-9.77888703346252e-09
"8687",2017-11-03 09:12:47,777807.1,777807.09999999
"8688",2017-11-03 09:12:47,20749.11,798556.20999999
"8689",2017-11-03 09:45:47,23029.72,821585.92999999
"8690",2017-11-03 10:12:43,300030.17,1121616.09999999
"8691",2017-11-03 11:21:28,436201.88,1557817.97999999
"8692",2017-11-03 11:26:11,251207.58,1809025.55999999
"8693",2017-11-03 13:01:33,161410.03,1970435.58999999
"8694",2017-11-03 13:23:52,300030.31,2270465.89999999
"8695",2017-11-03 14:07:28,300030.35,2570496.24999999
"8696",2017-11-03 14:35:28,191178.99,2761675.23999999
"8697",2017-11-03 16:03:29,300030.4,3061705.63999999
"8698",2017-11-03 16:03:29,300030.42,3361736.05999999
"8699",2017-11-03 18:24:11,133527.79,3495263.84999999
"8700",2017-11-03 18:24:11,157189.15,3652452.99999999
"8701",2017-11-03 18:52:28,137807.54,3790260.53999999
"8702",2017-11-03 19:59:34,300030.55,4090291.08999999
"8703",2017-11-03 20:50:13,77807.59,4168098.67999999
"8704",2017-11-03 21:18:25,88918.63,4257017.30999999
"8705",2017-11-03 21:45:04,88918.7,4345936.00999999
"8706",2017-11-03 21:45:04,397212.76,4743148.76999999
"8707",2017-11-03 22:27:39,200030.76,4943179.52999999
"8708",2017-11-03 22:27:39,77807.62,5020987.14999999
"8709",2017-11-03 22:34:40,179801.77,5200788.91999999
"8710",2017-11-03 23:37:45,195489.19,5396278.10999999
"8711",2017-11-03 23:44:47,177807.83,5574085.93999999
"8712",2017-11-03 23:49:38,177807.85,5751893.78999999
"8713",2017-11-04 01:00:36,192467.83,5944361.61999999
"8714",2017-11-04 01:00:36,122254.97,6066616.58999999
"8715",2017-11-04 01:00:36,98704.66,6165321.24999999
"8716",2017-11-04 01:44:44,310480.35,6475801.59999999
"8717",2017-11-04 01:44:44,130811.91,6606613.50999999
"8718",2017-11-04 02:05:22,197506.58,6804120.08999999
"8719",2017-11-04 02:28:27,223216.26,7027336.34999999
"8720",2017-11-04 03:15:18,150031.02,7177367.36999999
"8721",2017-11-04 03:15:18,153077.84,7330445.20999999
"8722",2017-11-04 03:53:55,123115.94,7453561.14999999
"8723",2017-11-04 03:53:55,148960.1,7602521.24999999
"8724",2017-11-04 04:17:35,118025.48,7720546.72999999
"8725",2017-11-04 04:17:35,377808.1,8098354.82999999
"8726",2017-11-04 05:03:03,377808.14,8476162.96999999
"8727",2017-11-04 05:03:03,78809.12,8554972.08999999
"8728",2017-11-04 05:03:03,140698.31,8695670.39999999
"8729",2017-11-04 05:24:16,200031.16,8895701.55999999
"8730",2017-11-04 06:44:19,163668.93,9059370.48999999
"8731",2017-11-04 07:23:00,250031.21,9309401.69999999
"8732",2017-11-04 07:23:00,111298.67,9420700.36999999
"8733",2017-11-04 07:33:21,136670.38,9557370.74999999
"8734",2017-11-04 07:33:21,-9420700.37,136670.37999999
"8735",2017-11-04 07:40:47,-136670.38,-1.03609636425972e-08
"8736",2017-11-04 07:43:22,158827.31,158827.30999999
"8737",2017-11-04 07:49:56,377808.27,536635.57999999
"8738",2017-11-04 07:49:56,209199.98,745835.55999999
"8739",2017-11-04 07:49:56,-158827.31,587008.24999999
"8740",2017-11-04 07:49:56,-158827.31,428180.93999999
"8741",2017-11-04 08:17:42,-428180.94,-1.04773789644241e-08
"8742",2017-11-04 09:22:45,110939.09,110939.08999999
"8743",2017-11-04 09:36:15,377808.31,488747.39999999
"8744",2017-11-04 09:36:15,-110939.09,377808.30999999
"8745",2017-11-04 09:43:16,-377808.31,-1.04191713035107e-08
"8746",2017-11-04 09:59:35,122042.82,122042.81999999
"8747",2017-11-04 10:07:28,300031.34,422074.15999999
"8748",2017-11-04 10:07:28,-122042.82,300031.33999999
"8749",2017-11-04 10:11:40,-300031.34,-1.04191713035107e-08
"8750",2017-11-04 11:11:50,387505.82,387505.81999999
"8751",2017-11-04 11:44:41,115057.8,502563.61999999
"8752",2017-11-04 11:44:41,377808.41,880372.02999999
"8753",2017-11-04 11:44:41,171403.37,1051775.39999999
"8754",2017-11-04 11:44:41,-387505.82,664269.57999999
"8755",2017-11-04 11:44:41,-387505.82,276763.75999999
"8756",2017-11-04 11:44:41,123702.7,400466.45999999
"8757",2017-11-04 12:26:52,186431.31,586897.76999999
"8758",2017-11-04 12:26:52,216648.71,803546.47999999
"8759",2017-11-04 12:26:52,-400466.46,403080.019999989
"8760",2017-11-04 12:30:01,-403080.02,-1.05355866253376e-08
"8761",2017-11-04 12:33:16,314481.03,314481.029999989
"8762",2017-11-04 12:41:32,300031.51,614512.53999999
"8763",2017-11-04 12:41:32,-314481.03,300031.50999999
"8764",2017-11-04 12:47:06,-300031.51,-1.04773789644241e-08
"8765",2017-11-04 13:27:16,230518.31,230518.30999999
"8766",2017-11-04 13:27:16,166995.01,397513.31999999
"8767",2017-11-04 13:49:07,144316.81,541830.12999999
"8768",2017-11-04 13:49:07,172866.76,714696.88999999
"8769",2017-11-04 13:49:07,154358.07,869054.959999989
"8770",2017-11-04 13:49:07,-397513.32,471541.639999989
"8771",2017-11-04 13:57:11,236383.31,707924.949999989
"8772",2017-11-04 13:57:11,-471541.64,236383.309999989
"8773",2017-11-04 13:57:11,7090.94,243474.249999989
"8774",2017-11-04 14:14:15,243052.8,486527.049999989
"8775",2017-11-04 14:14:15,267145.01,753672.059999989
"8776",2017-11-04 14:14:15,199960.63,953632.689999989
"8777",2017-11-04 14:14:15,-243474.25,710158.439999989
"8778",2017-11-04 14:14:15,-243474.25,466684.189999989
"8779",2017-11-04 14:19:14,-466684.19,-1.05355866253376e-08
"8780",2017-11-04 14:25:16,239542.08,239542.079999989
"8781",2017-11-04 14:34:21,155506.33,395048.409999989
"8782",2017-11-04 14:34:21,-239542.08,155506.329999989
"8783",2017-11-04 14:36:03,186962.23,342468.559999989
"8784",2017-11-04 14:44:06,300031.73,642500.289999989
"8785",2017-11-04 14:44:06,-342468.56,300031.729999989
"8786",2017-11-04 14:52:59,-300031.73,-1.05355866253376e-08
"8787",2017-11-04 15:15:53,152115.45,152115.449999989
"8788",2017-11-04 15:57:56,193343.13,345458.579999989
"8789",2017-11-04 15:57:56,172028.54,517487.11999999
"8790",2017-11-04 15:57:56,-152115.45,365371.66999999
"8791",2017-11-04 16:14:52,233805.37,599177.03999999
"8792",2017-11-04 16:14:52,300031.8,899208.83999999
"8793",2017-11-04 16:14:52,-365371.67,533837.16999999
"8794",2017-11-04 16:27:18,-533837.17,-1.03609636425972e-08
"8795",2017-11-04 16:38:23,357801.24,357801.23999999
"8796",2017-11-04 16:42:23,-357801.24,-1.03609636425972e-08
"8797",2017-11-04 20:22:47,77810.03,77810.0299999896
"8798",2017-11-04 20:35:22,-77810.03,-1.03609636425972e-08
"8799",2017-11-04 22:56:04,777811.38,777811.37999999
"8800",2017-11-04 22:56:04,573229.39,1351040.76999999
"8801",2017-11-04 23:03:51,-1351040.77,-1.02445483207703e-08
"8802",2017-11-04 23:26:28,351273.41,351273.40999999
"8803",2017-11-04 23:33:21,-351273.41,-1.02445483207703e-08
"8804",2017-11-04 23:44:35,504337.89,504337.88999999
"8805",2017-11-05 00:07:46,-504337.89,-1.02445483207703e-08
"8806",2017-11-05 01:47:38,237021.69,237021.68999999
"8807",2017-11-05 01:57:28,-237021.69,-1.02445483207703e-08
"8808",2017-11-05 02:22:09,252541.48,252541.47999999
"8809",2017-11-05 02:28:47,-252541.48,-1.02445483207703e-08
"8810",2017-11-05 13:33:15,177812.86,177812.85999999
"8811",2017-11-05 13:38:19,-177812.86,-1.02445483207703e-08
"8812",2017-11-06 01:13:44,303511.59,303511.58999999
"8813",2017-11-06 08:50:21,-303511.59,-1.02445483207703e-08
"8814",2017-11-06 10:01:52,28162.69,28162.6899999898
"8815",2017-11-06 10:08:59,-28162.69,-1.02445483207703e-08
"8816",2017-11-06 11:08:01,209796.35,209796.34999999
"8817",2017-11-06 11:17:06,-209796.35,-1.02445483207703e-08
"8818",2017-11-06 12:08:26,355953.6,355953.59999999
"8819",2017-11-06 12:08:26,325087.97,681041.56999999
"8820",2017-11-06 12:18:09,-681041.57,-1.02445483207703e-08
"8821",2017-11-06 13:05:45,361537.39,361537.38999999
"8822",2017-11-06 14:00:11,280875.87,642413.25999999
"8823",2017-11-06 14:00:11,-361537.39,280875.86999999
"8824",2017-11-06 14:15:58,-280875.87,-1.02445483207703e-08
"8825",2017-11-06 22:04:31,219942.36,219942.35999999
"8826",2017-11-07 00:03:00,6130.28,226072.63999999
"8827",2017-11-07 00:03:00,10859.34,236931.97999999
"8828",2017-11-07 00:09:22,122570.5,359502.47999999
"8829",2017-11-07 00:11:56,77816,437318.47999999
"8830",2017-11-07 00:11:56,88927.01,526245.48999999
"8831",2017-11-07 00:11:56,75039.02,601284.50999999
"8832",2017-11-07 00:11:56,78826.04,680110.54999999
"8833",2017-11-07 00:38:36,206525.26,886635.80999999
"8834",2017-11-07 00:56:29,150307.76,1036943.56999999
"8835",2017-11-07 01:28:40,174224.89,1211168.45999999
"8836",2017-11-07 01:56:50,153725.69,1364894.14999999
"8837",2017-11-07 01:56:50,8340.48,1373234.62999999
"8838",2017-11-07 02:25:01,186414.52,1559649.14999999
"8839",2017-11-07 03:36:03,158826.3,1718475.44999999
"8840",2017-11-07 04:46:23,157683.24,1876158.68999999
"8841",2017-11-07 04:46:23,196833.79,2072992.47999999
"8842",2017-11-07 04:46:23,300039.2,2373031.67999999
"8843",2017-11-07 07:26:08,134306.65,2507338.32999999
"8844",2017-11-07 08:47:58,148131.3,2655469.62999999
"8845",2017-11-07 08:51:00,50039.26,2705508.88999999
"8846",2017-11-07 15:18:52,121580.2,2827089.08999999
"8847",2017-11-07 15:18:52,122494.93,2949584.01999999
"8848",2017-11-07 16:45:47,142767.03,3092351.04999999
"8849",2017-11-07 16:45:47,125875.36,3218226.40999999
"8850",2017-11-07 17:17:29,144833.54,3363059.94999999
"8851",2017-11-07 21:19:19,77818.55,3440878.49999999
"8852",2017-11-07 22:50:01,437902.54,3878781.03999999
"8853",2017-11-07 22:58:35,77819.41,3956600.44999999
"8854",2017-11-07 23:29:48,199760.95,4156361.39999999
"8855",2017-11-08 00:15:50,188651.93,4345013.32999999
"8856",2017-11-08 00:55:06,144056.6,4489069.92999999
"8857",2017-11-08 02:03:49,162145.88,4651215.80999999
"8858",2017-11-08 02:03:49,232476.66,4883692.46999999
"8859",2017-11-08 02:03:49,275594.3,5159286.76999999
"8860",2017-11-08 02:50:36,327811.55,5487098.31999999
"8861",2017-11-08 03:33:07,170972.46,5658070.77999999
"8862",2017-11-08 03:33:07,167327.73,5825398.50999999
"8863",2017-11-08 03:40:15,200025.52,6025424.02999999
"8864",2017-11-08 04:20:06,165542.51,6190966.53999999
"8865",2017-11-08 05:11:36,194416.98,6385383.51999999
"8866",2017-11-08 05:18:31,77818.57,6463202.08999999
"8867",2017-11-08 06:23:31,223238.92,6686441.00999999
"8868",2017-11-08 06:59:06,-6686441.01,-1.02445483207703e-08
"8869",2017-11-08 07:07:41,271376.03,271376.02999999
"8870",2017-11-08 07:21:07,-271376.03,-1.02445483207703e-08
"8871",2017-11-08 08:02:57,170693.54,170693.53999999
"8872",2017-11-08 08:08:02,-170693.54,-1.02445483207703e-08
"8873",2017-11-08 08:50:18,157988.13,157988.12999999
"8874",2017-11-08 08:55:52,-157988.13,-1.02445483207703e-08
"8875",2017-11-08 09:14:07,168986.47,168986.46999999
"8876",2017-11-08 09:21:29,-168986.47,-1.02445483207703e-08
"8877",2017-11-08 10:01:34,177193.55,177193.54999999
"8878",2017-11-08 10:20:33,-177193.55,-1.02445483207703e-08
"8879",2017-11-08 11:40:25,203473.43,203473.42999999
"8880",2017-11-08 11:48:44,-203473.43,-1.02445483207703e-08
"8881",2017-11-08 12:01:27,296204.69,296204.68999999
"8882",2017-11-08 12:09:28,-296204.69,-1.02445483207703e-08
"8883",2017-11-08 12:28:10,294716.52,294716.51999999
"8884",2017-11-08 12:28:10,167778.78,462495.29999999
"8885",2017-11-08 12:36:10,201489.95,663985.24999999
"8886",2017-11-08 12:36:10,-462495.3,201489.94999999
"8887",2017-11-08 12:45:44,193594.75,395084.69999999
"8888",2017-11-08 12:45:44,-201489.95,193594.74999999
"8889",2017-11-08 12:53:46,-193594.75,-1.02445483207703e-08
"8890",2017-11-08 13:42:31,296642.2,296642.19999999
"8891",2017-11-08 13:48:35,-296642.2,-1.02445483207703e-08
"8892",2017-11-08 14:25:15,199243.56,199243.55999999
"8893",2017-11-08 14:25:15,223563.56,422807.11999999
"8894",2017-11-08 14:25:15,174972.38,597779.49999999
"8895",2017-11-08 14:25:15,185751.58,783531.07999999
"8896",2017-11-08 14:39:19,378723.77,1162254.84999999
"8897",2017-11-08 14:39:19,323333.59,1485588.43999999
"8898",2017-11-08 14:39:19,-783531.08,702057.35999999
"8899",2017-11-08 15:00:18,387193.96,1089251.31999999
"8900",2017-11-08 15:00:18,-702057.36,387193.95999999
"8901",2017-11-08 15:08:20,-387193.96,-9.95351001620293e-09
"8902",2017-11-08 15:21:00,301499.33,301499.32999999
"8903",2017-11-08 15:30:38,-301499.33,-9.95351001620293e-09
"8904",2017-11-08 16:03:18,319673.33,319673.32999999
"8905",2017-11-08 16:25:40,-319673.33,-9.95351001620293e-09
"8906",2017-11-08 17:14:45,77820.47,77820.46999999
"8907",2017-11-08 17:14:45,88931.5,166751.96999999
"8908",2017-11-08 17:28:50,-166751.97,-9.95351001620293e-09
"8909",2017-11-08 21:25:46,30045.09,30045.08999999
"8910",2017-11-08 21:46:03,-30045.09,-9.95351001620293e-09
"8911",2017-11-08 23:51:00,777822.93,777822.92999999
"8912",2017-11-09 00:02:53,777822.96,1555645.88999999
"8913",2017-11-09 00:02:53,-777822.93,777822.95999999
"8914",2017-11-09 00:21:44,528630.87,1306453.82999999
"8915",2017-11-09 00:21:44,777822.99,2084276.81999999
"8916",2017-11-09 00:21:44,-777822.96,1306453.85999999
"8917",2017-11-09 00:27:23,-1306453.86,-1.00117176771164e-08
"8918",2017-11-09 00:58:40,325212.26,325212.25999999
"8919",2017-11-09 00:58:40,320368.73,645580.98999999
"8920",2017-11-09 01:06:06,-645580.99,-1.00117176771164e-08
"8921",2017-11-09 02:40:19,278871.23,278871.22999999
"8922",2017-11-09 03:03:35,273068.81,551940.03999999
"8923",2017-11-09 03:03:35,-278871.23,273068.80999999
"8924",2017-11-09 03:28:24,-273068.81,-9.95351001620293e-09
"8925",2017-11-09 05:05:40,190628.93,190628.92999999
"8926",2017-11-09 05:09:23,-190628.93,-9.95351001620293e-09
"8927",2017-11-09 05:26:31,262205.33,262205.32999999
"8928",2017-11-09 05:44:10,-262205.33,-9.95351001620293e-09
"8929",2017-11-09 06:16:55,304175.38,304175.37999999
"8930",2017-11-09 07:11:58,325932.35,630107.72999999
"8931",2017-11-09 07:11:58,277665.19,907772.91999999
"8932",2017-11-09 07:11:58,-304175.38,603597.53999999
"8933",2017-11-09 07:16:00,-603597.54,-1.01281329989433e-08
"8934",2017-11-09 07:44:48,247749.12,247749.11999999
"8935",2017-11-09 07:50:30,-247749.12,-1.01281329989433e-08
"8936",2017-11-09 08:09:54,523404.39,523404.38999999
"8937",2017-11-09 08:15:38,-523404.39,-1.01281329989433e-08
"8938",2017-11-09 12:26:38,249991.97,249991.96999999
"8939",2017-11-09 12:34:15,-249991.97,-1.01281329989433e-08
"8940",2017-11-09 14:14:37,300763.19,300763.18999999
"8941",2017-11-09 14:14:37,192720.24,493483.42999999
"8942",2017-11-09 14:21:33,-493483.43,-1.01281329989433e-08
"8943",2017-11-09 15:02:36,391862.67,391862.66999999
"8944",2017-11-09 15:18:33,-391862.67,-1.01281329989433e-08
"8945",2017-11-09 16:11:02,307849.45,307849.44999999
"8946",2017-11-09 16:26:41,-307849.45,-1.01281329989433e-08
"8947",2017-11-09 17:40:05,100046.97,100046.96999999
"8948",2017-11-09 17:42:03,50046.92,150093.88999999
"8949",2017-11-09 17:48:07,-150093.89,-1.01281329989433e-08
"8950",2017-11-09 18:04:33,77824.21,77824.2099999899
"8951",2017-11-09 18:27:19,-77824.21,-1.01281329989433e-08
"8952",2017-11-10 01:01:37,454461.8,454461.79999999
"8953",2017-11-10 01:01:37,777827.79,1232289.58999999
"8954",2017-11-10 01:04:23,-1232289.59,-1.02445483207703e-08
"8955",2017-11-10 01:17:45,388938.85,388938.84999999
"8956",2017-11-10 01:17:45,777827.86,1166766.70999999
"8957",2017-11-10 01:48:25,354914.17,1521680.87999999
"8958",2017-11-10 02:02:00,239408.94,1761089.81999999
"8959",2017-11-10 02:15:36,406299.21,2167389.02999999
"8960",2017-11-10 02:28:01,295044.05,2462433.07999999
"8961",2017-11-10 02:42:12,365090.93,2827524.00999999
"8962",2017-11-10 03:35:56,543707.7,3371231.70999999
"8963",2017-11-10 04:35:29,388816.3,3760048.00999999
"8964",2017-11-10 05:08:36,364127.65,4124175.65999999
"8965",2017-11-10 07:41:16,505745.26,4629920.91999999
"8966",2017-11-10 07:41:16,-4124175.66,505745.25999999
"8967",2017-11-10 07:41:16,9290.23,515035.48999999
"8968",2017-11-10 07:50:57,-515035.49,-1.04773789644241e-08
"8969",2017-11-10 08:43:55,272286.79,272286.78999999
"8970",2017-11-10 08:51:25,-272286.79,-1.04773789644241e-08
"8971",2017-11-10 09:08:26,267615.25,267615.24999999
"8972",2017-11-10 09:13:12,-267615.25,-1.04773789644241e-08
"8973",2017-11-10 10:05:31,16571.78,16571.7799999895
"8974",2017-11-10 10:08:34,205207.1,221778.87999999
"8975",2017-11-10 10:08:34,-16571.78,205207.09999999
"8976",2017-11-10 10:17:53,333339.71,538546.80999999
"8977",2017-11-10 10:17:53,407850.62,946397.42999999
"8978",2017-11-10 10:17:53,-205207.1,741190.32999999
"8979",2017-11-10 10:17:53,-205207.1,535983.22999999
"8980",2017-11-10 10:42:53,652916.39,1188899.61999999
"8981",2017-11-10 10:42:53,297501.75,1486401.36999999
"8982",2017-11-10 10:42:53,-535983.23,950418.13999999
"8983",2017-11-10 10:49:13,-950418.14,-1.03609636425972e-08
"8984",2017-11-10 11:18:38,266971.09,266971.08999999
"8985",2017-11-10 11:18:38,272253.65,539224.73999999
"8986",2017-11-10 11:18:38,197014.44,736239.17999999
"8987",2017-11-10 11:34:18,-736239.18,-1.03609636425972e-08
"8988",2017-11-10 11:41:37,361709.87,361709.86999999
"8989",2017-11-10 11:59:16,-361709.87,-1.03609636425972e-08
"8990",2017-11-10 12:13:29,699252.58,699252.57999999
"8991",2017-11-10 12:21:04,370272,1069524.57999999
"8992",2017-11-10 12:21:04,316379.81,1385904.38999999
"8993",2017-11-10 12:21:04,-699252.58,686651.80999999
"8994",2017-11-10 12:47:09,356974.04,1043625.84999999
"8995",2017-11-10 12:47:09,-686651.81,356974.03999999
"8996",2017-11-10 12:51:14,-356974.04,-1.04191713035107e-08
"8997",2017-11-10 13:22:44,290520.87,290520.86999999
"8998",2017-11-10 13:22:44,306026.23,596547.09999999
"8999",2017-11-10 13:54:38,-596547.1,-1.03609636425972e-08
"9000",2017-11-10 14:13:55,364485.74,364485.73999999
"9001",2017-11-10 14:24:37,-364485.74,-1.03609636425972e-08
"9002",2017-11-10 15:19:38,315200.84,315200.83999999
"9003",2017-11-10 15:19:38,311777.4,626978.23999999
"9004",2017-11-10 15:33:53,204761.63,831739.86999999
"9005",2017-11-10 15:33:53,646728.51,1478468.37999999
"9006",2017-11-10 15:33:53,-626978.24,851490.13999999
"9007",2017-11-10 16:03:25,777828.63,1629318.76999999
"9008",2017-11-10 16:03:25,355481.78,1984800.54999999
"9009",2017-11-10 16:03:25,-851490.14,1133310.40999999
"9010",2017-11-10 16:09:13,-1133310.41,-1.00117176771164e-08
"9011",2017-11-10 16:28:10,532893.61,532893.60999999
"9012",2017-11-10 16:48:35,-532893.61,-1.00117176771164e-08
"9013",2017-11-10 17:29:19,333648.73,333648.72999999
"9014",2017-11-10 17:34:03,-333648.73,-1.00117176771164e-08
"9015",2017-11-10 19:42:43,633571.42,633571.41999999
"9016",2017-11-10 20:02:47,245504.61,879076.02999999
"9017",2017-11-10 20:02:47,-633571.42,245504.60999999
"9018",2017-11-10 20:04:50,314521.75,560026.35999999
"9019",2017-11-10 20:22:48,-560026.36,-1.00117176771164e-08
"9020",2017-11-10 20:33:08,88939.85,88939.84999999
"9021",2017-11-10 20:33:08,88939.86,177879.70999999
"9022",2017-11-10 20:40:08,-177879.71,-9.98261384665966e-09
"9023",2017-11-10 20:42:17,777828.89,777828.88999999
"9024",2017-11-10 20:54:41,222384.9,1000213.78999999
"9025",2017-11-10 20:54:41,-777828.89,222384.89999999
"9026",2017-11-10 20:58:13,504752.58,727137.47999999
"9027",2017-11-10 21:16:29,217052.59,944190.06999999
"9028",2017-11-10 21:16:29,-727137.48,217052.58999999
"9029",2017-11-10 21:34:39,692747.44,909800.02999999
"9030",2017-11-10 21:34:39,-217052.59,692747.43999999
"9031",2017-11-10 21:34:39,-217052.59,475694.84999999
"9032",2017-11-10 21:44:03,-475694.85,-1.00117176771164e-08
"9033",2017-11-10 22:59:54,265737.38,265737.37999999
"9034",2017-11-10 22:59:54,219837.39,485574.76999999
"9035",2017-11-10 23:09:54,-485574.77,-1.00117176771164e-08
"9036",2017-11-10 23:09:54,488940,488939.99999999
"9037",2017-11-11 00:01:01,413540.89,902480.88999999
"9038",2017-11-11 00:01:01,-488940,413540.88999999
"9039",2017-11-11 00:09:09,-413540.89,-1.00117176771164e-08
"9040",2017-11-11 04:43:05,743364.55,743364.54999999
"9041",2017-11-11 04:43:05,-743364.55,-1.00117176771164e-08
"9042",2017-11-11 05:40:16,777829.12,777829.11999999
"9043",2017-11-11 06:45:47,357672.6,1135501.71999999
"9044",2017-11-11 06:45:47,217513.29,1353015.00999999
"9045",2017-11-11 07:04:59,-1353015.01,-1.00117176771164e-08
"9046",2017-11-11 11:02:12,777829.26,777829.25999999
"9047",2017-11-11 11:02:12,127414.27,905243.52999999
"9048",2017-11-11 11:29:44,-905243.53,-1.00117176771164e-08
"9049",2017-11-11 12:04:37,66567.3,66567.29999999
"9050",2017-11-11 12:04:37,777829.29,844396.58999999
"9051",2017-11-11 12:29:45,-844396.59,-9.89530235528946e-09
"9052",2017-11-11 14:01:40,777829.39,777829.38999999
"9053",2017-11-11 14:11:32,-777829.39,-9.89530235528946e-09
"9054",2017-11-11 16:04:32,665222.71,665222.70999999
"9055",2017-11-11 16:11:28,-665222.71,-9.89530235528946e-09
"9056",2017-11-11 17:52:57,447243.84,447243.83999999
"9057",2017-11-11 17:52:57,459796.48,907040.31999999
"9058",2017-11-11 19:12:37,315099.92,1222140.23999999
"9059",2017-11-11 19:12:37,399553.65,1621693.88999999
"9060",2017-11-11 19:34:08,290063.95,1911757.83999999
"9061",2017-11-11 22:46:52,777829.57,2689587.40999999
"9062",2017-11-11 22:46:52,134911.58,2824498.98999999
"9063",2017-11-12 01:05:13,330695.44,3155194.42999999
"9064",2017-11-12 01:05:13,347682.5,3502876.92999999
"9065",2017-11-12 03:21:30,289887.12,3792764.04999999
"9066",2017-11-12 03:26:05,489001.25,4281765.29999999
"9067",2017-11-12 03:26:05,317212.36,4598977.65999999
"9068",2017-11-12 03:50:55,497909.49,5096887.14999999
"9069",2017-11-12 23:04:46,7415.68,5104302.82999999
"9070",2017-11-12 23:04:46,777829.67,5882132.49999999
"9071",2017-11-12 23:04:46,283132.51,6165265.00999999
"9072",2017-11-12 23:04:46,443002.14,6608267.14999999
"9073",2017-11-13 01:51:34,-5096887.15,1511379.99999999
"9074",2017-11-13 01:51:34,-907040.32,604339.679999989
"9075",2017-11-13 02:03:53,-604339.68,-1.11758708953857e-08
"9076",2017-11-13 02:08:57,776692.79,776692.789999989
"9077",2017-11-13 03:03:28,777829.78,1554522.56999999
"9078",2017-11-13 03:03:28,-776692.79,777829.779999989
"9079",2017-11-13 03:03:28,-776692.79,1136.98999998881
"9080",2017-11-13 03:10:29,-1136.99,-1.11851932160789e-08
"9081",2017-11-13 18:36:09,440427.44,440427.439999989
"9082",2017-11-13 21:11:53,777830.19,1218257.62999999
"9083",2017-11-13 21:11:53,187405.2,1405662.82999999
"9084",2017-11-13 21:38:20,-440427.44,965235.389999989
"9085",2017-11-13 21:38:20,-440427.44,524807.949999989
"9086",2017-11-13 21:38:20,-440427.44,84380.5099999888
"9087",2017-11-13 21:52:46,-84380.51,-1.12195266410708e-08
"9088",2017-11-14 00:14:41,462377.83,462377.829999989
"9089",2017-11-14 00:32:31,395516.15,857893.979999989
"9090",2017-11-14 03:13:13,443607.18,1301501.15999999
"9091",2017-11-14 09:41:40,378664.39,1680165.54999999
"9092",2017-11-14 11:12:49,447013.62,2127179.16999999
"9093",2017-11-14 12:13:28,662547.27,2789726.43999999
"9094",2017-11-14 13:45:29,537130.43,3326856.86999999
"9095",2017-11-14 19:39:32,413669.84,3740526.70999999
"9096",2017-11-14 20:24:21,457538.12,4198064.82999999
"9097",2017-11-14 22:52:00,483390.83,4681455.65999999
"9098",2017-11-15 01:24:02,455056.61,5136512.26999999
"9099",2017-11-15 20:43:19,512765.19,5649277.45999999
"9100",2017-11-15 20:43:19,-5136512.27,512765.18999999
"9101",2017-11-15 21:06:32,-512765.19,-9.83709469437599e-09
"9102",2017-11-15 22:17:39,393437.93,393437.92999999
"9103",2017-11-15 22:25:40,-393437.93,-9.83709469437599e-09
"9104",2017-11-15 23:20:26,381303.93,381303.92999999
"9105",2017-11-15 23:58:27,413424.57,794728.49999999
"9106",2017-11-16 00:05:15,-794728.5,-9.77888703346252e-09
"9107",2017-11-16 01:29:27,371046.95,371046.94999999
"9108",2017-11-16 01:29:27,391271.73,762318.67999999
"9109",2017-11-16 02:13:46,482314.85,1244633.52999999
"9110",2017-11-16 02:16:21,-762318.68,482314.84999999
"9111",2017-11-16 03:13:48,318368.23,800683.07999999
"9112",2017-11-16 03:13:48,443717.57,1244400.64999999
"9113",2017-11-16 03:16:23,14916.2,1259316.84999999
"9114",2017-11-16 03:19:14,-1259316.85,-1.02445483207703e-08
"9115",2017-11-16 04:27:04,403143.36,403143.35999999
"9116",2017-11-16 04:35:32,-403143.36,-1.02445483207703e-08
"9117",2017-11-16 04:47:14,355808.45,355808.44999999
"9118",2017-11-16 04:58:08,-355808.45,-1.02445483207703e-08
"9119",2017-11-16 05:09:35,644319.38,644319.37999999
"9120",2017-11-16 05:40:01,-644319.38,-1.02445483207703e-08
"9121",2017-11-16 06:27:02,401266.57,401266.56999999
"9122",2017-11-16 06:45:20,-401266.57,-1.02445483207703e-08
"9123",2017-11-16 07:00:32,575976.48,575976.47999999
"9124",2017-11-16 07:17:14,-575976.48,-1.02445483207703e-08
"9125",2017-11-16 07:59:57,582356.63,582356.62999999
"9126",2017-11-16 08:48:08,-582356.63,-1.02445483207703e-08
"9127",2017-11-16 10:18:41,768455.67,768455.66999999
"9128",2017-11-16 10:26:38,-768455.67,-1.02445483207703e-08
"9129",2017-11-16 12:26:52,727933.06,727933.05999999
"9130",2017-11-16 14:15:53,646724.48,1374657.53999999
"9131",2017-11-16 14:34:29,478896.47,1853554.00999999
"9132",2017-11-16 14:54:19,517207.22,2370761.22999999
"9133",2017-11-16 16:19:08,702357.84,3073119.06999999
"9134",2017-11-16 17:53:09,777832.18,3850951.24999999
"9135",2017-11-16 17:53:09,715854.1,4566805.34999999
"9136",2017-11-16 17:53:09,107396.19,4674201.53999999
"9137",2017-11-16 17:53:09,-3073119.07,1601082.46999999
"9138",2017-11-16 17:57:44,-1601082.47,-1.00117176771164e-08
"9139",2017-11-16 18:36:47,31977.23,31977.22999999
"9140",2017-11-16 18:36:47,777832.22,809809.44999999
"9141",2017-11-16 19:13:49,-809809.45,-1.00117176771164e-08
"9142",2017-11-16 20:29:54,720231.86,720231.85999999
"9143",2017-11-16 20:41:33,-720231.86,-1.00117176771164e-08
"9144",2017-11-16 21:55:44,133135.36,133135.35999999
"9145",2017-11-16 21:55:44,777832.35,910967.70999999
"9146",2017-11-16 22:07:37,320267.39,1231235.09999999
"9147",2017-11-16 22:07:37,777832.38,2009067.47999999
"9148",2017-11-16 22:07:37,-910967.71,1098099.76999999
"9149",2017-11-16 22:07:37,-910967.71,187132.05999999
"9150",2017-11-16 22:20:58,-187132.06,-1.01863406598568e-08
"9151",2017-11-17 00:31:58,328486.48,328486.47999999
"9152",2017-11-17 00:31:58,777832.47,1106318.94999999
"9153",2017-11-17 00:41:23,-1106318.95,-1.02445483207703e-08
"9154",2017-11-17 01:18:35,543399.52,543399.51999999
"9155",2017-11-17 01:18:35,777832.51,1321232.02999999
"9156",2017-11-17 01:34:35,-1321232.03,-1.02445483207703e-08
"9157",2017-11-17 12:54:59,166454.09,166454.08999999
"9158",2017-11-17 12:54:59,777835.05,944289.13999999
"9159",2017-11-17 12:54:59,777835.07,1722124.20999999
"9160",2017-11-17 12:54:59,777835.08,2499959.28999999
"9161",2017-11-17 12:54:59,777835.06,3277794.34999999
"9162",2017-11-17 15:05:13,547881.48,3825675.82999999
"9163",2017-11-18 11:27:10,431540.29,4257216.11999999
"9164",2017-11-18 11:37:21,59716.31,4316932.42999999
"9165",2017-11-18 11:42:08,777835.3,5094767.72999999
"9166",2017-11-18 13:09:58,642254.54,5737022.26999999
"9167",2017-11-18 17:52:40,769597.66,6506619.92999999
"9168",2017-11-18 20:11:58,526496.53,7033116.45999999
"9169",2017-11-18 21:27:55,395326.47,7428442.92999999
"9170",2017-11-18 21:27:55,777835.46,8206278.38999999
"9171",2017-11-18 22:59:55,777835.49,8984113.87999999
"9172",2017-11-18 22:59:55,260782.5,9244896.37999999
"9173",2017-11-19 00:03:10,777835.51,10022731.89
"9174",2017-11-19 00:03:10,315311.52,10338043.41
"9175",2017-11-19 06:05:12,-10338043.41,-1.11758708953857e-08
"9176",2017-11-19 17:54:23,777835.55,777835.549999989
"9177",2017-11-19 17:54:23,490591.56,1268427.10999999
"9178",2017-11-19 18:10:38,777835.6,2046262.70999999
"9179",2017-11-19 18:10:38,169802.62,2216065.32999999
"9180",2017-11-19 18:10:38,777835.61,2993900.93999999
"9181",2017-11-19 18:10:38,-1268427.11,1725473.82999999
"9182",2017-11-19 18:14:49,-1725473.83,-1.14087015390396e-08
"9183",2017-11-19 18:27:00,777835.65,777835.649999989
"9184",2017-11-19 18:27:00,145582.66,923418.309999989
"9185",2017-11-19 18:37:19,207379.68,1130797.98999999
"9186",2017-11-19 18:37:19,777835.67,1908633.65999999
"9187",2017-11-19 18:37:19,-923418.31,985215.349999988
"9188",2017-11-19 18:49:40,-985215.35,-1.15251168608665e-08
"9189",2017-11-20 12:23:55,1264479.12,1264479.11999999
"9190",2017-11-20 20:47:56,-1264479.12,-1.16415321826935e-08
"9191",2017-11-21 00:02:17,3680009.19,3680009.18999999
"9192",2017-11-21 00:20:29,-3680009.19,-1.16415321826935e-08
"9193",2017-11-23 17:59:26,437365.93,437365.929999988
"9194",2017-11-23 18:17:01,311252.96,748618.889999988
"9195",2017-11-23 18:21:43,438058.35,1186677.23999999
"9196",2017-11-23 19:03:57,408164.91,1594842.14999999
"9197",2017-11-23 20:40:20,-1594842.15,-1.16415321826935e-08
"9198",2017-11-23 20:50:33,23991.32,23991.3199999884
"9199",2017-11-23 20:59:38,-23991.32,-1.16415321826935e-08
"9200",2017-11-23 22:43:18,351597.86,351597.859999988
"9201",2017-11-23 22:45:54,-351597.86,-1.16415321826935e-08
"9202",2017-11-24 00:37:31,389582.49,389582.489999988
"9203",2017-11-24 00:42:26,-389582.49,-1.16415321826935e-08
"9204",2017-11-24 01:41:24,324836.48,324836.479999988
"9205",2017-11-24 07:20:46,283933.34,608769.819999988
"9206",2017-11-24 09:50:45,649053.47,1257823.28999999
"9207",2017-11-24 10:08:05,400733.04,1658556.32999999
"9208",2017-11-24 10:08:05,301457.64,1960013.96999999
"9209",2017-11-24 10:41:24,386768.46,2346782.42999999
"9210",2017-11-24 11:20:53,627661.64,2974444.06999999
"9211",2017-11-24 13:39:08,447675.21,3422119.27999999
"9212",2017-11-24 17:12:20,390115.03,3812234.30999999
"9213",2017-11-24 17:15:10,716057.99,4528292.29999999
"9214",2017-11-24 17:26:32,730030.93,5258323.22999999
"9215",2017-11-24 17:26:32,-4528292.3,730030.929999989
"9216",2017-11-24 17:30:33,-730030.93,-1.15251168608665e-08
"9217",2017-11-24 19:21:50,637086.91,637086.909999989
"9218",2017-11-24 19:30:33,-637086.91,-1.15251168608665e-08
"9219",2017-11-24 19:53:16,137060.46,137060.459999988
"9220",2017-11-24 19:53:16,777850.45,914910.909999988
"9221",2017-11-24 19:56:46,-914910.91,-1.16415321826935e-08
"9222",2017-11-24 22:53:56,458023.45,458023.449999988
"9223",2017-11-24 23:18:22,-458023.45,-1.16415321826935e-08
"9224",2017-11-24 23:30:00,191525.5,191525.499999988
"9225",2017-11-24 23:30:00,777850.49,969375.989999988
"9226",2017-11-24 23:49:16,437039.32,1406415.30999999
"9227",2017-11-24 23:49:16,-969375.99,437039.319999988
"9228",2017-11-25 00:04:40,-437039.32,-1.158332452178e-08
"9229",2017-11-25 00:18:58,565681.48,565681.479999988
"9230",2017-11-25 00:21:42,-565681.48,-1.16415321826935e-08
"9231",2017-11-25 01:27:10,116648.55,116648.549999988
"9232",2017-11-25 01:27:10,777850.54,894499.089999988
"9233",2017-11-25 01:38:38,-894499.09,-1.15251168608665e-08
"9234",2017-11-25 02:40:06,548055.51,548055.509999988
"9235",2017-11-25 02:56:54,-548055.51,-1.15251168608665e-08
"9236",2017-11-25 07:48:11,28554.65,28554.6499999885
"9237",2017-11-25 07:48:11,777850.64,806405.289999989
"9238",2017-11-25 08:02:14,-806405.29,-1.15251168608665e-08
"9239",2017-11-25 09:29:01,727389.95,727389.949999988
"9240",2017-11-25 09:33:19,564197.61,1291587.55999999
"9241",2017-11-25 09:59:36,763201.11,2054788.66999999
"9242",2017-11-25 11:13:10,115994.79,2170783.45999999
"9243",2017-11-25 11:13:10,777850.78,2948634.23999999
"9244",2017-11-25 14:27:37,78289.27,3026923.50999999
"9245",2017-11-25 14:56:45,18676.87,3045600.37999999
"9246",2017-11-25 15:27:34,4091.84,3049692.21999999
"9247",2017-11-26 06:16:20,-3049692.22,-1.21071934700012e-08
"9248",2017-11-26 10:13:18,227395.56,227395.559999988
"9249",2017-11-26 10:24:31,-227395.56,-1.21071934700012e-08
"9250",2017-11-26 11:20:04,313980.59,313980.589999988
"9251",2017-11-26 11:28:15,-313980.59,-1.21071934700012e-08
"9252",2017-11-26 13:06:17,337421.49,337421.489999988
"9253",2017-11-26 13:16:59,-337421.49,-1.21071934700012e-08
"9254",2017-11-26 15:49:51,424100.72,424100.719999988
"9255",2017-11-26 16:03:49,-424100.72,-1.21071934700012e-08
"9256",2017-11-26 16:25:08,546294.94,546294.939999988
"9257",2017-11-26 16:28:42,-546294.94,-1.21071934700012e-08
"9258",2017-11-26 17:03:12,388966.76,388966.759999988
"9259",2017-11-26 17:29:03,325709.96,714676.719999988
"9260",2017-11-26 17:29:03,-388966.76,325709.959999988
"9261",2017-11-26 17:38:22,-325709.96,-1.21654011309147e-08
"9262",2017-11-26 19:11:44,57769.53,57769.5299999878
"9263",2017-11-26 19:31:53,269802.23,327571.759999988
"9264",2017-11-26 19:31:53,122132.21,449703.969999988
"9265",2017-11-26 19:31:53,17246.34,466950.309999988
"9266",2017-11-26 19:31:53,-57769.53,409180.779999988
"9267",2017-11-26 19:36:26,-409180.78,-1.22236087918282e-08
"9268",2017-11-26 19:58:10,302299.63,302299.629999988
"9269",2017-11-26 20:14:41,-302299.63,-1.22236087918282e-08
"9270",2017-11-26 20:22:56,6106.49,6106.48999998778
"9271",2017-11-26 20:31:25,-6106.49,-1.22236087918282e-08
"9272",2017-11-26 21:14:21,95014.62,95014.6199999878
"9273",2017-11-26 21:34:21,-95014.62,-1.22236087918282e-08
"9274",2017-11-26 22:46:01,5595.65,5595.64999998778
"9275",2017-11-26 22:48:44,-5595.65,-1.22236087918282e-08
"9276",2017-11-26 23:16:28,89073.82,89073.8199999878
"9277",2017-11-26 23:16:28,2087.61,91161.4299999878
"9278",2017-11-26 23:19:57,-91161.43,-1.22090568765998e-08
"9279",2017-11-26 23:29:00,1397.96,1397.95999998779
"9280",2017-11-26 23:35:33,-1397.96,-1.22090568765998e-08
"9281",2017-11-26 23:38:21,777853.41,777853.409999988
"9282",2017-11-26 23:38:21,777853.45,1555706.85999999
"9283",2017-11-26 23:49:04,777853.43,2333560.28999999
"9284",2017-11-26 23:49:04,777853.48,3111413.76999999
"9285",2017-11-26 23:49:04,777853.47,3889267.23999999
"9286",2017-11-26 23:49:04,-1555706.86,2333560.37999999
"9287",2017-11-26 23:52:38,-2333560.38,-1.21071934700012e-08
"9288",2017-11-27 00:10:24,777853.5,777853.499999988
"9289",2017-11-27 00:10:24,777853.52,1555707.01999999
"9290",2017-11-27 00:20:55,777853.54,2333560.55999999
"9291",2017-11-27 00:20:55,777853.57,3111414.12999999
"9292",2017-11-27 00:20:55,777853.56,3889267.68999999
"9293",2017-11-27 00:20:55,-1555707.02,2333560.66999999
"9294",2017-11-27 00:32:52,777853.59,3111414.25999999
"9295",2017-11-27 00:32:52,-2333560.67,777853.589999988
"9296",2017-11-27 00:37:16,-777853.59,-1.22236087918282e-08
"9297",2017-11-27 00:50:18,213421.61,213421.609999988
"9298",2017-11-27 00:57:39,-213421.61,-1.22236087918282e-08
"9299",2017-11-27 01:22:43,206988.64,206988.639999988
"9300",2017-11-27 06:49:49,150077.45,357066.089999988
"9301",2017-11-27 12:07:58,777853.63,1134919.71999999
"9302",2017-11-27 12:07:58,888965.86,2023885.57999999
"9303",2017-11-27 12:07:58,888965.84,2912851.41999999
"9304",2017-11-27 12:07:58,777853.6,3690705.01999999
"9305",2017-11-27 12:07:58,777854.82,4468559.83999999
"9306",2017-11-27 12:24:30,888965.88,5357525.71999999
"9307",2017-11-27 13:32:36,888965.95,6246491.66999999
"9308",2017-11-27 15:32:55,777854.97,7024346.63999999
"9309",2017-11-27 15:35:50,634969.98,7659316.61999999
"9310",2017-11-27 15:35:50,888965.99,8548282.60999999
"9311",2017-11-27 23:29:20,777855.1,9326137.70999999
"9312",2017-11-28 07:15:23,-9326137.71,-1.30385160446167e-08
"9313",2017-11-28 12:57:45,777856.05,777856.049999987
"9314",2017-11-28 12:57:45,323040.11,1100896.15999999
"9315",2017-11-28 12:57:45,330263.07,1431159.22999999
"9316",2017-11-28 12:57:45,777856.06,2209015.28999999
"9317",2017-11-28 13:08:49,-2209015.29,-1.30385160446167e-08
"9318",2017-11-28 14:22:52,888967.14,888967.139999987
"9319",2017-11-28 14:22:52,888967.1,1777934.23999999
"9320",2017-11-28 14:41:17,888967.12,2666901.35999999
"9321",2017-11-28 22:53:25,1131687.55,3798588.90999999
"9322",2017-11-29 01:03:33,103562.75,3902151.65999999
"9323",2017-11-29 01:13:28,254120.22,4156271.87999999
"9324",2017-11-29 01:13:28,777856.21,4934128.08999999
"9325",2017-11-29 01:27:07,888967.25,5823095.33999999
"9326",2017-11-29 01:27:07,888967.24,6712062.57999999
"9327",2017-11-29 01:58:09,888967.28,7601029.85999999
"9328",2017-11-29 05:27:44,1070306.5,8671336.35999999
"9329",2017-11-29 05:49:41,47425.45,8718761.80999999
"9330",2017-11-29 05:52:58,1479342.87,10198104.68
"9331",2017-11-29 06:16:34,14600.17,10212704.85
"9332",2017-11-29 06:16:34,66091.84,10278796.69
"9333",2017-11-29 06:27:08,12956.74,10291753.43
"9334",2017-11-29 06:38:54,11205.06,10302958.49
"9335",2017-11-29 06:49:27,7081.87,10310040.36
"9336",2017-11-29 08:11:21,888967.72,11199008.08
"9337",2017-11-29 08:38:54,888967.68,12087975.76
"9338",2017-11-29 08:38:54,888967.8,12976943.56
"9339",2017-11-29 08:38:54,888967.7,13865911.26
"9340",2017-11-29 08:38:54,888967.74,14754879
"9341",2017-11-29 08:40:03,888967.76,15643846.76
"9342",2017-11-29 08:40:03,888967.78,16532814.54
"9343",2017-11-29 11:05:25,971900.98,17504715.52
"9344",2017-11-29 12:14:14,888967.87,18393683.39
"9345",2017-11-29 13:06:02,777856.89,19171540.28
"9346",2017-11-29 13:06:02,777856.88,19949397.16
"9347",2017-11-29 13:06:02,555978.9,20505376.06
"9348",2017-11-29 13:23:17,777856.91,21283232.97
"9349",2017-11-29 13:23:17,777856.92,22061089.89
"9350",2017-11-29 13:23:17,651063.93,22712153.82
"9351",2017-11-29 19:50:08,574309.92,23286463.74
"9352",2017-11-29 21:29:24,777857.23,24064320.97
"9353",2017-11-29 21:29:24,53221.24,24117542.21
"9354",2017-11-29 22:41:11,275481.3,24393023.51
"9355",2017-11-29 22:41:11,777857.29,25170880.8
"9356",2017-11-29 23:30:13,187043.32,25357924.12
"9357",2017-11-29 23:30:13,777857.31,26135781.43
"9358",2017-11-30 00:09:38,22228.16,26158009.59
"9359",2017-11-30 00:57:20,660288.3,26818297.89
"9360",2017-11-30 02:09:13,574476.15,27392774.04
"9361",2017-11-30 02:18:13,78536.48,27471310.52
"9362",2017-11-30 02:18:13,777857.47,28249167.99
"9363",2017-11-30 02:23:08,777857.49,29027025.48
"9364",2017-11-30 02:23:08,240398.5,29267423.98
"9365",2017-11-30 04:28:23,506354.02,29773778
"9366",2017-11-30 07:37:15,777858.3,30551636.3
"9367",2017-11-30 08:12:11,1587533.61,32139169.91
"9368",2017-11-30 09:17:20,475148.56,32614318.47
"9369",2017-11-30 10:05:41,660536.48,33274854.95
"9370",2017-11-30 14:34:50,777858.57,34052713.52
"9371",2017-11-30 14:34:50,126931.58,34179645.1
"9372",2017-11-30 14:41:50,777858.59,34957503.69
"9373",2017-11-30 14:41:50,278444.6,35235948.29
"9374",2017-11-30 18:07:58,489821.58,35725769.87
"9375",2017-11-30 19:22:00,595862.03,36321631.9
"9376",2017-11-30 19:46:19,463577.26,36785209.16
"9377",2017-11-30 20:17:12,888969.82,37674178.98
"9378",2017-11-30 20:31:06,777858.91,38452037.89
"9379",2017-11-30 20:39:38,392983.93,38845021.82
"9380",2017-11-30 20:39:38,777858.92,39622880.74
"9381",2017-11-30 21:10:17,733081.9,40355962.64
"9382",2017-11-30 21:37:50,619899.35,40975861.99
"9383",2017-11-30 21:48:55,720999.24,41696861.23
"9384",2017-11-30 22:51:14,777859.03,42474720.26
"9385",2017-11-30 22:51:14,15557.04,42490277.3
"9386",2017-12-01 00:38:39,520527.56,43010804.86
"9387",2017-12-01 01:44:44,776754.52,43787559.38
"9388",2017-12-01 06:38:27,456252.01,44243811.39
"9389",2017-12-01 09:52:52,486055.11,44729866.5
"9390",2017-12-01 10:18:31,777859.26,45507725.76
"9391",2017-12-01 10:18:31,43198.27,45550924.03
"9392",2017-12-01 12:23:29,777859.34,46328783.37
"9393",2017-12-01 12:23:29,777859.3,47106642.67
"9394",2017-12-01 12:23:29,217306.35,47323949.02
"9395",2017-12-01 12:50:24,123989.39,47447938.41
"9396",2017-12-02 00:32:47,777861.11,48225799.52
"9397",2017-12-02 00:32:47,777861.09,49003660.61
"9398",2017-12-02 00:32:47,777861.12,49781521.73
"9399",2017-12-02 00:32:47,484454.13,50265975.86
"9400",2017-12-02 00:32:47,777861.1,51043836.96
"9401",2017-12-02 00:58:35,618895.39,51662732.35
"9402",2017-12-02 00:58:35,24424.22,51687156.57
"9403",2017-12-02 00:58:35,777861.21,52465017.78
"9404",2017-12-02 01:07:16,1055874.59,53520892.37
"9405",2017-12-02 01:21:48,462997.94,53983890.31
"9406",2017-12-02 01:28:56,777861.25,54761751.56
"9407",2017-12-02 01:28:56,888972.26,55650723.82
"9408",2017-12-02 02:45:05,122837.34,55773561.16
"9409",2017-12-02 02:45:05,777861.33,56551422.49
"9410",2017-12-02 02:45:05,563728.64,57115151.13
"9411",2017-12-02 06:25:45,888972.37,58004123.5
"9412",2017-12-02 07:55:21,888972.39,58893095.89
"9413",2017-12-02 07:55:21,-58004123.5,888972.389999993
"9414",2017-12-02 08:05:33,-888972.39,-6.86850398778915e-09
"9415",2017-12-02 16:06:24,511504.51,511504.509999993
"9416",2017-12-02 16:17:14,-511504.51,-6.86850398778915e-09
"9417",2017-12-02 16:57:43,541706.34,541706.339999993
"9418",2017-12-02 21:01:11,769799.73,1311506.06999999
"9419",2017-12-03 04:54:03,494673.99,1806180.05999999
"9420",2017-12-03 06:01:37,686612.61,2492792.66999999
"9421",2017-12-03 07:06:15,476573.88,2969366.54999999
"9422",2017-12-03 07:14:52,595791.86,3565158.40999999
"9423",2017-12-03 11:16:56,100569.77,3665728.17999999
"9424",2017-12-03 11:16:56,777863.76,4443591.93999999
"9425",2017-12-03 11:30:23,777863.8,5221455.73999999
"9426",2017-12-03 11:30:23,774779.82,5996235.55999999
"9427",2017-12-03 11:30:23,777863.81,6774099.36999999
"9428",2017-12-03 11:32:10,494559.87,7268659.23999999
"9429",2017-12-03 11:32:10,777863.86,8046523.09999999
"9430",2017-12-03 12:13:26,777863.94,8824387.03999999
"9431",2017-12-03 12:13:26,777863.93,9602250.96999999
"9432",2017-12-03 12:13:26,210312.95,9812563.91999999
"9433",2017-12-03 12:17:39,888975.03,10701538.95
"9434",2017-12-03 18:53:35,777864.08,11479403.03
"9435",2017-12-03 18:53:35,256053.09,11735456.12
"9436",2017-12-03 20:18:03,777864.1,12513320.22
"9437",2017-12-03 20:18:03,122686.11,12636006.33
"9438",2017-12-03 22:37:17,51548.34,12687554.67
"9439",2017-12-04 05:19:30,635798.26,13323352.93
"9440",2017-12-04 20:33:34,502289.99,13825642.92
"9441",2017-12-04 20:54:20,768347.82,14593990.74
"9442",2017-12-04 21:19:34,777864.66,15371855.4
"9443",2017-12-04 21:19:34,99100.67,15470956.07
"9444",2017-12-04 21:19:34,483540.6,15954496.67
"9445",2017-12-04 23:11:20,777864.68,16732361.35
"9446",2017-12-04 23:11:20,160500.69,16892862.04
"9447",2017-12-05 00:25:55,505105.67,17397967.71
"9448",2017-12-05 06:56:50,810030.69,18207998.4
"9449",2017-12-05 07:51:03,777864.86,18985863.26
"9450",2017-12-05 07:51:03,7121.87,18992985.13
"9451",2017-12-05 08:33:31,623708.9,19616694.03
"9452",2017-12-05 08:33:31,777864.89,20394558.92
"9453",2017-12-05 10:49:45,777864.92,21172423.84
"9454",2017-12-05 10:49:45,422363.93,21594787.77
"9455",2017-12-05 12:43:13,646736.24,22241524.01
"9456",2017-12-06 02:30:42,576327.1,22817851.11
"9457",2017-12-06 03:40:44,398954.6,23216805.71
"9458",2017-12-06 04:43:05,475552.32,23692358.03
"9459",2017-12-06 06:13:53,336451.99,24028810.02
"9460",2017-12-06 09:19:44,-24028810.02,-3.72529029846191e-09
"9461",2017-12-06 10:14:59,655490.12,655490.119999996
"9462",2017-12-06 10:17:51,-655490.12,-3.72529029846191e-09
"9463",2017-12-06 10:52:46,1027320.5,1027320.5
"9464",2017-12-06 12:18:05,632880.25,1660200.75
"9465",2017-12-06 12:38:18,602835.07,2263035.82
"9466",2017-12-06 12:49:45,569176.4,2832212.22
"9467",2017-12-06 14:40:29,462940.58,3295152.8
"9468",2017-12-06 15:11:13,75822.77,3370975.57
"9469",2017-12-06 15:12:01,568153.27,3939128.84
"9470",2017-12-06 15:22:17,655103.77,4594232.61
"9471",2017-12-06 15:46:33,530958.72,5125191.33
"9472",2017-12-06 18:02:33,353871.58,5479062.91
"9473",2017-12-06 18:55:05,476259.86,5955322.77
"9474",2017-12-06 19:27:03,437139.17,6392461.94
"9475",2017-12-06 21:40:57,402190.13,6794652.07
"9476",2017-12-06 22:52:53,217172.64,7011824.71
"9477",2017-12-06 23:10:58,309355.11,7321179.82
"9478",2017-12-06 23:10:58,629769.5,7950949.32
"9479",2017-12-06 23:44:26,300958.14,8251907.46
"9480",2017-12-07 00:57:42,352794.56,8604702.02
"9481",2017-12-07 01:18:49,513388.33,9118090.35
"9482",2017-12-07 01:34:24,484259.69,9602350.04
"9483",2017-12-07 01:56:13,360274.64,9962624.68
"9484",2017-12-07 02:16:27,377704.6,10340329.28
"9485",2017-12-07 02:36:47,652856.55,10993185.83
"9486",2017-12-07 02:53:19,426062.12,11419247.95
"9487",2017-12-07 02:53:19,336847.54,11756095.49
"9488",2017-12-07 03:05:45,314343.01,12070438.5
"9489",2017-12-07 03:29:21,724091.61,12794530.11
"9490",2017-12-07 03:46:55,450218.82,13244748.93
"9491",2017-12-07 04:59:54,514409.61,13759158.54
"9492",2017-12-07 05:03:44,607221.75,14366380.29
"9493",2017-12-07 07:38:00,338832.23,14705212.52
"9494",2017-12-07 08:06:15,335334.85,15040547.37
"9495",2017-12-07 08:06:15,360739.39,15401286.76
"9496",2017-12-07 08:21:24,438294.39,15839581.15
"9497",2017-12-07 08:21:24,287135.58,16126716.73
"9498",2017-12-07 10:14:44,371130,16497846.73
"9499",2017-12-07 13:41:02,808062.17,17305908.9
"9500",2017-12-07 17:11:01,336164.67,17642073.57
"9501",2017-12-07 17:19:38,274354.04,17916427.61
"9502",2017-12-07 17:19:38,508308.7,18424736.31
"9503",2017-12-07 18:17:34,777865.9,19202602.21
"9504",2017-12-07 18:26:45,600581.99,19803184.2
"9505",2017-12-07 18:59:17,777865.98,20581050.18
"9506",2017-12-07 18:59:17,396488.99,20977539.17
"9507",2017-12-07 21:35:23,888977,21866516.17
"9508",2017-12-07 21:35:23,888977.02,22755493.19
"9509",2017-12-07 21:35:23,888977.01,23644470.2
"9510",2017-12-08 03:35:00,777866.03,24422336.23
"9511",2017-12-08 03:35:00,68769.04,24491105.27
"9512",2017-12-08 03:57:54,777866.06,25268971.33
"9513",2017-12-08 03:57:54,777219.07,26046190.4
"9514",2017-12-08 03:57:54,777866.05,26824056.45
"9515",2017-12-08 05:02:23,777866.1,27601922.55
"9516",2017-12-08 05:02:23,777866.09,28379788.64
"9517",2017-12-08 05:02:23,22252.11,28402040.75
"9518",2017-12-08 05:03:43,777866.08,29179906.83
"9519",2017-12-08 07:44:27,777866.14,29957772.97
"9520",2017-12-08 07:44:27,91874.15,30049647.12
"9521",2017-12-08 07:44:27,777866.13,30827513.25
"9522",2017-12-08 07:44:27,777866.12,31605379.37
"9523",2017-12-08 19:33:42,523543.27,32128922.64
"9524",2017-12-08 21:14:34,523743.35,32652665.99
"9525",2017-12-08 23:55:00,771420.4,33424086.39
"9526",2017-12-09 00:32:37,777866.35,34201952.74
"9527",2017-12-09 00:32:37,381919.36,34583872.1
"9528",2017-12-09 02:16:55,7806.42,34591678.52
"9529",2017-12-09 02:16:55,777866.41,35369544.93
"9530",2017-12-09 02:32:38,763347.72,36132892.65
"9531",2017-12-09 03:43:09,625224.17,36758116.82
"9532",2017-12-09 05:25:34,540531.3,37298648.12
"9533",2017-12-09 06:07:24,649533.01,37948181.13
"9534",2017-12-09 06:07:24,733326.11,38681507.24
"9535",2017-12-09 07:03:05,548147.41,39229654.65
"9536",2017-12-09 07:06:21,777866.55,40007521.2
"9537",2017-12-09 07:06:21,16011.56,40023532.76
"9538",2017-12-09 08:30:40,893164.26,40916697.02
"9539",2017-12-09 09:30:15,545984.65,41462681.67
"9540",2017-12-09 09:30:15,777866.64,42240548.31
"9541",2017-12-09 09:30:15,777866.63,43018414.94
"9542",2017-12-09 09:52:55,777866.66,43796281.6
"9543",2017-12-09 09:52:55,777866.67,44574148.27
"9544",2017-12-09 09:52:55,23673.68,44597821.95
"9545",2017-12-09 12:46:47,497139.74,45094961.69
"9546",2017-12-09 13:20:45,777866.73,45872828.42
"9547",2017-12-09 13:55:28,18346.84,45891175.26
"9548",2017-12-09 14:36:42,734473.5,46625648.76
"9549",2017-12-09 17:27:40,388977.88,47014626.64
"9550",2017-12-09 17:37:35,777866.92,47792493.56
"9551",2017-12-09 17:54:21,777866.93,48570360.49
"9552",2017-12-09 18:19:21,777866.99,49348227.48
"9553",2017-12-09 20:25:08,888978.07,50237205.55
"9554",2017-12-09 20:25:08,888978.05,51126183.6
"9555",2017-12-09 23:01:34,888978.09,52015161.69
"9556",2017-12-09 23:05:02,463567.48,52478729.17
"9557",2017-12-09 23:08:20,685263.28,53163992.45
"9558",2017-12-10 05:17:31,-53163992.45,-2.23517417907715e-08
"9559",2017-12-10 05:52:07,79279.32,79279.3199999777
"9560",2017-12-10 05:52:07,777867.31,857146.629999978
"9561",2017-12-10 06:01:51,-857146.63,-2.22353264689445e-08
"9562",2017-12-10 06:57:37,419216.88,419216.879999978
"9563",2017-12-10 07:08:29,-419216.88,-2.22353264689445e-08
"9564",2017-12-10 08:19:52,564580.84,564580.839999978
"9565",2017-12-10 08:41:45,777867.38,1342448.21999998
"9566",2017-12-10 08:41:45,128747.39,1471195.60999998
"9567",2017-12-10 09:48:54,777867.41,2249063.01999998
"9568",2017-12-10 09:48:54,219769.42,2468832.43999998
"9569",2017-12-10 10:12:21,133828.45,2602660.88999998
"9570",2017-12-10 10:12:21,777867.44,3380528.32999998
"9571",2017-12-10 14:05:38,777867.49,4158395.81999998
"9572",2017-12-10 14:13:49,41415.5,4199811.31999998
"9573",2017-12-10 14:33:48,722611.55,4922422.86999998
"9574",2017-12-10 14:33:48,777867.54,5700290.40999998
"9575",2017-12-10 14:33:48,777867.58,6478157.98999998
"9576",2017-12-10 14:33:48,179044.59,6657202.57999998
"9577",2017-12-10 14:59:36,746030.51,7403233.08999998
"9578",2017-12-10 15:23:29,777867.67,8181100.75999998
"9579",2017-12-10 17:37:44,183069.68,8364170.43999998
"9580",2017-12-11 02:43:39,300090.81,8664261.24999998
"9581",2017-12-11 03:42:42,777867.82,9442129.06999998
"9582",2017-12-11 03:42:42,777867.84,10219996.91
"9583",2017-12-11 03:42:42,777867.83,10997864.74
"9584",2017-12-11 03:51:10,260464.85,11258329.59
"9585",2017-12-11 07:31:33,-11258329.59,-2.23517417907715e-08
"9586",2017-12-11 09:58:58,777868.21,777868.209999978
"9587",2017-12-11 09:58:58,777868.22,1555736.42999998
"9588",2017-12-11 09:58:58,777868.19,2333604.61999998
"9589",2017-12-11 10:00:39,777868.2,3111472.81999998
"9590",2017-12-11 10:04:15,165191.23,3276664.04999998
"9591",2017-12-11 10:14:55,777868.28,4054532.32999998
"9592",2017-12-11 12:37:41,104484.33,4159016.65999998
"9593",2017-12-11 12:37:41,777868.32,4936884.97999998
"9594",2017-12-11 13:49:02,722143.1,5659028.07999998
"9595",2017-12-11 14:34:37,664066.98,6323095.05999998
"9596",2017-12-11 14:46:09,634602.04,6957697.09999998
"9597",2017-12-11 15:31:45,335181.38,7292878.47999998
"9598",2017-12-11 15:31:45,777868.37,8070746.84999998
"9599",2017-12-11 15:31:45,777868.39,8848615.23999998
"9600",2017-12-11 15:31:45,192765.4,9041380.63999998
"9601",2017-12-11 16:59:05,729300.41,9770681.04999998
"9602",2017-12-11 20:23:45,944008.47,10714689.52
"9603",2017-12-11 20:23:45,849428.15,11564117.67
"9604",2017-12-11 21:11:24,32590.93,11596708.6
"9605",2017-12-11 21:30:22,7269.49,11603978.09
"9606",2017-12-11 21:45:12,61352.94,11665331.03
"9607",2017-12-11 21:45:12,149530,11814861.03
"9608",2017-12-11 21:45:12,7800.51,11822661.54
"9609",2017-12-11 21:59:36,240011.62,12062673.16
"9610",2017-12-11 22:45:27,164050.35,12226723.51
"9611",2017-12-11 23:57:47,5882.92,12232606.43
"9612",2017-12-11 23:57:47,1786.96,12234393.39
"9613",2017-12-12 01:52:17,1033.92,12235427.31
"9614",2017-12-12 02:16:57,31335.89,12266763.2
"9615",2017-12-12 02:29:24,25095.1,12291858.3
"9616",2017-12-12 03:27:22,20101.24,12311959.54
"9617",2017-12-12 04:05:14,17681.76,12329641.3
"9618",2017-12-12 04:05:14,744.75,12330386.05
"9619",2017-12-12 05:24:47,29030.13,12359416.18
"9620",2017-12-12 07:28:46,155227.34,12514643.52
"9621",2017-12-12 09:41:35,2762.29,12517405.81
"9622",2017-12-12 12:26:09,19264.59,12536670.4
"9623",2017-12-12 12:26:09,16984.69,12553655.09
"9624",2017-12-12 12:33:34,2182.77,12555837.86
"9625",2017-12-12 13:13:10,830.43,12556668.29
"9626",2017-12-12 13:24:28,17380.19,12574048.48
"9627",2017-12-12 14:26:35,25204.65,12599253.13
"9628",2017-12-12 17:59:37,11033.87,12610287
"9629",2017-12-12 18:43:00,24697.88,12634984.88
"9630",2017-12-12 22:22:31,15626.51,12650611.39
"9631",2017-12-13 00:20:16,24254.65,12674866.04
"9632",2017-12-13 00:20:16,9629.47,12684495.51
"9633",2017-12-13 01:08:29,3473.44,12687968.95
"9634",2017-12-13 01:08:29,987.48,12688956.43
"9635",2017-12-13 02:18:14,777869.83,13466826.26
"9636",2017-12-13 02:18:14,777868.46,14244694.72
"9637",2017-12-13 02:18:14,777869.77,15022564.49
"9638",2017-12-13 02:18:14,690391.5,15712955.99
"9639",2017-12-13 02:18:14,220826.47,15933782.46
"9640",2017-12-13 02:18:14,23730.49,15957512.95
"9641",2017-12-13 02:18:14,888980.81,16846493.76
"9642",2017-12-13 02:18:14,777868.48,17624362.24
"9643",2017-12-13 02:18:14,2578.3,17626940.54
"9644",2017-12-13 02:18:14,1657.21,17628597.75
"9645",2017-12-13 02:18:14,3936.2,17632533.95
"9646",2017-12-13 07:00:55,77870.7,17710404.65
"9647",2017-12-13 07:17:36,1073.55,17711478.2
"9648",2017-12-13 07:25:46,-17711478.2,-2.23517417907715e-08
"9649",2017-12-13 15:06:17,77872.42,77872.4199999776
"9650",2017-12-13 16:46:41,777872.61,855745.029999978
"9651",2017-12-13 16:46:41,777872.59,1633617.61999998
"9652",2017-12-13 16:46:41,777872.62,2411490.23999998
"9653",2017-12-13 16:46:41,777872.63,3189362.86999998
"9654",2017-12-13 16:58:16,53037.64,3242400.50999998
"9655",2017-12-13 16:58:16,777872.6,4020273.10999998
"9656",2017-12-13 17:13:05,47919.72,4068192.82999998
"9657",2017-12-13 17:13:05,777872.69,4846065.51999998
"9658",2017-12-13 17:13:05,777872.68,5623938.19999998
"9659",2017-12-13 17:13:05,777872.71,6401810.90999998
"9660",2017-12-13 17:13:05,777872.67,7179683.57999998
"9661",2017-12-13 17:13:05,777872.7,7957556.27999998
"9662",2017-12-13 17:37:02,777872.74,8735429.01999998
"9663",2017-12-13 18:01:54,888983.75,9624412.76999998
"9664",2017-12-13 18:01:54,888983.76,10513396.53
"9665",2017-12-13 18:01:54,888983.77,11402380.3
"9666",2017-12-13 19:15:38,247131.3,11649511.6
"9667",2017-12-13 20:09:30,11181.94,11660693.54
"9668",2017-12-13 20:10:58,15781.68,11676475.22
"9669",2017-12-13 20:21:26,15835.18,11692310.4
"9670",2017-12-13 21:01:02,7754.25,11700064.65
"9671",2017-12-13 21:32:24,777872.81,12477937.46
"9672",2017-12-13 22:02:22,777873.33,13255810.79
"9673",2017-12-13 22:12:55,888984.41,14144795.2
"9674",2017-12-13 22:24:26,888984.36,15033779.56
"9675",2017-12-13 22:24:26,246540.43,15280319.99
"9676",2017-12-13 22:24:26,777873.42,16058193.41
"9677",2017-12-13 22:24:26,888984.38,16947177.79
"9678",2017-12-13 22:24:26,777873.4,17725051.19
"9679",2017-12-13 23:17:42,888984.6,18614035.79
"9680",2017-12-13 23:55:16,88984.87,18703020.66
"9681",2017-12-14 00:17:34,173207.96,18876228.62
"9682",2017-12-14 00:48:08,88985.16,18965213.78
"9683",2017-12-14 00:52:56,88985.25,19054199.03
"9684",2017-12-14 01:52:06,4634.19,19058833.22
"9685",2017-12-14 02:13:58,2087.96,19060921.18
"9686",2017-12-14 04:49:06,16094.91,19077016.09
"9687",2017-12-14 05:30:54,5772.29,19082788.38
"9688",2017-12-14 05:55:39,8569.28,19091357.66
"9689",2017-12-14 06:10:30,1130.84,19092488.5
"9690",2017-12-14 08:11:40,582.08,19093070.58
"9691",2017-12-14 08:22:58,11546.52,19104617.1
"9692",2017-12-14 09:17:34,2811.24,19107428.34
"9693",2017-12-14 09:17:34,4853.95,19112282.29
"9694",2017-12-14 09:17:34,3965.39,19116247.68
"9695",2017-12-14 09:19:47,2280.21,19118527.89
"9696",2017-12-14 09:19:47,1482.84,19120010.73
"9697",2017-12-14 09:33:18,9901.86,19129912.59
"9698",2017-12-14 09:45:20,4483.14,19134395.73
"9699",2017-12-14 09:55:05,1323.27,19135719
"9700",2017-12-14 10:17:25,947.52,19136666.52
"9701",2017-12-14 10:36:43,1365.24,19138031.76
"9702",2017-12-14 10:36:43,1745.3,19139777.06
"9703",2017-12-14 10:36:43,309.83,19140086.89
"9704",2017-12-14 10:36:43,411.53,19140498.42
"9705",2017-12-14 10:55:27,888986.69,20029485.11
"9706",2017-12-14 11:14:20,888986.75,20918471.86
"9707",2017-12-14 11:14:20,888986.71,21807458.57
"9708",2017-12-14 11:14:20,888986.73,22696445.3
"9709",2017-12-14 12:10:21,637797.89,23334243.19
"9710",2017-12-14 12:10:21,777875.78,24112118.97
"9711",2017-12-14 12:10:21,634620.79,24746739.76
"9712",2017-12-14 13:15:22,859205.2,25605944.96
"9713",2017-12-14 13:15:22,1192716.32,26798661.28
"9714",2017-12-14 14:05:49,665711.06,27464372.34
"9715",2017-12-14 18:14:04,118659.74,27583032.08
"9716",2017-12-14 18:14:04,97029.19,27680061.27
"9717",2017-12-14 18:14:04,43665.5,27723726.77
"9718",2017-12-14 18:19:47,777876.08,28501602.85
"9719",2017-12-14 18:24:58,777876.11,29279478.96
"9720",2017-12-14 18:24:58,300090.34,29579569.3
"9721",2017-12-14 18:43:11,487854.95,30067424.25
"9722",2017-12-14 19:00:50,286139.18,30353563.43
"9723",2017-12-14 19:00:50,777876.17,31131439.6
"9724",2017-12-14 19:15:04,754944.59,31886384.19
"9725",2017-12-14 19:56:10,630809.83,32517194.02
"9726",2017-12-14 20:08:41,763771.22,33280965.24
"9727",2017-12-14 20:16:05,734030.85,34014996.09
"9728",2017-12-14 20:16:05,-33280965.24,734030.849999975
"9729",2017-12-14 20:30:50,-734030.85,-2.45636329054832e-08
"9730",2017-12-14 21:45:18,477622.69,477622.689999975
"9731",2017-12-14 22:32:28,821230.68,1298853.36999998
"9732",2017-12-14 23:05:13,-477622.69,821230.679999975
"9733",2017-12-14 23:05:13,-477622.69,343607.989999975
"9734",2017-12-14 23:05:13,27560.57,371168.559999975
"9735",2017-12-14 23:30:07,34400.68,405569.239999975
"9736",2017-12-14 23:30:07,-371168.56,34400.6799999755
"9737",2017-12-14 23:48:50,765528.63,799929.309999975
"9738",2017-12-14 23:48:50,777876.62,1577805.92999998
"9739",2017-12-14 23:48:50,777876.61,2355682.53999998
"9740",2017-12-15 00:29:23,412465.67,2768148.20999998
"9741",2017-12-15 00:29:23,777876.66,3546024.86999998
"9742",2017-12-15 04:12:49,-3546024.87,-2.46800482273102e-08
"9743",2017-12-15 06:00:36,995598.61,995598.609999975
"9744",2017-12-15 06:49:32,777876.88,1773475.48999998
"9745",2017-12-15 06:53:44,102168.89,1875644.37999998
"9746",2017-12-15 06:53:44,777876.87,2653521.24999998
"9747",2017-12-15 09:05:09,777876.93,3431398.17999998
"9748",2017-12-15 09:05:09,654783.94,4086182.11999998
"9749",2017-12-15 11:06:22,777877.04,4864059.15999998
"9750",2017-12-15 11:06:22,416761.05,5280820.20999998
"9751",2017-12-15 12:18:46,777877.15,6058697.35999998
"9752",2017-12-15 12:18:46,656071.16,6714768.51999998
"9753",2017-12-15 13:04:52,777877.26,7492645.77999998
"9754",2017-12-15 13:04:52,50559.27,7543205.04999998
"9755",2017-12-15 13:31:52,583218.43,8126423.47999998
"9756",2017-12-15 13:39:30,466286.82,8592710.29999997
"9757",2017-12-15 13:39:30,446315.37,9039025.66999997
"9758",2017-12-15 13:48:18,467967.06,9506992.72999997
"9759",2017-12-15 14:25:09,777877.4,10284870.13
"9760",2017-12-15 14:25:09,6612.41,10291482.54
"9761",2017-12-15 14:25:09,44325.28,10335807.82
"9762",2017-12-15 15:30:01,91973.07,10427780.89
"9763",2017-12-15 16:00:13,182323.81,10610104.7
"9764",2017-12-15 16:08:55,6922.47,10617027.17
"9765",2017-12-15 16:23:04,384504.68,11001531.85
"9766",2017-12-15 16:43:02,156393.97,11157925.82
"9767",2017-12-15 16:50:11,111654.41,11269580.23
"9768",2017-12-15 18:51:02,5824639.64,17094219.87
"9769",2017-12-16 06:46:56,-17094219.87,-2.60770320892334e-08
"9770",2017-12-16 12:51:05,777883.63,777883.629999974
"9771",2017-12-16 12:51:05,309997.66,1087881.28999997
"9772",2017-12-16 12:51:05,777883.62,1865764.90999997
"9773",2017-12-16 12:51:05,777883.59,2643648.49999997
"9774",2017-12-16 12:51:05,777883.65,3421532.14999997
"9775",2017-12-16 12:51:05,777883.6,4199415.74999997
"9776",2017-12-16 12:51:05,777883.64,4977299.38999997
"9777",2017-12-16 12:51:05,777883.61,5755182.99999997
"9778",2017-12-16 15:48:41,486065.78,6241248.77999997
"9779",2017-12-16 15:48:41,777883.77,7019132.54999997
"9780",2017-12-16 21:38:49,587887.86,7607020.40999998
"9781",2017-12-16 21:38:49,777883.85,8384904.25999997
"9782",2017-12-16 22:42:06,777883.88,9162788.13999997
"9783",2017-12-16 22:42:06,777883.87,9940672.00999997
"9784",2017-12-16 22:42:06,148517.89,10089189.9
"9785",2017-12-17 00:19:27,777883.91,10867073.81
"9786",2017-12-17 00:29:55,777883.92,11644957.73
"9787",2017-12-17 00:29:55,254334.93,11899292.66
"9788",2017-12-17 00:47:33,888994.96,12788287.62
"9789",2017-12-17 09:56:34,777884.21,13566171.83
"9790",2017-12-17 09:57:46,431269.22,13997441.05
"9791",2017-12-17 10:06:01,777884.2,14775325.25
"9792",2017-12-17 11:35:01,777884.28,15553209.53
"9793",2017-12-17 11:35:01,777884.29,16331093.82
"9794",2017-12-17 11:35:01,274604.3,16605698.12
"9795",2017-12-17 17:05:28,-16605698.12,-2.42143869400024e-08
"9796",2017-12-17 19:41:24,53850.76,53850.7599999758
"9797",2017-12-17 19:50:39,777884.5,831735.259999976
"9798",2017-12-17 19:50:39,558632.51,1390367.76999998
"9799",2017-12-17 19:55:12,-1390367.77,-2.42143869400024e-08
"9800",2017-12-17 21:12:52,1748969.99,1748969.98999998
"9801",2017-12-18 01:24:42,481424.67,2230394.65999998
"9802",2017-12-18 02:46:39,32245.95,2262640.60999998
"9803",2017-12-18 02:50:07,31621.69,2294262.29999998
"9804",2017-12-18 04:34:15,130881.59,2425143.88999998
"9805",2017-12-18 04:34:15,177968.89,2603112.77999998
"9806",2017-12-18 05:23:28,261476.77,2864589.54999998
"9807",2017-12-18 05:26:48,20234.57,2884824.11999998
"9808",2017-12-18 05:49:17,777884.65,3662708.76999998
"9809",2017-12-18 05:49:17,777884.61,4440593.37999998
"9810",2017-12-18 05:49:17,777884.62,5218477.99999998
"9811",2017-12-18 05:49:17,777884.66,5996362.65999998
"9812",2017-12-18 06:09:28,155280.59,6151643.24999998
"9813",2017-12-18 07:02:49,428184.16,6579827.40999998
"9814",2017-12-18 07:11:36,720557.63,7300385.03999998
"9815",2017-12-18 07:11:36,767680.27,8068065.30999998
"9816",2017-12-18 07:49:36,777885.07,8845950.37999998
"9817",2017-12-18 07:49:36,81120.08,8927070.45999998
"9818",2017-12-18 08:41:38,484713.15,9411783.60999998
"9819",2017-12-18 08:57:05,78495.12,9490278.72999998
"9820",2017-12-18 08:57:05,777885.11,10268163.84
"9821",2017-12-18 10:43:25,407848.27,10676012.11
"9822",2017-12-18 11:00:35,491768.88,11167780.99
"9823",2017-12-18 11:12:51,27567.27,11195348.26
"9824",2017-12-18 11:22:44,154369.13,11349717.39
"9825",2017-12-18 13:55:20,190095.26,11539812.65
"9826",2017-12-18 13:55:20,777885.25,12317697.9
"9827",2017-12-18 16:31:41,756187.85,13073885.75
"9828",2017-12-18 17:25:35,598081.85,13671967.6
"9829",2017-12-18 17:26:23,538119.07,14210086.67
"9830",2017-12-18 17:30:25,513351.63,14723438.3
"9831",2017-12-18 18:35:25,23317.33,14746755.63
"9832",2017-12-18 19:05:31,39328.46,14786084.09
"9833",2017-12-18 19:05:31,777885.44,15563969.53
"9834",2017-12-18 19:05:31,777885.45,16341854.98
"9835",2017-12-19 04:19:15,209.22,16342064.2
"9836",2017-12-19 04:19:15,777888.19,17119952.39
"9837",2017-12-19 04:19:15,38474.2,17158426.59
"9838",2017-12-19 04:19:15,777888.21,17936314.8
"9839",2017-12-19 04:40:18,136333.26,18072648.06
"9840",2017-12-19 04:40:18,777888.25,18850536.31
"9841",2017-12-19 05:53:42,777888.28,19628424.59
"9842",2017-12-19 05:53:42,246466.29,19874890.88
"9843",2017-12-19 07:23:44,1179512.23,21054403.11
"9844",2017-12-19 09:02:26,627659.64,21682062.75
"9845",2017-12-19 09:33:54,777888.36,22459951.11
"9846",2017-12-19 09:33:54,153236.37,22613187.48
"9847",2017-12-19 10:52:44,3597.85,22616785.33
"9848",2017-12-19 10:57:00,12217.2,22629002.53
"9849",2017-12-19 11:14:29,89420.75,22718423.28
"9850",2017-12-19 11:14:29,64563.52,22782986.8
"9851",2017-12-19 11:14:29,24710.46,22807697.26
"9852",2017-12-19 11:16:24,48720.35,22856417.61
"9853",2017-12-19 11:16:24,10526.92,22866944.53
"9854",2017-12-19 11:16:24,10556.53,22877501.06
"9855",2017-12-19 11:16:24,5275.69,22882776.75
"9856",2017-12-19 11:16:24,10395.47,22893172.22
"9857",2017-12-19 13:27:36,-22893172.22,-1.11758708953857e-08
"9858",2017-12-19 13:27:36,50462.63,50462.6299999888
"9859",2017-12-19 17:13:29,777888.85,828351.479999989
"9860",2017-12-19 17:13:29,475498.95,1303850.42999999
"9861",2017-12-19 22:38:34,122654.89,1426505.31999999
"9862",2017-12-19 22:38:34,777888.88,2204394.19999999
"9863",2017-12-19 22:38:34,777888.91,2982283.10999999
"9864",2017-12-19 23:35:35,777888.93,3760172.03999999
"9865",2017-12-20 05:05:35,247020.11,4007192.14999999
"9866",2017-12-20 05:05:35,743491.15,4750683.29999999
"9867",2017-12-20 05:05:35,504816.76,5255500.05999999
"9868",2017-12-20 05:08:24,751003.66,6006503.71999999
"9869",2017-12-20 05:35:32,290704.1,6297207.81999999
"9870",2017-12-20 05:35:32,777889.09,7075096.90999999
"9871",2017-12-20 09:10:36,300112.16,7375209.06999999
"9872",2017-12-20 09:14:21,300112.17,7675321.23999999
"9873",2017-12-20 10:15:04,777889.19,8453210.42999999
"9874",2017-12-20 11:53:10,300112.22,8753322.64999999
"9875",2017-12-20 19:12:02,-8753322.65,-1.11758708953857e-08
"9876",2017-12-20 19:55:26,389000.61,389000.609999989
"9877",2017-12-21 02:05:29,103218.19,492218.799999989
"9878",2017-12-21 03:26:33,228772.46,720991.259999989
"9879",2017-12-21 10:12:26,246165.6,967156.859999989
"9880",2017-12-21 10:12:26,442188.46,1409345.31999999
"9881",2017-12-21 21:19:44,550725.29,1960070.60999999
"9882",2017-12-21 21:40:10,777890.38,2737960.98999999
"9883",2017-12-21 21:40:10,640145.39,3378106.37999999
"9884",2017-12-21 22:29:48,777890.41,4155996.78999999
"9885",2017-12-22 00:09:57,413544.69,4569541.47999999
"9886",2017-12-22 00:09:57,777890.68,5347432.15999999
"9887",2017-12-22 00:26:14,342711.84,5690143.99999999
"9888",2017-12-22 00:59:39,85927.54,5776071.53999999
"9889",2017-12-22 00:59:39,40089.96,5816161.49999999
"9890",2017-12-22 00:59:39,184735.4,6000896.89999999
"9891",2017-12-22 00:59:39,236071.45,6236968.34999999
"9892",2017-12-22 00:59:39,171855.07,6408823.41999999
"9893",2017-12-22 01:53:51,311475.11,6720298.52999999
"9894",2017-12-22 01:53:51,173242.33,6893540.85999999
"9895",2017-12-22 02:03:46,150148.77,7043689.62999999
"9896",2017-12-22 02:10:28,167922.8,7211612.42999999
"9897",2017-12-22 02:10:28,142357.98,7353970.40999999
"9898",2017-12-22 02:18:02,155548.54,7509518.94999999
"9899",2017-12-22 03:08:12,294843.46,7804362.40999999
"9900",2017-12-22 03:08:12,554558.46,8358920.86999999
"9901",2017-12-22 04:25:39,427677.85,8786598.71999999
"9902",2017-12-22 05:09:09,149678.3,8936277.01999999
"9903",2017-12-22 05:09:09,179900.04,9116177.05999999
"9904",2017-12-22 05:09:09,135110.76,9251287.81999999
"9905",2017-12-22 05:21:20,230104.37,9481392.18999999
"9906",2017-12-22 05:44:31,120784.68,9602176.86999999
"9907",2017-12-22 05:44:31,110294.46,9712471.32999999
"9908",2017-12-22 05:44:31,136105.78,9848577.10999999
"9909",2017-12-22 05:44:31,91812.61,9940389.71999999
"9910",2017-12-22 05:44:31,32068.89,9972458.60999999
"9911",2017-12-22 05:44:31,94345.97,10066804.58
"9912",2017-12-22 06:16:31,128143.89,10194948.47
"9913",2017-12-22 06:32:40,8819.72,10203768.19
"9914",2017-12-22 06:32:40,7561.69,10211329.88
"9915",2017-12-22 06:32:40,57532.59,10268862.47
"9916",2017-12-22 06:32:40,32626.06,10301488.53
"9917",2017-12-22 06:32:40,39289.01,10340777.54
"9918",2017-12-22 06:36:28,17698.4,10358475.94
"9919",2017-12-22 06:36:28,32807.69,10391283.63
"9920",2017-12-22 06:36:28,49750.81,10441034.44
"9921",2017-12-22 06:59:54,180223.11,10621257.55
"9922",2017-12-22 06:59:54,138181.63,10759439.18
"9923",2017-12-22 10:20:06,300114.7,11059553.88
"9924",2017-12-22 16:17:35,294968.64,11354522.52
"9925",2017-12-22 19:20:37,231590.16,11586112.68
"9926",2017-12-22 19:20:37,191731.43,11777844.11
"9927",2017-12-22 19:20:37,190712.95,11968557.06
"9928",2017-12-22 19:20:37,383193.35,12351750.41
"9929",2017-12-22 19:20:37,653385.41,13005135.82
"9930",2017-12-22 21:31:58,189003.31,13194139.13
"9931",2017-12-23 01:53:46,245544.37,13439683.5
"9932",2017-12-23 02:01:26,261729.82,13701413.32
"9933",2017-12-23 02:31:41,100012.19,13801425.51
"9934",2017-12-23 04:16:40,338915.42,14140340.93
"9935",2017-12-23 04:16:40,376354.65,14516695.58
"9936",2017-12-23 05:07:37,530973.08,15047668.66
"9937",2017-12-23 05:31:13,545596.26,15593264.92
"9938",2017-12-23 08:55:02,415673.31,16008938.23
"9939",2017-12-23 10:01:31,-1303850.43,14705087.8
"9940",2017-12-23 10:01:31,-1303850.43,13401237.37
"9941",2017-12-23 10:01:31,-1303850.43,12097386.94
"9942",2017-12-23 10:01:31,107641.87,12205028.81
"9943",2017-12-23 10:01:31,-1303850.43,10901178.38
"9944",2017-12-23 10:03:47,16411.16,10917589.54
"9945",2017-12-23 10:03:47,16312.89,10933902.43
"9946",2017-12-23 10:03:47,-1303850.43,9630051.99999999
"9947",2017-12-23 11:12:43,233643.49,9863695.48999999
"9948",2017-12-23 11:26:49,59463.92,9923159.40999999
"9949",2017-12-23 11:31:51,233721.69,10156881.1
"9950",2017-12-23 13:05:48,258662.64,10415543.74
"9951",2017-12-23 14:57:54,241190.07,10656733.81
"9952",2017-12-23 15:00:18,431550.87,11088284.68
"9953",2017-12-23 15:00:18,271768.78,11360053.46
"9954",2017-12-23 15:15:58,588553.83,11948607.29
"9955",2017-12-23 16:05:10,240056.24,12188663.53
"9956",2017-12-23 16:20:26,178612.01,12367275.54
"9957",2017-12-23 16:20:26,192281.96,12559557.5
"9958",2017-12-23 16:42:29,284733.05,12844290.55
"9959",2017-12-23 16:42:29,323231.19,13167521.74
"9960",2017-12-23 17:11:18,218738.32,13386260.06
"9961",2017-12-23 17:11:18,188982.5,13575242.56
"9962",2017-12-23 17:11:18,195580.6,13770823.16
"9963",2017-12-23 17:11:18,217588.27,13988411.43
"9964",2017-12-23 18:55:39,173088.08,14161499.51
"9965",2017-12-23 18:55:39,77489.94,14238989.45
"9966",2017-12-23 19:14:05,359694.38,14598683.83
"9967",2017-12-23 19:51:43,179909.85,14778593.68
"9968",2017-12-23 20:11:12,201436.63,14980030.31
"9969",2017-12-23 20:25:03,164975.77,15145006.08
"9970",2017-12-23 21:05:09,252102.75,15397108.83
"9971",2017-12-23 21:17:56,223999.92,15621108.75
"9972",2017-12-23 21:42:37,155579.98,15776688.73
"9973",2017-12-23 22:37:48,134862.46,15911551.19
"9974",2017-12-23 22:37:48,234433.19,16145984.38
"9975",2017-12-23 22:37:48,275879.02,16421863.4
"9976",2017-12-23 22:37:48,163525.33,16585388.73
"9977",2017-12-23 22:55:10,457238.86,17042627.59
"9978",2017-12-23 22:55:10,302015.91,17344643.5
"9979",2017-12-23 23:15:00,514243.2,17858886.7
"9980",2017-12-23 23:15:00,364899.46,18223786.16
"9981",2017-12-23 23:15:00,777893.45,19001679.61
"9982",2017-12-23 23:50:33,206268.54,19207948.15
"9983",2017-12-23 23:50:33,777893.53,19985841.68
"9984",2017-12-23 23:50:33,557181.13,20543022.81
"9985",2017-12-24 00:03:00,579855.55,21122878.36
"9986",2017-12-24 00:55:43,603704.1,21726582.46
"9987",2017-12-24 00:55:43,596428.81,22323011.27
"9988",2017-12-24 00:55:43,620068.78,22943080.05
"9989",2017-12-24 00:58:00,33223.75,22976303.8
"9990",2017-12-24 00:58:00,17636.07,22993939.87
"9991",2017-12-24 01:20:11,451304.41,23445244.28
"9992",2017-12-24 01:56:08,751591.12,24196835.4
"9993",2017-12-24 02:32:40,30170.81,24227006.21
"9994",2017-12-24 02:32:40,504754.7,24731760.91
"9995",2017-12-24 02:32:40,777893.8,25509654.71
"9996",2017-12-24 02:35:55,45405.21,25555059.92
"9997",2017-12-24 02:56:49,440732.86,25995792.78
"9998",2017-12-24 02:56:49,732528.88,26728321.66
"9999",2017-12-24 03:05:30,607991.68,27336313.34
"10000",2017-12-24 03:29:38,409666.73,27745980.07
"10001",2017-12-24 03:29:38,567249.8,28313229.87
"10002",2017-12-24 04:02:21,139112.91,28452342.78
"10003",2017-12-24 04:43:04,470458.78,28922801.56
"10004",2017-12-24 04:43:04,97478.96,29020280.52
"10005",2017-12-24 04:51:23,527118.51,29547399.03
"10006",2017-12-24 06:18:12,474587.63,30021986.66
"10007",2017-12-24 06:18:12,430141.65,30452128.31
"10008",2017-12-24 07:18:56,387857.57,30839985.88
"10009",2017-12-24 07:18:56,468366.33,31308352.21
"10010",2017-12-24 07:36:31,18723.98,31327076.19
"10011",2017-12-24 07:37:41,382929.57,31710005.76
"10012",2017-12-24 08:00:23,549514.13,32259519.89
"10013",2017-12-24 10:21:19,377334.75,32636854.64
"10014",2017-12-24 12:42:36,46949.04,32683803.68
"10015",2017-12-24 13:11:48,362496.44,33046300.12
"10016",2017-12-24 13:27:59,414869.59,33461169.71
"10017",2017-12-24 14:59:17,592099.89,34053269.6
"10018",2017-12-24 15:55:17,289418.05,34342687.65
"10019",2017-12-24 16:33:25,231227.79,34573915.44
"10020",2017-12-24 16:43:40,324990.43,34898905.87
"10021",2017-12-24 16:43:40,384577.1,35283482.97
"10022",2017-12-24 17:49:34,286287.74,35569770.71
"10023",2017-12-24 18:19:26,666895.31,36236666.02
"10024",2017-12-24 18:46:53,300118.16,36536784.18
"10025",2017-12-24 19:14:25,274298.69,36811082.87
"10026",2017-12-24 20:21:59,407091.08,37218173.95
"10027",2017-12-24 20:36:53,394624.87,37612798.82
"10028",2017-12-24 21:15:12,709191.31,38321990.13
"10029",2017-12-24 21:15:12,277867.82,38599857.95
"10030",2017-12-25 00:12:38,317103.52,38916961.47
"10031",2017-12-25 00:12:38,347085.62,39264047.09
"10032",2017-12-25 00:25:09,24263.75,39288310.84
"10033",2017-12-25 01:02:01,284579.93,39572890.77
"10034",2017-12-25 01:56:01,388181.66,39961072.43
"10035",2017-12-25 05:00:09,404837.63,40365910.06
"10036",2017-12-25 05:00:09,269671.94,40635582
"10037",2017-12-25 05:00:09,340542.59,40976124.59
"10038",2017-12-25 05:35:09,328952.17,41305076.76
"10039",2017-12-25 05:35:09,26364.89,41331441.65
"10040",2017-12-25 08:03:18,300118.88,41631560.53
"10041",2017-12-25 08:03:18,287082.25,41918642.78
"10042",2017-12-25 08:29:20,346342.08,42264984.86
"10043",2017-12-25 08:29:20,613784.36,42878769.22
"10044",2017-12-25 08:46:18,366806.04,43245575.26
"10045",2017-12-25 08:46:18,659760.52,43905335.78
"10046",2017-12-25 09:13:39,284672.5,44190008.28
"10047",2017-12-25 10:18:32,422160.57,44612168.85
"10048",2017-12-25 12:29:50,289932.67,44902101.52
"10049",2017-12-25 12:29:50,406837.25,45308938.77
"10050",2017-12-25 13:03:42,267611.85,45576550.62
"10051",2017-12-25 13:03:42,391176.3,45967726.92
"10052",2017-12-25 13:59:10,93801.2,46061528.12
"10053",2017-12-25 13:59:10,382786.34,46444314.46
"10054",2017-12-25 13:59:10,777896.19,47222210.65
"10055",2017-12-25 13:59:10,393465.42,47615676.07
"10056",2017-12-25 14:31:15,383235.55,47998911.62
"10057",2017-12-25 14:31:15,383235.55,48382147.17
"10058",2017-12-25 15:22:44,439822.49,48821969.66
"10059",2017-12-25 15:49:35,247007.59,49068977.25
"10060",2017-12-25 16:51:32,249683.58,49318660.83
"10061",2017-12-25 18:01:43,404896.13,49723556.96
"10062",2017-12-25 18:24:37,317559.31,50041116.27
"10063",2017-12-25 18:26:10,300119.44,50341235.71
"10064",2017-12-25 18:59:19,290139.9,50631375.61
"10065",2017-12-25 18:59:19,304486.27,50935861.88
"10066",2017-12-25 19:12:33,313660.16,51249522.04
"10067",2017-12-25 19:24:37,315587.02,51565109.06
"10068",2017-12-25 19:35:11,277890.88,51842999.94
"10069",2017-12-25 20:58:35,401805.4,52244805.34
"10070",2017-12-25 20:58:35,382062.32,52626867.66
"10071",2017-12-25 20:58:35,343906.09,52970773.75
"10072",2017-12-25 21:05:01,49821.82,53020595.57
"10073",2017-12-25 21:20:09,311328.57,53331924.14
"10074",2017-12-25 23:07:50,345739.49,53677663.63
"10075",2017-12-25 23:56:49,379242.4,54056906.03
"10076",2017-12-26 00:28:12,282559.78,54339465.81
"10077",2017-12-26 00:57:21,559284.17,54898749.98
"10078",2017-12-26 02:03:16,302800.92,55201550.9
"10079",2017-12-26 02:38:39,172282.19,55373833.09
"10080",2017-12-26 03:12:41,152292.62,55526125.71
"10081",2017-12-26 03:31:57,204851.93,55730977.64
"10082",2017-12-26 03:58:31,246058.65,55977036.29
"10083",2017-12-26 04:13:20,263874.22,56240910.51
"10084",2017-12-26 05:25:54,384985.13,56625895.64
"10085",2017-12-26 05:25:54,62787.51,56688683.15
"10086",2017-12-26 05:30:05,240170.29,56928853.44
"10087",2017-12-26 05:38:20,291974.6,57220828.04
"10088",2017-12-26 06:14:47,591596.64,57812424.68
"10089",2017-12-26 06:54:52,-57812424.68,7.45058059692383e-09
"10090",2017-12-26 07:29:34,326054.39,326054.390000007
"10091",2017-12-26 07:37:32,430706.57,756760.960000007
"10092",2017-12-26 07:37:32,-326054.39,430706.570000007
"10093",2017-12-26 07:50:52,-430706.57,7.39237293601036e-09
"10094",2017-12-26 08:14:13,311287.97,311287.970000007
"10095",2017-12-26 08:21:50,234006.92,545294.890000007
"10096",2017-12-26 08:21:50,-311287.97,234006.920000007
"10097",2017-12-26 08:26:43,-234006.92,7.36326910555363e-09
"10098",2017-12-26 10:19:11,201089.7,201089.700000007
"10099",2017-12-26 10:31:08,-201089.7,7.36326910555363e-09
"10100",2017-12-26 10:54:43,197820.72,197820.720000007
"10101",2017-12-26 11:07:22,50639.75,248460.470000007
"10102",2017-12-26 11:07:22,-197820.72,50639.7500000074
"10103",2017-12-26 11:23:11,-50639.75,7.36326910555363e-09
"10104",2017-12-26 12:43:33,211709.61,211709.610000007
"10105",2017-12-26 13:03:13,-211709.61,7.36326910555363e-09
"10106",2017-12-26 13:50:32,211954.65,211954.650000007
"10107",2017-12-26 14:31:47,196525.78,408480.430000007
"10108",2017-12-26 14:37:09,-211954.65,196525.780000007
"10109",2017-12-26 17:26:35,72097.22,268623.000000007
"10110",2017-12-26 17:48:28,656144.42,924767.420000007
"10111",2017-12-26 17:55:11,370372.2,1295139.62000001
"10112",2017-12-26 17:55:11,224842.48,1519982.10000001
"10113",2017-12-26 18:53:17,26217.69,1546199.79000001
"10114",2017-12-26 18:53:17,252798.71,1798998.50000001
"10115",2017-12-26 20:23:38,373177.49,2172175.99000001
"10116",2017-12-26 20:23:38,241094.57,2413270.56000001
"10117",2017-12-26 21:15:14,503449.52,2916720.08000001
"10118",2017-12-26 21:23:07,44554.96,2961275.04000001
"10119",2017-12-26 21:52:04,262506.1,3223781.14000001
"10120",2017-12-26 21:52:04,233468.43,3457249.57000001
"10121",2017-12-26 22:10:54,261201.67,3718451.24000001
"10122",2017-12-26 22:10:54,266685.83,3985137.07000001
"10123",2017-12-26 23:31:50,326341.15,4311478.22000001
"10124",2017-12-26 23:31:50,337721.97,4649200.19000001
"10125",2017-12-27 00:04:11,313634.03,4962834.22000001
"10126",2017-12-27 01:16:04,351054.24,5313888.46000001
"10127",2017-12-27 05:27:35,644417.21,5958305.67000001
"10128",2017-12-27 06:54:01,-5958305.67,7.45058059692383e-09
"10129",2017-12-27 07:09:39,631945.55,631945.550000007
"10130",2017-12-27 07:26:35,610786.23,1242731.78000001
"10131",2017-12-27 07:26:35,-631945.55,610786.230000007
"10132",2017-12-27 07:41:35,-610786.23,7.45058059692383e-09
"10133",2017-12-27 07:49:09,628902.33,628902.330000007
"10134",2017-12-27 08:00:56,-628902.33,7.45058059692383e-09
"10135",2017-12-27 08:00:56,605371.33,605371.330000007
"10136",2017-12-27 08:07:23,-605371.33,7.45058059692383e-09
"10137",2017-12-27 08:20:33,1259556.78,1259556.78000001
"10138",2017-12-27 09:35:42,777898.88,2037455.66000001
"10139",2017-12-27 09:35:42,312017.89,2349473.55000001
"10140",2017-12-27 10:16:20,111650.01,2461123.56000001
"10141",2017-12-27 10:27:04,777898.93,3239022.49000001
"10142",2017-12-27 10:27:04,39281.94,3278304.43000001
"10143",2017-12-27 10:38:11,64335.01,3342639.44000001
"10144",2017-12-27 10:50:56,273352,3615991.44000001
"10145",2017-12-27 10:50:56,777898.99,4393890.43000001
"10146",2017-12-27 11:23:51,640196.73,5034087.16000001
"10147",2017-12-27 14:17:37,448427.96,5482515.12000001
"10148",2017-12-27 14:18:32,551824.49,6034339.61000001
"10149",2017-12-27 14:21:19,777899.11,6812238.72000001
"10150",2017-12-27 14:21:19,29618.12,6841856.84000001
"10151",2017-12-27 14:35:14,427237.58,7269094.42000001
"10152",2017-12-27 14:56:17,433258.32,7702352.74000001
"10153",2017-12-27 15:02:36,777899.18,8480251.92000001
"10154",2017-12-27 15:02:36,192035.19,8672287.11000001
"10155",2017-12-27 15:31:48,553199.85,9225486.96000001
"10156",2017-12-27 17:27:11,283952.59,9509439.55000001
"10157",2017-12-27 17:27:11,325391.28,9834830.83000001
"10158",2017-12-27 17:39:51,456284.7,10291115.53
"10159",2017-12-27 18:09:51,291487.08,10582602.61
"10160",2017-12-27 18:48:24,334138.75,10916741.36
"10161",2017-12-27 19:08:01,292545.85,11209287.21
"10162",2017-12-27 19:18:32,452151.67,11661438.88
"10163",2017-12-27 22:23:09,777899.61,12439338.49
"10164",2017-12-27 22:23:09,777899.6,13217238.09
"10165",2017-12-27 22:23:09,777899.59,13995137.68
"10166",2017-12-27 22:23:09,777899.62,14773037.3
"10167",2017-12-27 22:23:09,75247.63,14848284.93
"10168",2017-12-28 01:10:46,111617.33,14959902.26
"10169",2017-12-28 03:16:31,23109.24,14983011.5
"10170",2017-12-28 03:51:12,358580.75,15341592.25
"10171",2017-12-28 03:51:12,761614.29,16103206.54
"10172",2017-12-28 04:22:28,673782.47,16776989.01
"10173",2017-12-28 04:22:28,534672.92,17311661.93
"10174",2017-12-28 04:56:43,470065.98,17781727.91
"10175",2017-12-28 04:56:43,478914.02,18260641.93
"10176",2017-12-28 05:08:27,609894.26,18870536.19
"10177",2017-12-28 06:52:21,281304.58,19151840.77
"10178",2017-12-28 07:23:04,276613.01,19428453.78
"10179",2017-12-28 09:28:06,348360.81,19776814.59
"10180",2017-12-28 09:57:58,465998.62,20242813.21
"10181",2017-12-28 11:09:15,353044.56,20595857.77
"10182",2017-12-28 11:27:04,380240.98,20976098.75
"10183",2017-12-28 12:22:24,326267.81,21302366.56
"10184",2017-12-28 12:45:56,385430.75,21687797.31
"10185",2017-12-28 12:45:56,340395.8,22028193.11
"10186",2017-12-28 13:21:14,322606.81,22350799.92
"10187",2017-12-28 14:52:30,318155.63,22668955.55
"10188",2017-12-28 14:52:30,595002.26,23263957.81
"10189",2017-12-28 14:52:30,317511.77,23581469.58
"10190",2017-12-28 15:13:36,698984.42,24280454
"10191",2017-12-28 15:26:23,687267.82,24967721.82
"10192",2017-12-28 19:31:14,395936.68,25363658.5
"10193",2017-12-28 20:13:53,283450.16,25647108.66
"10194",2017-12-28 20:44:15,220237.32,25867345.98
"10195",2017-12-28 20:48:47,193689.93,26061035.91
"10196",2017-12-28 22:13:10,90467.5,26151503.41
"10197",2017-12-28 22:31:54,261624.07,26413127.48
"10198",2017-12-28 23:34:30,191840.39,26604967.87
"10199",2017-12-29 00:04:46,192024.75,26796992.62
"10200",2017-12-29 00:04:46,664139.3,27461131.92
"10201",2017-12-29 00:25:22,239420.05,27700551.97
"10202",2017-12-29 01:05:29,221794.44,27922346.41
"10203",2017-12-29 01:05:29,243347.71,28165694.12
"10204",2017-12-29 01:26:35,323433.77,28489127.89
"10205",2017-12-29 01:59:53,264978.36,28754106.25
"10206",2017-12-29 02:25:55,310179.78,29064286.03
"10207",2017-12-29 02:25:55,273470.02,29337756.05
"10208",2017-12-29 02:25:55,484702.35,29822458.4
"10209",2017-12-29 02:54:54,310989.19,30133447.59
"10210",2017-12-29 03:36:00,275940.4,30409387.99
"10211",2017-12-29 03:36:00,54153.11,30463541.1
"10212",2017-12-29 03:41:19,324975.38,30788516.48
"10213",2017-12-29 04:07:43,234698.96,31023215.44
"10214",2017-12-29 04:15:58,295189.33,31318404.77
"10215",2017-12-29 04:20:11,363039.35,31681444.12
"10216",2017-12-29 05:04:58,308581.18,31990025.3
"10217",2017-12-29 05:04:58,293879.91,32283905.21
"10218",2017-12-29 05:04:58,22554.97,32306460.18
"10219",2017-12-29 05:04:58,-31681444.12,625016.06000001
"10220",2017-12-29 05:12:29,-625016.06,9.77888703346252e-09
"10221",2017-12-29 05:34:50,337648.39,337648.39000001
"10222",2017-12-29 05:58:49,308285.67,645934.06000001
"10223",2017-12-29 05:58:49,299492.47,945426.53000001
"10224",2017-12-29 05:58:49,316107.62,1261534.15000001
"10225",2017-12-29 05:58:49,-337648.39,923885.76000001
"10226",2017-12-29 06:15:41,732944.96,1656830.72000001
"10227",2017-12-29 06:15:41,-923885.76,732944.96000001
"10228",2017-12-29 06:22:30,395088.72,1128033.68000001
"10229",2017-12-29 06:22:30,-732944.96,395088.72000001
"10230",2017-12-29 06:26:27,-395088.72,9.54605638980865e-09
"10231",2017-12-29 07:11:21,375838.52,375838.52000001
"10232",2017-12-29 07:48:46,407642.99,783481.51000001
"10233",2017-12-29 08:26:56,391645.68,1175127.19000001
"10234",2017-12-29 08:53:05,387219.89,1562347.08000001
"10235",2017-12-29 10:57:22,182061.21,1744408.29000001
"10236",2017-12-29 11:03:09,149149.97,1893558.26000001
"10237",2017-12-29 11:06:31,543604.66,2437162.92000001
"10238",2017-12-29 11:16:49,320908.41,2758071.33000001
"10239",2017-12-29 11:36:19,193509.68,2951581.01000001
"10240",2017-12-29 11:54:07,288548.51,3240129.52000001
"10241",2017-12-29 12:12:49,210917.86,3451047.38000001
"10242",2017-12-29 12:12:49,325272.41,3776319.79000001
"10243",2017-12-29 12:29:22,545807.8,4322127.59000001
"10244",2017-12-29 12:42:21,58843.15,4380970.74000001
"10245",2017-12-29 13:09:47,269280.63,4650251.37000001
"10246",2017-12-29 13:29:56,194440.72,4844692.09000001
"10247",2017-12-29 13:54:21,176556.87,5021248.96000001
"10248",2017-12-29 13:57:48,306316.04,5327565.00000001
"10249",2017-12-29 14:13:33,191046.78,5518611.78000001
"10250",2017-12-29 14:13:33,195176.39,5713788.17000001
"10251",2017-12-29 15:42:32,210183.43,5923971.60000001
"10252",2017-12-29 17:34:47,150116.45,6074088.05000001
"10253",2017-12-29 17:48:21,693040.71,6767128.76000001
"10254",2017-12-29 18:07:32,401736.47,7168865.23000001
"10255",2017-12-29 18:09:57,446723.5,7615588.73000001
"10256",2017-12-29 18:17:44,271922.34,7887511.07000001
"10257",2017-12-29 18:32:08,300126.66,8187637.73000001
"10258",2017-12-29 18:32:08,401783.09,8589420.82000001
"10259",2017-12-29 18:32:08,14515.88,8603936.70000001
"10260",2017-12-29 18:54:54,336492.54,8940429.24000001
"10261",2017-12-29 18:54:54,624382.65,9564811.89000001
"10262",2017-12-29 19:17:52,445727.97,10010539.86
"10263",2017-12-29 19:17:52,639963.84,10650503.7
"10264",2017-12-29 20:05:13,268161.79,10918665.49
"10265",2017-12-29 20:05:13,228012.64,11146678.13
"10266",2017-12-29 20:05:13,494608.44,11641286.57
"10267",2017-12-29 20:28:00,316524.34,11957810.91
"10268",2017-12-29 20:28:00,87648.09,12045459
"10269",2017-12-29 20:58:18,206461.31,12251920.31
"10270",2017-12-29 21:03:36,541724.39,12793644.7
"10271",2017-12-29 21:28:32,690499.9,13484144.6
"10272",2017-12-29 21:54:31,496602.56,13980747.16
"10273",2017-12-29 22:19:55,405730.46,14386477.62
"10274",2017-12-29 22:57:02,234574.98,14621052.6
"10275",2017-12-29 23:32:02,343101.73,14964154.33
"10276",2017-12-29 23:32:02,396191.01,15360345.34
"10277",2017-12-30 00:04:20,551176.54,15911521.88
"10278",2017-12-30 00:31:49,440149.53,16351671.41
"10279",2017-12-30 00:31:49,366359.62,16718031.03
"10280",2017-12-30 00:52:43,312034.8,17030065.83
"10281",2017-12-30 01:09:23,381092.32,17411158.15
"10282",2017-12-30 01:12:19,332926.2,17744084.35
"10283",2017-12-30 01:58:16,291593.85,18035678.2
"10284",2017-12-30 02:02:02,667260.2,18702938.4
"10285",2017-12-30 02:43:54,225670.06,18928608.46
"10286",2017-12-30 02:56:58,561768.24,19490376.7
"10287",2017-12-30 03:17:18,602271.78,20092648.48
"10288",2017-12-30 03:41:39,327533.59,20420182.07
"10289",2017-12-30 03:41:39,454068.93,20874251
"10290",2017-12-30 03:56:53,36540.46,20910791.46
"10291",2017-12-30 03:56:53,287189.04,21197980.5
"10292",2017-12-30 04:30:54,191713.15,21389693.65
"10293",2017-12-30 04:56:30,246299.65,21635993.3
"10294",2017-12-30 04:56:30,405991.3,22041984.6
"10295",2017-12-30 04:56:30,247159.99,22289144.59
"10296",2017-12-30 05:41:15,280891.76,22570036.35
"10297",2017-12-30 05:41:15,260598.87,22830635.22
"10298",2017-12-30 06:13:55,28426.95,22859062.17
"10299",2017-12-30 06:13:55,407205.9,23266268.07
"10300",2017-12-30 06:13:55,599121.23,23865389.3
"10301",2017-12-30 06:29:06,406570.46,24271959.76
"10302",2017-12-30 06:29:06,501560.92,24773520.68
"10303",2017-12-30 06:49:47,236128.38,25009649.06
"10304",2017-12-30 07:25:27,213565.62,25223214.68
"10305",2017-12-30 07:25:27,563293.97,25786508.65
"10306",2017-12-30 07:48:19,253018.62,26039527.27
"10307",2017-12-30 07:48:19,235528.54,26275055.81
"10308",2017-12-30 08:23:44,322176.96,26597232.77
"10309",2017-12-30 09:13:00,-26597232.77,1.11758708953857e-08
"10310",2017-12-30 10:10:55,296285.63,296285.630000011
"10311",2017-12-30 10:23:14,-296285.63,1.11758708953857e-08
"10312",2017-12-30 10:25:39,284838.36,284838.360000011
"10313",2017-12-30 10:32:34,404786.23,689624.590000011
"10314",2017-12-30 10:32:34,-284838.36,404786.230000011
"10315",2017-12-30 10:36:50,379618.15,784404.380000011
"10316",2017-12-30 10:39:18,-784404.38,1.11758708953857e-08
"10317",2017-12-30 11:19:49,512416.3,512416.300000011
"10318",2017-12-30 11:31:29,-512416.3,1.11758708953857e-08
"10319",2017-12-30 12:32:51,346943.83,346943.830000011
"10320",2017-12-30 12:32:51,331315.71,678259.540000011
"10321",2017-12-30 12:32:51,256735.85,934995.390000011
"10322",2017-12-30 13:06:03,626069.3,1561064.69000001
"10323",2017-12-30 13:31:04,344547.41,1905612.10000001
"10324",2017-12-30 13:31:04,317591.38,2223203.48000001
"10325",2017-12-30 13:47:11,245224.01,2468427.49000001
"10326",2017-12-30 14:12:24,300128.37,2768555.86000001
"10327",2017-12-30 14:12:24,233357.96,3001913.82000001
"10328",2017-12-30 14:40:55,404374.56,3406288.38000001
"10329",2017-12-30 14:40:55,319247.54,3725535.92000001
"10330",2017-12-30 15:02:10,318772.06,4044307.98000001
"10331",2017-12-30 15:02:10,251993.59,4296301.57000001
"10332",2017-12-30 15:18:12,413480.12,4709781.69000001
"10333",2017-12-30 16:23:30,26086.59,4735868.28000001
"10334",2017-12-30 16:28:51,405268.74,5141137.02000001
"10335",2017-12-30 16:34:06,305543.44,5446680.46000001
"10336",2017-12-30 17:16:51,275815.15,5722495.61000001
"10337",2017-12-30 17:16:51,268235.36,5990730.97000001
"10338",2017-12-30 17:23:09,265863.9,6256594.87000001
"10339",2017-12-30 18:13:58,233387.79,6489982.66000001
"10340",2017-12-30 18:13:58,489352.05,6979334.71000001
"10341",2017-12-30 18:34:35,305628.57,7284963.28000001
"10342",2017-12-30 19:08:04,416793.35,7701756.63000001
"10343",2017-12-30 19:08:04,343200.83,8044957.46000001
"10344",2017-12-30 19:29:15,348458.26,8393415.72000001
"10345",2017-12-30 19:41:56,309174.58,8702590.30000001
"10346",2017-12-30 19:41:56,330148.68,9032738.98000001
"10347",2017-12-30 20:11:10,271804.77,9304543.75000001
"10348",2017-12-30 20:11:10,340054.29,9644598.04000001
"10349",2017-12-30 20:11:10,235582.85,9880180.89000001
"10350",2017-12-30 20:30:31,411237.16,10291418.05
"10351",2017-12-30 21:01:49,420676.73,10712094.78
"10352",2017-12-30 21:14:33,200128.89,10912223.67
"10353",2017-12-30 21:50:02,285558.96,11197782.63
"10354",2017-12-30 22:47:24,359342.12,11557124.75
"10355",2017-12-30 22:47:24,311826.44,11868951.19
"10356",2017-12-30 23:26:46,464858.62,12333809.81
"10357",2017-12-31 00:52:15,275851.01,12609660.82
"10358",2017-12-31 00:52:15,276824.94,12886485.76
"10359",2017-12-31 01:28:38,295276.58,13181762.34
"10360",2017-12-31 01:28:38,414016.91,13595779.25
"10361",2017-12-31 02:07:54,362444.83,13958224.08
"10362",2017-12-31 02:26:39,541093.59,14499317.67
"10363",2017-12-31 02:47:35,437474.4,14936792.07
"10364",2017-12-31 02:47:35,500739.59,15437531.66
"10365",2017-12-31 02:56:35,337636.26,15775167.92
"10366",2017-12-31 03:04:31,549084.38,16324252.3
"10367",2017-12-31 03:04:31,343055.46,16667307.76
"10368",2017-12-31 03:32:22,305449.26,16972757.02
"10369",2017-12-31 03:32:22,442819.49,17415576.51
"10370",2017-12-31 04:34:25,263875.41,17679451.92
"10371",2017-12-31 05:30:49,306229.92,17985681.84
"10372",2017-12-31 06:52:33,342115.89,18327797.73
"10373",2017-12-31 07:09:58,384513.42,18712311.15
"10374",2017-12-31 09:11:12,378698,19091009.15
"10375",2017-12-31 11:33:25,391284.35,19482293.5
"10376",2017-12-31 12:23:25,250325.53,19732619.03
"10377",2017-12-31 12:32:38,586958.88,20319577.91
"10378",2017-12-31 12:32:38,473439.41,20793017.32
"10379",2017-12-31 13:33:42,343794.27,21136811.59
"10380",2017-12-31 16:03:38,37592.56,21174404.15
"10381",2017-12-31 16:22:44,530405.75,21704809.9
"10382",2017-12-31 16:22:44,471738.19,22176548.09
"10383",2017-12-31 17:34:06,599760.64,22776308.73
"10384",2017-12-31 18:53:15,338373.9,23114682.63
"10385",2017-12-31 18:53:15,405080.05,23519762.68
"10386",2017-12-31 20:50:39,428620.84,23948383.52
"10387",2017-12-31 20:50:39,34163.52,23982547.04
"10388",2017-12-31 21:41:43,538372.21,24520919.25
"10389",2017-12-31 21:47:32,302156.77,24823076.02
"10390",2017-12-31 22:57:33,400883.61,25223959.63
"10391",2018-01-01 01:02:03,533333.87,25757293.5
"10392",2018-01-01 01:44:42,57595.59,25814889.09
"10393",2018-01-01 03:02:24,49009.32,25863898.41
"10394",2018-01-01 03:20:30,511005.74,26374904.15
"10395",2018-01-01 04:10:24,372022.02,26746926.17
"10396",2018-01-01 04:51:50,435260.34,27182186.51
"10397",2018-01-01 05:09:13,579742.68,27761929.19
"10398",2018-01-01 05:45:32,392592.67,28154521.86
"10399",2018-01-01 09:19:16,62570.18,28217092.04
"10400",2018-01-01 10:43:34,430566.2,28647658.24
"10401",2018-01-01 11:47:10,195304.55,28842962.79
"10402",2018-01-01 11:47:10,777907.54,29620870.33
"10403",2018-01-01 11:51:20,538637.3,30159507.63
"10404",2018-01-01 12:35:55,396420.94,30555928.57
"10405",2018-01-01 12:55:58,570561.11,31126489.68
"10406",2018-01-01 12:55:58,413247.78,31539737.46
"10407",2018-01-01 13:11:52,387294.04,31927031.5
"10408",2018-01-01 13:42:19,373681.44,32300712.94
"10409",2018-01-01 14:26:21,27094.85,32327807.79
"10410",2018-01-01 15:23:38,200130.8,32527938.59
"10411",2018-01-01 15:23:38,292593.65,32820532.24
"10412",2018-01-01 15:23:38,382644.96,33203177.2
"10413",2018-01-01 15:58:25,363939,33567116.2
"10414",2018-01-01 16:13:26,37004.97,33604121.17
"10415",2018-01-01 16:13:26,365912.56,33970033.73
"10416",2018-01-01 16:43:08,378006.42,34348040.15
"10417",2018-01-01 16:43:08,401670.04,34749710.19
"10418",2018-01-01 16:43:08,333616.36,35083326.55
"10419",2018-01-01 16:49:12,564253.18,35647579.73
"10420",2018-01-01 17:41:06,362476.12,36010055.85
"10421",2018-01-01 19:17:32,481360.32,36491416.17
"10422",2018-01-01 19:37:00,510849.97,37002266.14
"10423",2018-01-01 19:37:00,527806.37,37530072.51
"10424",2018-01-01 19:45:36,681422.63,38211495.14
"10425",2018-01-01 20:25:47,379169.06,38590664.2
"10426",2018-01-01 21:16:52,386281.18,38976945.38
"10427",2018-01-01 23:53:05,716375.11,39693320.49
"10428",2018-01-02 00:37:08,777908.15,40471228.64
"10429",2018-01-02 00:37:08,12748.16,40483976.8
"10430",2018-01-02 05:39:04,462007.82,40945984.62
"10431",2018-01-02 10:41:58,618381.98,41564366.6
"10432",2018-01-02 11:01:33,446032.06,42010398.66
"10433",2018-01-02 12:29:03,441906.1,42452304.76
"10434",2018-01-02 13:11:03,490272.15,42942576.91
"10435",2018-01-02 13:11:03,1275823,44218399.91
"10436",2018-01-02 13:35:16,305910.69,44524310.6
"10437",2018-01-02 13:35:16,777908.68,45302219.28
"10438",2018-01-02 16:20:51,573667.56,45875886.84
"10439",2018-01-02 17:03:58,703403.77,46579290.61
"10440",2018-01-02 17:33:04,619569.05,47198859.66
"10441",2018-01-02 20:24:29,777909.01,47976768.67
"10442",2018-01-02 20:24:29,309641.02,48286409.69
"10443",2018-01-02 20:55:49,73031.06,48359440.75
"10444",2018-01-02 20:55:49,777909.05,49137349.8
"10445",2018-01-02 23:27:05,455997.29,49593347.09
"10446",2018-01-02 23:46:54,200118.19,49793465.28
"10447",2018-01-02 23:46:54,777909.18,50571374.46
"10448",2018-01-02 23:46:54,581627.87,51153002.33
"10449",2018-01-03 08:49:13,34025.44,51187027.77
"10450",2018-01-03 08:49:13,777909.43,51964937.2
"10451",2018-01-03 08:49:13,-51153002.33,811934.870000005
"10452",2018-01-03 08:54:17,666193.72,1478128.59
"10453",2018-01-03 08:54:17,386608.98,1864737.57
"10454",2018-01-03 09:08:27,-811934.87,1052802.7
"10455",2018-01-03 09:17:57,-1052802.7,4.88944351673126e-09
"10456",2018-01-03 10:17:41,585573.8,585573.800000005
"10457",2018-01-03 10:17:41,508651.57,1094225.37000001
"10458",2018-01-03 10:21:01,-1094225.37,4.88944351673126e-09
"10459",2018-01-03 10:47:20,421684.81,421684.810000005
"10460",2018-01-03 10:51:06,-421684.81,4.88944351673126e-09
"10461",2018-01-03 11:50:09,649887.53,649887.530000005
"10462",2018-01-03 11:55:32,-649887.53,4.88944351673126e-09
"10463",2018-01-03 13:30:04,505852.03,505852.030000005
"10464",2018-01-03 13:36:02,-505852.03,4.88944351673126e-09
"10465",2018-01-03 13:40:20,587018.74,587018.740000005
"10466",2018-01-03 13:45:25,-587018.74,4.88944351673126e-09
"10467",2018-01-03 14:10:53,480303.94,480303.940000005
"10468",2018-01-03 14:17:47,766017.67,1246321.61
"10469",2018-01-03 14:25:14,633173.01,1879494.62000001
"10470",2018-01-03 14:47:51,556017.17,2435511.79000001
"10471",2018-01-03 14:59:17,663851.8,3099363.59000001
"10472",2018-01-03 15:06:15,634085.59,3733449.18000001
"10473",2018-01-03 15:27:24,591782.12,4325231.30000001
"10474",2018-01-03 15:47:53,588925.06,4914156.36
"10475",2018-01-03 17:24:47,609717.91,5523874.27000001
"10476",2018-01-03 18:46:02,636110.87,6159985.14000001
"10477",2018-01-03 19:43:45,509752.2,6669737.34000001
"10478",2018-01-03 21:50:00,595075.37,7264812.71000001
"10479",2018-01-04 01:55:47,569278.37,7834091.08000001
"10480",2018-01-04 02:22:23,714995.71,8549086.79000001
"10481",2018-01-04 03:45:51,622551.76,9171638.55000001
"10482",2018-01-04 09:10:04,314927.76,9486566.31000001
"10483",2018-01-04 09:10:04,213824.97,9700391.28000001
"10484",2018-01-04 09:35:09,518177.92,10218569.2
"10485",2018-01-04 10:29:35,442664.34,10661233.54
"10486",2018-01-04 10:29:35,438703.11,11099936.65
"10487",2018-01-04 10:29:35,462266.16,11562202.81
"10488",2018-01-04 10:53:29,427521.52,11989724.33
"10489",2018-01-04 11:11:24,647581.43,12637305.76
"10490",2018-01-04 11:11:24,473171.94,13110477.7
"10491",2018-01-04 11:24:21,547809.84,13658287.54
"10492",2018-01-04 12:01:03,545377.9,14203665.44
"10493",2018-01-04 12:18:11,447953.2,14651618.64
"10494",2018-01-04 13:13:41,611968.36,15263587
"10495",2018-01-04 15:36:10,36186.67,15299773.67
"10496",2018-01-04 15:36:10,777911.66,16077685.33
"10497",2018-01-04 15:36:10,616171.19,16693856.52
"10498",2018-01-04 15:48:12,573895.73,17267752.25
"10499",2018-01-04 15:48:12,439696.01,17707448.26
"10500",2018-01-04 16:17:25,539065.16,18246513.42
"10501",2018-01-04 16:49:49,523173.08,18769686.5
"10502",2018-01-04 16:57:00,394959.85,19164646.35
"10503",2018-01-04 19:32:52,777911.82,19942558.17
"10504",2018-01-04 19:32:52,294234.83,20236793
"10505",2018-01-04 20:38:17,547181.53,20783974.53
"10506",2018-01-04 21:30:28,278523.94,21062498.47
"10507",2018-01-04 21:30:28,777911.93,21840410.4
"10508",2018-01-05 01:46:13,486412.07,22326822.47
"10509",2018-01-05 01:56:49,563432.04,22890254.51
"10510",2018-01-05 02:04:39,522745.89,23413000.4
"10511",2018-01-05 02:25:21,644732.04,24057732.44
"10512",2018-01-05 02:25:21,540953.43,24598685.87
"10513",2018-01-05 02:25:21,462778,25061463.87
"10514",2018-01-05 02:57:56,622738.21,25684202.08
"10515",2018-01-05 04:20:30,494111.51,26178313.59
"10516",2018-01-05 04:20:30,509889.04,26688202.63
"10517",2018-01-05 06:24:14,525461.17,27213663.8
"10518",2018-01-05 08:03:23,595941.25,27809605.05
"10519",2018-01-05 08:44:33,532676.85,28342281.9
"10520",2018-01-05 09:09:08,285938.31,28628220.21
"10521",2018-01-05 09:09:08,777912.3,29406132.51
"10522",2018-01-05 09:17:08,-29406132.51,7.45058059692383e-09
"10523",2018-01-05 09:37:22,33870.33,33870.3300000075
"10524",2018-01-05 09:37:22,777912.32,811782.650000007
"10525",2018-01-05 09:37:22,784946.72,1596729.37000001
"10526",2018-01-05 09:46:37,-1596729.37,7.21774995326996e-09
"10527",2018-01-05 11:21:56,68278.25,68278.2500000072
"10528",2018-01-05 11:35:54,-68278.25,7.21774995326996e-09
"10529",2018-01-05 15:27:08,141210.6,141210.600000007
"10530",2018-01-05 15:27:08,22983.23,164193.830000007
"10531",2018-01-05 15:27:08,230198.78,394392.610000007
"10532",2018-01-05 15:27:08,169909.05,564301.660000007
"10533",2018-01-05 16:56:49,409519,973820.660000007
"10534",2018-01-05 17:58:47,296218.88,1270039.54000001
"10535",2018-01-05 19:11:18,545412.31,1815451.85000001
"10536",2018-01-05 22:07:24,200102.93,2015554.78000001
"10537",2018-01-05 22:07:24,17732.67,2033287.45000001
"10538",2018-01-05 22:45:19,280041.04,2313328.49000001
"10539",2018-01-05 22:45:19,42992.11,2356320.60000001
"10540",2018-01-05 23:18:04,55657.82,2411978.42000001
"10541",2018-01-06 00:17:50,348645.74,2760624.16000001
"10542",2018-01-06 00:28:18,83632.27,2844256.43000001
"10543",2018-01-06 00:51:35,158470.3,3002726.73000001
"10544",2018-01-06 00:51:35,39147.79,3041874.52000001
"10545",2018-01-06 00:51:35,108761.06,3150635.58000001
"10546",2018-01-06 01:17:36,424533.13,3575168.71000001
"10547",2018-01-06 02:05:16,19670.86,3594839.57000001
"10548",2018-01-06 03:09:02,126662.07,3721501.64000001
"10549",2018-01-06 04:08:04,184938.62,3906440.26000001
"10550",2018-01-06 04:08:04,777914.61,4684354.87000001
"10551",2018-01-06 04:23:35,284381.01,4968735.88000001
"10552",2018-01-06 04:44:33,13334.83,4982070.71000001
"10553",2018-01-06 05:15:24,105860.38,5087931.09000001
"10554",2018-01-06 05:15:24,16664.9,5104595.99000001
"10555",2018-01-06 05:26:32,13177.41,5117773.40000001
"10556",2018-01-06 06:03:37,222212.26,5339985.66000001
"10557",2018-01-06 06:04:06,306002.02,5645987.68000001
"10558",2018-01-06 06:27:45,464070.54,6110058.22000001
"10559",2018-01-06 06:32:27,247443.1,6357501.32000001
"10560",2018-01-06 07:36:18,365916.46,6723417.78000001
"10561",2018-01-06 10:39:55,370470.45,7093888.23000001
"10562",2018-01-06 10:51:01,602417.68,7696305.91000001
"10563",2018-01-06 11:20:21,49292.21,7745598.12000001
"10564",2018-01-06 11:26:10,570705.37,8316303.49000001
"10565",2018-01-06 13:11:36,136907.19,8453210.68000001
"10566",2018-01-06 13:24:51,86160.49,8539371.17000001
"10567",2018-01-06 13:43:12,505061.27,9044432.44000001
"10568",2018-01-06 13:43:12,245020.61,9289453.05000001
"10569",2018-01-06 14:00:02,152531.71,9441984.76000001
"10570",2018-01-06 14:00:02,294997.52,9736982.28000001
"10571",2018-01-06 14:00:02,103774.13,9840756.41000001
"10572",2018-01-06 15:18:21,776835.48,10617591.89
"10573",2018-01-06 15:29:21,250012.34,10867604.23
"10574",2018-01-06 15:55:07,64217.12,10931821.35
"10575",2018-01-06 16:23:03,554154.96,11485976.31
"10576",2018-01-06 20:54:07,294496.3,11780472.61
"10577",2018-01-06 21:15:10,274975.39,12055448
"10578",2018-01-07 01:36:47,265731.52,12321179.52
"10579",2018-01-07 01:36:47,304342.33,12625521.85
"10580",2018-01-07 05:24:32,79330.45,12704852.3
"10581",2018-01-07 05:24:32,221751.41,12926603.71
"10582",2018-01-07 05:24:32,69464.89,12996068.6
"10583",2018-01-07 05:33:04,390115.49,13386184.09
"10584",2018-01-07 05:54:33,561470.34,13947654.43
"10585",2018-01-07 05:58:53,-13947654.43,7.45058059692383e-09
"10586",2018-01-07 07:46:27,312997.48,312997.480000007
"10587",2018-01-07 07:54:24,-312997.48,7.45058059692383e-09
"10588",2018-01-07 08:08:58,295557.56,295557.560000007
"10589",2018-01-07 08:53:38,374545.88,670103.440000007
"10590",2018-01-07 11:32:51,507145.59,1177249.03000001
"10591",2018-01-07 12:05:31,399682.31,1576931.34000001
"10592",2018-01-07 13:29:43,491702.53,2068633.87000001
"10593",2018-01-07 13:35:26,510832.88,2579466.75000001
"10594",2018-01-07 13:35:26,475334.49,3054801.24000001
"10595",2018-01-07 13:53:40,419042.63,3473843.87000001
"10596",2018-01-07 18:20:24,455194.71,3929038.58000001
"10597",2018-01-07 18:48:37,272039.86,4201078.44000001
"10598",2018-01-07 19:02:55,189825.54,4390903.98000001
"10599",2018-01-07 19:02:55,120783.54,4511687.52000001
"10600",2018-01-07 19:02:55,244958.53,4756646.05000001
"10601",2018-01-07 19:02:55,34106.31,4790752.36000001
"10602",2018-01-07 19:07:55,405165.1,5195917.46000001
"10603",2018-01-07 19:30:05,42010.08,5237927.54000001
"10604",2018-01-07 19:30:05,13918.76,5251846.30000001
"10605",2018-01-07 19:42:14,76996.02,5328842.32000001
"10606",2018-01-07 19:56:22,261772.76,5590615.08000001
"10607",2018-01-07 20:38:09,119028.35,5709643.43000001
"10608",2018-01-07 20:38:09,63615.67,5773259.10000001
"10609",2018-01-07 20:38:09,18546.61,5791805.71000001
"10610",2018-01-07 20:38:09,77946.17,5869751.88000001
"10611",2018-01-07 20:38:09,27061.78,5896813.66000001
"10612",2018-01-07 20:42:43,184928.67,6081742.33000001
"10613",2018-01-07 20:42:43,430004.29,6511746.62000001
"10614",2018-01-07 20:42:43,486727.89,6998474.51000001
"10615",2018-01-07 20:42:43,266251,7264725.51000001
"10616",2018-01-07 22:11:16,437633.01,7702358.52000001
"10617",2018-01-07 22:37:34,79807.7,7782166.22000001
"10618",2018-01-08 06:51:13,400508.7,8182674.92000001
"10619",2018-01-08 09:49:16,322011,8504685.92000001
"10620",2018-01-08 09:49:16,24841.6,8529527.52000001
"10621",2018-01-08 10:10:44,551391.74,9080919.26000001
"10622",2018-01-08 10:46:31,140636.75,9221556.01000001
"10623",2018-01-08 11:47:06,642932.92,9864488.93000001
"10624",2018-01-08 11:59:49,155303.08,10019792.01
"10625",2018-01-08 11:59:49,640331.33,10660123.34
"10626",2018-01-08 11:59:49,242430.15,10902553.49
"10627",2018-01-08 11:59:49,302674.15,11205227.64
"10628",2018-01-08 12:33:29,325495.19,11530722.83
"10629",2018-01-08 12:55:47,233653.78,11764376.61
"10630",2018-01-08 13:07:09,141317.73,11905694.34
"10631",2018-01-08 13:07:09,21238.65,11926932.99
"10632",2018-01-08 13:07:09,75292.94,12002225.93
"10633",2018-01-08 13:07:09,86109.87,12088335.8
"10634",2018-01-08 13:41:50,17492.03,12105827.83
"10635",2018-01-08 13:41:50,257317.72,12363145.55
"10636",2018-01-08 13:54:50,222550.73,12585696.28
"10637",2018-01-08 13:54:50,777918.72,13363615
"10638",2018-01-08 13:54:50,19553.89,13383168.89
"10639",2018-01-08 14:02:30,777918.76,14161087.65
"10640",2018-01-08 14:02:30,189764.77,14350852.42
"10641",2018-01-08 14:48:30,606120.81,14956973.23
"10642",2018-01-08 14:48:30,225558.62,15182531.85
"10643",2018-01-08 14:48:30,28976.82,15211508.67
"10644",2018-01-08 14:48:30,275857.77,15487366.44
"10645",2018-01-08 14:48:30,193531.76,15680898.2
"10646",2018-01-08 14:48:30,46127.7,15727025.9
"10647",2018-01-08 14:48:30,47009.08,15774034.98
"10648",2018-01-08 14:48:30,777918.97,16551953.95
"10649",2018-01-08 14:57:59,85592.98,16637546.93
"10650",2018-01-08 15:01:00,30901.87,16668448.8
"10651",2018-01-08 15:29:48,168762.64,16837211.44
"10652",2018-01-08 15:29:48,163983.93,17001195.37
"10653",2018-01-08 15:29:48,572090.09,17573285.46
"10654",2018-01-08 15:35:25,278362.63,17851648.09
"10655",2018-01-08 15:55:57,71237.53,17922885.62
"10656",2018-01-08 15:55:57,103448.17,18026333.79
"10657",2018-01-08 16:26:45,138197.49,18164531.28
"10658",2018-01-08 16:26:45,46133.37,18210664.65
"10659",2018-01-08 17:46:17,352612.33,18563276.98
"10660",2018-01-08 17:46:17,251581.75,18814858.73
"10661",2018-01-08 18:27:50,373550.33,19188409.06
"10662",2018-01-08 18:30:15,176013.02,19364422.08
"10663",2018-01-08 19:24:56,119657.98,19484080.06
"10664",2018-01-08 20:16:20,556559.4,20040639.46
"10665",2018-01-08 20:19:34,344975.83,20385615.29
"10666",2018-01-08 20:35:17,295701.28,20681316.57
"10667",2018-01-08 20:35:17,460758.45,21142075.02
"10668",2018-01-08 20:35:17,621548.94,21763623.96
"10669",2018-01-08 20:35:17,310449.38,22074073.34
"10670",2018-01-08 21:15:03,703814.2,22777887.54
"10671",2018-01-08 22:44:07,777919.93,23555807.47
"10672",2018-01-08 22:44:07,49251.94,23605059.41
"10673",2018-01-08 22:44:07,142357.5,23747416.91
"10674",2018-01-08 23:21:12,340531.97,24087948.88
"10675",2018-01-08 23:21:12,777919.96,24865868.84
"10676",2018-01-08 23:53:36,777919.98,25643788.82
"10677",2018-01-09 00:08:43,339652.99,25983441.81
"10678",2018-01-09 01:00:22,777920.03,26761361.84
"10679",2018-01-09 01:00:22,215194.04,26976555.88
"10680",2018-01-09 01:36:49,280367.08,27256922.96
"10681",2018-01-09 01:36:49,777920.07,28034843.03
"10682",2018-01-09 03:30:49,28162.1,28063005.13
"10683",2018-01-09 03:30:49,101758.65,28164763.78
"10684",2018-01-09 04:27:30,48265.81,28213029.59
"10685",2018-01-09 04:34:38,43732.54,28256762.13
"10686",2018-01-09 04:34:38,14840.92,28271603.05
"10687",2018-01-09 04:34:38,25599.08,28297202.13
"10688",2018-01-09 04:34:38,109693.02,28406895.15
"10689",2018-01-09 04:34:38,265188.02,28672083.17
"10690",2018-01-09 04:34:38,47740.37,28719823.54
"10691",2018-01-09 04:50:36,777920.47,29497744.01
"10692",2018-01-09 04:50:36,22945.53,29520689.54
"10693",2018-01-09 04:50:36,54044.81,29574734.35
"10694",2018-01-09 04:50:36,426447.48,30001181.83
"10695",2018-01-09 04:50:36,45004.72,30046186.55
"10696",2018-01-09 04:50:36,25546.41,30071732.96
"10697",2018-01-09 04:50:36,23454.54,30095187.5
"10698",2018-01-09 05:48:15,777920.57,30873108.07
"10699",2018-01-09 05:53:05,147363.58,31020471.65
"10700",2018-01-09 06:22:40,144300.87,31164772.52
"10701",2018-01-09 06:22:40,91519.34,31256291.86
"10702",2018-01-09 06:22:40,232023.89,31488315.75
"10703",2018-01-09 07:23:57,468266.75,31956582.5
"10704",2018-01-09 07:50:48,496147.47,32452729.97
"10705",2018-01-09 07:50:48,666873.32,33119603.29
"10706",2018-01-09 09:39:48,-33119603.29,-7.45058059692383e-09
"10707",2018-01-09 10:57:22,320734.77,320734.769999993
"10708",2018-01-09 10:57:22,104987.74,425722.509999993
"10709",2018-01-09 10:57:22,40629.07,466351.579999993
"10710",2018-01-09 10:57:22,75733.14,542084.719999993
"10711",2018-01-09 10:57:22,31340.5,573425.219999993
"10712",2018-01-09 10:57:22,614765.81,1188191.02999999
"10713",2018-01-09 10:57:22,311878.07,1500069.09999999
"10714",2018-01-09 10:57:22,109094.6,1609163.69999999
"10715",2018-01-09 10:57:22,34110.78,1643274.47999999
"10716",2018-01-09 11:00:55,60802.04,1704076.51999999
"10717",2018-01-09 11:00:55,-1643274.48,60802.0399999928
"10718",2018-01-09 11:11:10,178383.05,239185.089999993
"10719",2018-01-09 11:11:10,777921.04,1017106.12999999
"10720",2018-01-09 11:11:10,71204.99,1088311.11999999
"10721",2018-01-09 11:11:10,116374.33,1204685.44999999
"10722",2018-01-09 11:11:10,21652,1226337.44999999
"10723",2018-01-09 11:11:10,17917.19,1244254.63999999
"10724",2018-01-09 11:11:10,-60802.04,1183452.59999999
"10725",2018-01-09 11:18:57,-1183452.6,-7.21774995326996e-09
"10726",2018-01-09 13:05:37,48013.64,48013.6399999928
"10727",2018-01-09 13:25:22,85664.12,133677.759999993
"10728",2018-01-09 13:25:22,777921.11,911598.869999993
"10729",2018-01-09 14:40:04,359040.01,1270638.87999999
"10730",2018-01-09 14:40:04,151033.77,1421672.64999999
"10731",2018-01-09 15:08:29,21287.32,1442959.96999999
"10732",2018-01-09 15:17:28,134514.71,1577474.67999999
"10733",2018-01-09 15:17:28,482241.37,2059716.04999999
"10734",2018-01-09 16:25:01,130538.08,2190254.12999999
"10735",2018-01-09 16:37:57,219431.05,2409685.17999999
"10736",2018-01-09 17:09:08,37996.35,2447681.52999999
"10737",2018-01-09 17:44:40,545037.39,2992718.91999999
"10738",2018-01-09 18:15:28,147292.52,3140011.43999999
"10739",2018-01-09 18:29:14,290115.89,3430127.32999999
"10740",2018-01-09 18:29:14,131893.44,3562020.76999999
"10741",2018-01-09 20:27:42,671305.92,4233326.68999999
"10742",2018-01-09 21:46:54,445787.75,4679114.43999999
"10743",2018-01-09 22:06:04,443299.42,5122413.85999999
"10744",2018-01-09 22:06:04,743399.76,5865813.61999999
"10745",2018-01-09 23:04:38,397549.58,6263363.19999999
"10746",2018-01-09 23:33:38,426727.15,6690090.34999999
"10747",2018-01-09 23:33:38,407882.32,7097972.66999999
"10748",2018-01-09 23:51:50,603341.37,7701314.03999999
"10749",2018-01-09 23:51:50,415174.06,8116488.09999999
"10750",2018-01-10 00:06:53,714069.22,8830557.31999999
"10751",2018-01-10 00:11:15,480139.68,9310696.99999999
"10752",2018-01-10 00:43:21,658463.55,9969160.54999999
"10753",2018-01-10 01:08:50,462256.46,10431417.01
"10754",2018-01-10 03:45:53,710326.89,11141743.9
"10755",2018-01-10 04:16:42,539846.5,11681590.4
"10756",2018-01-10 05:52:48,698096.52,12379686.92
"10757",2018-01-10 06:22:53,331058.33,12710745.25
"10758",2018-01-10 07:47:10,585119.81,13295865.06
"10759",2018-01-10 07:47:10,406870.62,13702735.68
"10760",2018-01-10 08:22:42,835846.16,14538581.84
"10761",2018-01-10 08:40:02,162453.76,14701035.6
"10762",2018-01-10 08:40:02,147369.07,14848404.67
"10763",2018-01-10 08:40:02,777924.06,15626328.73
"10764",2018-01-10 08:40:02,38978.22,15665306.95
"10765",2018-01-10 09:07:39,142141.17,15807448.12
"10766",2018-01-10 10:43:37,146647.16,15954095.28
"10767",2018-01-10 10:43:37,294832.14,16248927.42
"10768",2018-01-10 11:33:45,331610.24,16580537.66
"10769",2018-01-10 11:33:45,118368.35,16698906.01
"10770",2018-01-10 11:53:14,106516.16,16805422.17
"10771",2018-01-10 11:58:05,12756.72,16818178.89
"10772",2018-01-10 11:58:05,40796.51,16858975.4
"10773",2018-01-10 12:05:17,16120.07,16875095.47
"10774",2018-01-10 12:05:17,15568.64,16890664.11
"10775",2018-01-10 12:05:17,26840.06,16917504.17
"10776",2018-01-10 12:24:58,118040.44,17035544.61
"10777",2018-01-10 12:40:53,407780.63,17443325.24
"10778",2018-01-10 12:43:25,105808.83,17549134.07
"10779",2018-01-10 13:10:02,263078.01,17812212.08
"10780",2018-01-10 13:13:10,648516.93,18460729.01
"10781",2018-01-10 13:38:48,416884.76,18877613.77
"10782",2018-01-10 14:41:38,207016.83,19084630.6
"10783",2018-01-10 14:41:38,96166.01,19180796.61
"10784",2018-01-10 14:41:38,73844.82,19254641.43
"10785",2018-01-10 14:57:04,347595.7,19602237.13
"10786",2018-01-10 14:57:25,41083.64,19643320.77
"10787",2018-01-10 15:08:49,294588.34,19937909.11
"10788",2018-01-10 15:08:49,231358.05,20169267.16
"10789",2018-01-10 15:08:49,610098.59,20779365.75
"10790",2018-01-10 15:08:49,201180.46,20980546.21
"10791",2018-01-10 15:08:49,74986.64,21055532.85
"10792",2018-01-10 15:08:49,242869.21,21298402.06
"10793",2018-01-10 15:08:49,14177.47,21312579.53
"10794",2018-01-10 15:10:18,11920.36,21324499.89
"10795",2018-01-10 15:22:21,129850.01,21454349.9
"10796",2018-01-10 15:22:21,154657.21,21609007.11
"10797",2018-01-10 15:22:21,407800.34,22016807.45
"10798",2018-01-10 16:02:56,352656.85,22369464.3
"10799",2018-01-10 16:02:56,162138.23,22531602.53
"10800",2018-01-10 17:10:51,59064.49,22590667.02
"10801",2018-01-10 17:10:51,119989.95,22710656.97
"10802",2018-01-10 18:14:33,246951.37,22957608.34
"10803",2018-01-10 21:03:56,321865.41,23279473.75
"10804",2018-01-10 23:06:42,516423.77,23795897.52
"10805",2018-01-11 00:00:42,295595.36,24091492.88
"10806",2018-01-11 00:00:42,165112.91,24256605.79
"10807",2018-01-11 00:00:42,61075.42,24317681.21
"10808",2018-01-11 00:00:42,42657.61,24360338.82
"10809",2018-01-11 00:06:50,28941.29,24389280.11
"10810",2018-01-11 00:26:59,777925.29,25167205.4
"10811",2018-01-11 00:26:59,113545.82,25280751.22
"10812",2018-01-11 00:26:59,201846.3,25482597.52
"10813",2018-01-11 04:41:33,228343.92,25710941.44
"10814",2018-01-11 04:41:33,310446.7,26021388.14
"10815",2018-01-11 04:41:33,777925.68,26799313.82
"10816",2018-01-11 04:41:33,777925.69,27577239.51
"10817",2018-01-11 05:28:34,86184.97,27663424.48
"10818",2018-01-11 05:28:34,117014.82,27780439.3
"10819",2018-01-11 05:28:34,280865.52,28061304.82
"10820",2018-01-11 05:28:34,346843.22,28408148.04
"10821",2018-01-11 05:28:34,278608.67,28686756.71
"10822",2018-01-11 05:28:34,777925.81,29464682.52
"10823",2018-01-11 05:28:34,199975.03,29664657.55
"10824",2018-01-11 06:02:41,176467.7,29841125.25
"10825",2018-01-11 06:02:41,78705.5,29919830.75
"10826",2018-01-11 06:17:24,144028.38,30063859.13
"10827",2018-01-11 06:24:10,226327.42,30290186.55
"10828",2018-01-11 06:24:10,285350.81,30575537.36
"10829",2018-01-11 06:24:10,154011.95,30729549.31
"10830",2018-01-11 06:40:28,695367.11,31424916.42
"10831",2018-01-11 06:40:28,536171.02,31961087.44
"10832",2018-01-11 06:57:56,592811.76,32553899.2
"10833",2018-01-11 07:15:23,359010.69,32912909.89
"10834",2018-01-11 07:21:49,269557.12,33182467.01
"10835",2018-01-11 08:43:18,527177.51,33709644.52
"10836",2018-01-11 08:43:18,220635.87,33930280.39
"10837",2018-01-11 08:51:19,389652.49,34319932.88
"10838",2018-01-11 09:08:08,166316.77,34486249.65
"10839",2018-01-11 09:08:08,107547.82,34593797.47
"10840",2018-01-11 09:08:08,153253.88,34747051.35
"10841",2018-01-11 09:23:24,517301.43,35264352.78
"10842",2018-01-11 09:23:24,773833.85,36038186.63
"10843",2018-01-11 09:23:24,-34747051.35,1291135.28000001
"10844",2018-01-11 09:38:03,-1291135.28,8.61473381519318e-09
"10845",2018-01-11 10:29:58,734123.71,734123.710000009
"10846",2018-01-11 11:11:44,269071.26,1003194.97000001
"10847",2018-01-11 11:25:18,624250.88,1627445.85000001
"10848",2018-01-11 12:29:34,480697.06,2108142.91000001
"10849",2018-01-11 12:59:23,535989.59,2644132.50000001
"10850",2018-01-11 12:59:23,21878.44,2666010.94000001
"10851",2018-01-11 12:59:23,777926.43,3443937.37000001
"10852",2018-01-11 13:45:30,405264.49,3849201.86000001
"10853",2018-01-11 13:54:39,230416.49,4079618.35000001
"10854",2018-01-11 13:54:39,777926.48,4857544.83000001
"10855",2018-01-11 20:30:38,409967.87,5267512.70000001
"10856",2018-01-11 21:13:18,401242.14,5668754.84000001
"10857",2018-01-11 23:34:15,777927.07,6446681.91000001
"10858",2018-01-11 23:34:15,777927.08,7224608.99000001
"10859",2018-01-12 00:48:46,506280.81,7730889.80000001
"10860",2018-01-12 00:48:46,160028.76,7890918.56000001
"10861",2018-01-12 00:57:25,340040.24,8230958.80000001
"10862",2018-01-12 00:57:25,20638.86,8251597.66000001
"10863",2018-01-12 01:03:56,369787.01,8621384.67000001
"10864",2018-01-12 01:14:54,48367.08,8669751.75000001
"10865",2018-01-12 03:17:59,161997.53,8831749.28000001
"10866",2018-01-12 03:17:59,92665.73,8924415.01000001
"10867",2018-01-12 13:12:21,-8924415.01,9.31322574615479e-09
"10868",2018-01-12 13:48:20,15927.87,15927.8700000093
"10869",2018-01-12 14:03:44,-15927.87,9.31322574615479e-09
"10870",2018-01-12 14:03:44,322109.3,322109.300000009
"10871",2018-01-12 14:13:58,-322109.3,9.31322574615479e-09
"10872",2018-01-12 14:39:29,702489.97,702489.970000009
"10873",2018-01-12 15:02:18,-702489.97,9.31322574615479e-09
"10874",2018-01-13 01:33:12,436183.9,436183.900000009
"10875",2018-01-13 01:33:12,777927.9,1214111.80000001
"10876",2018-01-13 01:53:59,139142.91,1353254.71000001
"10877",2018-01-13 09:38:51,-1353254.71,9.31322574615479e-09
"10878",2018-01-13 13:27:07,383888.63,383888.630000009
"10879",2018-01-13 13:43:47,433972.77,817861.400000009
"10880",2018-01-13 13:43:47,527943.36,1345804.76000001
"10881",2018-01-13 16:44:02,63104.39,1408909.15000001
"10882",2018-01-13 17:01:53,251757.58,1660666.73000001
"10883",2018-01-13 17:32:18,1133927.85,2794594.58000001
"10884",2018-01-13 17:32:18,970784.09,3765378.67000001
"10885",2018-01-13 17:32:18,828906.63,4594285.30000001
"10886",2018-01-13 17:50:08,1206173.24,5800458.54000001
"10887",2018-01-14 06:14:30,147949.53,5948408.07000001
"10888",2018-01-14 07:57:22,1193120.8,7141528.87000001
"10889",2018-01-14 19:37:58,1777931.96,8919460.83000001
"10890",2018-01-14 19:37:58,1777931.97,10697392.8
"10891",2018-01-14 19:37:58,618909.98,11316302.78
"10892",2018-01-14 20:34:44,469691.43,11785994.21
"10893",2018-01-15 04:03:12,196500.48,11982494.69
"10894",2018-01-15 04:46:56,803491.29,12785985.98
"10895",2018-01-15 08:18:29,-12785985.98,1.11758708953857e-08
"10896",2018-01-15 08:35:22,110883.23,110883.230000011
"10897",2018-01-15 08:55:49,-110883.23,1.11758708953857e-08
"10898",2018-01-15 08:55:49,63117.26,63117.2600000112
"10899",2018-01-15 09:04:45,-63117.26,1.11758708953857e-08
"10900",2018-01-15 09:20:55,1484055.04,1484055.04000001
"10901",2018-01-15 09:25:36,-1484055.04,1.11758708953857e-08
"10902",2018-01-15 14:09:28,1253105.3,1253105.30000001
"10903",2018-01-15 14:09:28,1777934.29,3031039.59000001
"10904",2018-01-15 14:09:28,1777934.28,4808973.87000001
"10905",2018-01-15 15:42:26,1189168.96,5998142.83000001
"10906",2018-01-16 00:39:05,1525259.53,7523402.36000001
"10907",2018-01-16 02:42:34,345118.33,7868520.69000001
"10908",2018-01-16 03:10:08,165695.52,8034216.21000001
"10909",2018-01-16 03:10:08,678877.22,8713093.43000001
"10910",2018-01-16 04:21:15,1006587.27,9719680.70000001
"10911",2018-01-16 04:27:58,724617.92,10444298.62
"10912",2018-01-16 06:25:50,167365.3,10611663.92
"10913",2018-01-16 07:28:21,-10611663.92,1.11758708953857e-08
"10914",2018-01-16 07:58:27,146844.87,146844.870000011
"10915",2018-01-16 07:58:27,1777934.86,1924779.73000001
"10916",2018-01-16 08:14:37,1396105.48,3320885.21000001
"10917",2018-01-16 08:14:37,-1924779.73,1396105.48000001
"10918",2018-01-16 08:17:47,-1396105.48,1.11758708953857e-08
"10919",2018-01-16 09:08:53,459712.46,459712.460000011
"10920",2018-01-16 09:08:53,936051.83,1395764.29000001
"10921",2018-01-16 09:08:53,92103.08,1487867.37000001
"10922",2018-01-16 09:08:53,150211.88,1638079.25000001
"10923",2018-01-16 09:08:53,70550.57,1708629.82000001
"10924",2018-01-16 09:08:53,182128.9,1890758.72000001
"10925",2018-01-16 09:08:53,134580.17,2025338.89000001
"10926",2018-01-16 09:08:53,119887.01,2145225.90000001
"10927",2018-01-16 09:08:53,13336.4,2158562.30000001
"10928",2018-01-16 09:19:43,1679134.61,3837696.91000001
"10929",2018-01-16 09:19:43,329755.43,4167452.34000001
"10930",2018-01-16 09:19:43,141412.25,4308864.59000001
"10931",2018-01-16 09:19:43,-2158562.3,2150302.29000001
"10932",2018-01-16 10:02:36,1019846.82,3170149.11000001
"10933",2018-01-16 10:02:36,107383.01,3277532.12000001
"10934",2018-01-16 10:02:36,9696.19,3287228.31000001
"10935",2018-01-16 10:02:36,1755227.28,5042455.59000001
"10936",2018-01-16 10:02:36,-2150302.29,2892153.30000001
"10937",2018-01-16 10:12:50,-2892153.3,1.11758708953857e-08
"10938",2018-01-16 10:25:55,87580.57,87580.5700000112
"10939",2018-01-16 10:25:55,15313.23,102893.800000011
"10940",2018-01-16 10:25:55,29488,132381.800000011
"10941",2018-01-16 10:36:46,1322027,1454408.80000001
"10942",2018-01-16 10:36:46,40060.48,1494469.28000001
"10943",2018-01-16 10:36:46,248638.54,1743107.82000001
"10944",2018-01-16 10:36:46,9789.68,1752897.50000001
"10945",2018-01-16 10:44:34,718562.26,2471459.76000001
"10946",2018-01-16 13:31:58,1370748.11,3842207.87000001
"10947",2018-01-16 18:17:46,1737142.56,5579350.43000001
"10948",2018-01-16 18:49:23,1616450.93,7195801.36000001
"10949",2018-01-16 23:56:37,1777938.2,8973739.56000001
"10950",2018-01-16 23:56:37,989736.21,9963475.77000001
"10951",2018-01-17 02:55:39,852974.56,10816450.33
"10952",2018-01-17 03:05:54,1187986.64,12004436.97
"10953",2018-01-17 03:31:00,905340.15,12909777.12
"10954",2018-01-17 03:34:41,1392242.48,14302019.6
"10955",2018-01-17 04:55:12,1112880.39,15414899.99
"10956",2018-01-17 05:40:29,1598344.15,17013244.14
"10957",2018-01-17 06:38:44,1429939.33,18443183.47
"10958",2018-01-17 09:01:15,-18443183.47,1.49011611938477e-08
"10959",2018-01-17 10:51:56,159581.84,159581.840000015
"10960",2018-01-17 11:03:22,664247.47,823829.310000015
"10961",2018-01-17 11:30:05,979691.05,1803520.36000001
"10962",2018-01-17 12:54:50,615237.74,2418758.10000001
"10963",2018-01-17 12:54:50,647569.95,3066328.05000001
"10964",2018-01-17 12:54:50,405040.67,3471368.72000001
"10965",2018-01-17 12:54:50,755889.52,4227258.24000002
"10966",2018-01-17 12:54:50,58761.39,4286019.63000001
"10967",2018-01-17 14:45:45,1052530.46,5338550.09000001
"10968",2018-01-17 14:50:24,816189.88,6154739.97000001
"10969",2018-01-17 15:11:59,825217.09,6979957.06000001
"10970",2018-01-17 15:11:59,1205852.12,8185809.18000001
"10971",2018-01-17 15:54:16,1777938.94,9963748.12000001
"10972",2018-01-17 15:54:16,376048.95,10339797.07
"10973",2018-01-17 16:38:38,1294506.04,11634303.11
"10974",2018-01-17 16:38:38,1777939.03,13412242.14
"10975",2018-01-18 05:56:32,1777941.49,15190183.63
"10976",2018-01-18 05:56:32,1777941.48,16968125.11
"10977",2018-01-18 06:00:10,122628.5,17090753.61
"10978",2018-01-18 09:38:32,1097718.61,18188472.22
"10979",2018-01-18 11:11:23,1777941.73,19966413.95
"10980",2018-01-18 11:11:23,1685529.74,21651943.69
"10981",2018-01-18 15:26:49,1244837.68,22896781.37
"10982",2018-01-18 17:17:13,1777942.9,24674724.27
"10983",2018-01-18 17:17:13,1777942.91,26452667.18
"10984",2018-01-18 17:18:31,1777942.89,28230610.07
"10985",2018-01-18 17:37:50,1777942.87,30008552.94
"10986",2018-01-18 17:37:50,1777942.88,31786495.82
"10987",2018-01-18 17:37:50,1111279.92,32897775.74
"10988",2018-01-18 18:43:09,1777943.02,34675718.76
"10989",2018-01-18 18:43:09,1071307.03,35747025.79
"10990",2018-01-18 21:17:59,-35747025.79,1.49011611938477e-08
"10991",2018-01-18 21:44:52,17347.06,17347.0600000149
"10992",2018-01-18 21:44:52,11777.3,29124.3600000149
"10993",2018-01-18 21:53:29,-29124.36,1.49011611938477e-08
"10994",2018-01-18 23:29:20,1777943.3,1777943.30000001
"10995",2018-01-18 23:29:20,1266835.31,3044778.61000002
"10996",2018-01-18 23:36:14,-3044778.61,1.53668224811554e-08
"10997",2018-01-19 02:50:23,1708631.35,1708631.35000002
"10998",2018-01-19 13:41:00,1777943.34,3486574.69000002
"10999",2018-01-19 14:49:33,1777948.7,5264523.39000002
"11000",2018-01-19 15:36:58,1777948.71,7042472.10000002
"11001",2018-01-19 15:36:58,1777948.69,8820420.79000002
"11002",2018-01-19 15:36:58,1777948.68,10598369.47
"11003",2018-01-19 15:36:58,1777948.72,12376318.19
"11004",2018-01-19 15:36:58,1111285.73,13487603.92
"11005",2018-01-20 11:10:05,-13487603.92,1.67638063430786e-08
"11006",2018-01-21 08:14:02,1718264.94,1718264.94000002
"11007",2018-01-21 08:14:02,1999990.93,3718255.87000002
"11008",2018-01-21 08:48:42,1188390.97,4906646.84000002
"11009",2018-01-21 08:48:42,1999990.96,6906637.80000002
"11010",2018-01-21 10:19:49,1091415.11,7998052.91000002
"11011",2018-01-21 13:41:32,1815789.16,9813842.07000002
"11012",2018-01-21 16:29:07,1999991.45,11813833.52
"11013",2018-01-21 16:29:07,1746909.46,13560742.98
"11014",2018-01-21 21:45:41,1745919.59,15306662.57
"11015",2018-01-21 21:45:41,1999991.58,17306654.15
"11016",2018-01-22 06:53:07,488889.71,17795543.86
"11017",2018-01-22 14:39:26,1493707.8,19289251.66
"11018",2018-01-22 15:02:59,531926.79,19821178.45
"11019",2018-01-22 15:02:59,1999991.78,21821170.23
"11020",2018-01-22 21:41:54,1481767.91,23302938.14
"11021",2018-01-22 21:41:54,1999991.9,25302930.04
"11022",2018-01-22 22:02:26,1795280.93,27098210.97
"11023",2018-01-22 22:02:26,1999991.92,29098202.89
"11024",2018-01-23 00:02:28,1999991.97,31098194.86
"11025",2018-01-23 00:02:28,982680.98,32080875.84
"11026",2018-01-23 01:20:49,-32080875.84,1.49011611938477e-08
"11027",2018-01-23 03:27:28,1601808.02,1601808.02000001
"11028",2018-01-23 03:27:28,1999992.01,3601800.03000002
"11029",2018-01-23 03:37:01,-3601800.03,1.53668224811554e-08
"11030",2018-01-23 05:42:04,377780.53,377780.530000015
"11031",2018-01-23 07:38:37,1915697.07,2293477.60000002
"11032",2018-01-23 07:38:37,1999992.06,4293469.66000002
"11033",2018-01-23 13:49:32,979750.26,5273219.92000001
"11034",2018-01-23 19:50:31,962674.33,6235894.25000001
"11035",2018-01-23 19:50:31,1999994.32,8235888.57000002
"11036",2018-01-23 19:58:44,1999994.31,10235882.88
"11037",2018-01-25 05:16:52,-10235882.88,1.49011611938477e-08
"11038",2018-01-25 13:06:24,5056744.95,5056744.95000002
"11039",2018-01-25 20:37:47,777781.52,5834526.47000002
"11040",2018-01-26 13:16:01,777782.08,6612308.55000002
"11041",2018-01-26 13:41:05,499004.64,7111313.19000002
"11042",2018-01-27 03:15:25,4394321.93,11505635.12
"11043",2018-01-27 12:07:50,777782.66,12283417.78
"11044",2018-01-27 21:34:48,777782.89,13061200.67
"11045",2018-01-28 07:32:21,-13061200.67,1.67638063430786e-08
"11046",2018-02-01 01:35:57,888897.47,888897.470000017
"11047",2018-02-01 01:42:11,-888897.47,1.67638063430786e-08
"11048",2018-02-05 03:37:49,1136470.25,1136470.25000002
"11049",2018-02-05 03:46:54,-1136470.25,1.67638063430786e-08
"11050",2018-02-05 03:46:54,1741730.49,1741730.49000002
"11051",2018-02-05 04:03:57,-1741730.49,1.67638063430786e-08
"11052",2018-02-05 05:11:45,796628.06,796628.060000017
"11053",2018-02-05 05:11:45,1999999.05,2796627.11000002
"11054",2018-02-05 06:01:04,-2796627.11,1.72294676303864e-08
"11055",2018-02-05 10:30:47,138878.1,138878.100000017
"11056",2018-02-05 10:33:50,1999999.09,2138877.19000002
"11057",2018-02-05 10:33:50,1999999.07,4138876.26000002
"11058",2018-02-05 15:40:05,1999999.16,6138875.42000002
"11059",2018-02-05 15:40:05,1588052.17,7726927.59000002
"11060",2018-02-05 17:25:08,470075.12,8197002.71000002
"11061",2018-02-05 17:54:28,1999999.34,10197002.05
"11062",2018-02-05 18:05:38,1646357.35,11843359.4
"11063",2018-02-06 09:16:28,1999999.08,13843358.48
"11064",2018-02-07 19:37:58,-13843358.48,1.67638063430786e-08
"11065",2018-02-10 08:26:56,41390.92,41390.9200000168
"11066",2018-02-10 08:35:22,378340.09,419731.010000017
"11067",2018-02-10 08:54:17,732537.6,1152268.61000002
"11068",2018-02-10 10:43:18,568311.19,1720579.80000002
"11069",2018-02-10 15:03:45,111402.51,1831982.31000002
"11070",2018-02-10 15:29:29,496451.3,2328433.61000002
"11071",2018-02-10 17:10:20,633399.03,2961832.64000002
"11072",2018-02-10 17:10:20,428238.62,3390071.26000002
"11073",2018-02-10 18:30:38,856487.56,4246558.82000002
"11074",2018-02-10 19:15:41,807676.97,5054235.79000002
"11075",2018-02-10 21:42:47,362767.83,5417003.62000002
"11076",2018-02-10 21:43:39,270395.37,5687398.99000002
"11077",2018-02-10 21:51:07,436381.1,6123780.09000002
"11078",2018-02-10 23:31:23,451550.12,6575330.21000002
"11079",2018-02-10 23:54:45,342355.27,6917685.48000002
"11080",2018-02-11 01:58:49,248831.9,7166517.38000002
"11081",2018-02-11 03:24:23,27874.58,7194391.96000002
"11082",2018-02-11 03:24:23,239282.49,7433674.45000002
"11083",2018-02-11 04:17:02,153822.42,7587496.87000002
"11084",2018-02-11 04:17:02,232998.27,7820495.14000002
"11085",2018-02-11 04:18:01,163041.7,7983536.84000002
"11086",2018-02-11 05:02:19,262992.61,8246529.45000002
"11087",2018-02-11 05:25:29,164279.15,8410808.60000002
"11088",2018-02-11 05:51:10,225281.6,8636090.20000002
"11089",2018-02-11 06:09:36,86986.42,8723076.62000002
"11090",2018-02-11 06:30:43,822832.95,9545909.57000002
"11091",2018-02-11 06:45:02,164313.25,9710222.82000002
"11092",2018-02-11 07:00:15,213915.36,9924138.18000002
"11093",2018-02-11 07:00:45,236168.09,10160306.27
"11094",2018-02-11 07:08:55,205085.29,10365391.56
"11095",2018-02-11 07:18:49,376696.16,10742087.72
"11096",2018-02-11 08:07:13,778710.32,11520798.04
"11097",2018-02-11 08:07:13,577919.37,12098717.41
"11098",2018-02-11 08:16:20,880498.15,12979215.56
"11099",2018-02-11 08:41:44,954044.54,13933260.1
"11100",2018-02-11 08:41:44,848700.1,14781960.2
"11101",2018-02-11 10:05:14,974442.78,15756402.98
"11102",2018-02-11 11:44:17,953081.34,16709484.32
"11103",2018-02-11 12:29:29,749931.37,17459415.69
"11104",2018-02-11 13:46:07,922895.53,18382311.22
"11105",2018-02-11 21:50:23,872564.22,19254875.44
"11106",2018-02-11 23:30:32,326196.44,19581071.88
"11107",2018-02-12 00:12:30,2823066.25,22404138.13
"11108",2018-02-12 12:14:48,835190.59,23239328.72
"11109",2018-02-13 11:16:54,181420.93,23420749.65
"11110",2018-02-13 15:02:39,276143.96,23696893.61
"11111",2018-02-13 16:10:40,496186.11,24193079.72
"11112",2018-02-14 12:32:18,849727.51,25042807.23
"11113",2018-02-14 12:36:08,888896.98,25931704.21
"11114",2018-02-16 08:20:09,649127.24,26580831.45
"11115",2018-02-16 08:38:50,739530.85,27320362.3
"11116",2018-02-16 12:04:40,856837.11,28177199.41
"11117",2018-02-16 20:23:56,-28177199.41,1.86264514923096e-08
"11118",2018-02-16 22:38:02,482024.28,482024.280000019
"11119",2018-02-16 23:18:10,-482024.28,1.86264514923096e-08
"11120",2018-02-17 03:11:59,1535438.28,1535438.28000002
"11121",2018-02-17 03:29:00,-1535438.28,1.86264514923096e-08
"11122",2018-02-17 12:47:04,709034.99,709034.990000019
"11123",2018-02-17 12:58:24,-709034.99,1.86264514923096e-08
"11124",2018-02-17 16:45:05,1227513.01,1227513.01000002
"11125",2018-02-17 16:49:05,-1227513.01,1.86264514923096e-08
"11126",2018-02-17 23:00:05,1482604.52,1482604.52000002
"11127",2018-02-17 23:06:03,-1482604.52,1.86264514923096e-08
"11128",2018-02-17 23:26:08,1747975.22,1747975.22000002
"11129",2018-02-17 23:29:47,-1747975.22,1.86264514923096e-08
"11130",2018-02-18 01:02:55,1082161.32,1082161.32000002
"11131",2018-02-18 01:08:38,-1082161.32,1.86264514923096e-08
"11132",2018-02-18 01:51:21,487706.16,487706.160000019
"11133",2018-02-18 02:09:16,-487706.16,1.86264514923096e-08
"11134",2018-02-18 02:09:16,599994.39,599994.390000019
"11135",2018-02-18 02:33:41,-599994.39,1.86264514923096e-08
"11136",2018-02-18 02:48:29,1082981.75,1082981.75000002
"11137",2018-02-18 02:50:56,-1082981.75,1.86264514923096e-08
"11138",2018-02-18 06:13:33,1170739.9,1170739.90000002
"11139",2018-02-18 09:12:50,1245614.1,2416354.00000002
"11140",2018-02-18 12:29:00,397468.81,2813822.81000002
"11141",2018-02-18 13:34:47,961659.9,3775482.71000002
"11142",2018-02-18 16:58:48,608662.13,4384144.84000002
"11143",2018-02-18 17:30:38,766624.28,5150769.12000002
"11144",2018-02-18 19:37:43,484437.71,5635206.83000002
"11145",2018-02-18 20:16:53,1102439.51,6737646.34000002
"11146",2018-02-18 22:05:36,-6737646.34,1.86264514923096e-08
"11147",2018-02-19 07:40:17,547408.45,547408.450000019
"11148",2018-02-19 07:47:07,-547408.45,1.86264514923096e-08
"11149",2018-02-19 14:22:11,1428364.68,1428364.68000002
"11150",2018-02-19 14:29:56,-1428364.68,1.86264514923096e-08
"11151",2018-02-19 16:47:43,1393018.79,1393018.79000002
"11152",2018-02-19 16:52:16,-1393018.79,1.86264514923096e-08
"11153",2018-02-19 22:08:35,1140178.71,1140178.71000002
"11154",2018-02-19 22:14:31,-1140178.71,1.86264514923096e-08
"11155",2018-02-20 00:22:08,1988387.72,1988387.72000002
"11156",2018-02-20 00:38:52,-1988387.72,1.86264514923096e-08
"11157",2018-02-20 01:42:48,1398187.79,1398187.79000002
"11158",2018-02-20 02:07:07,-1398187.79,1.86264514923096e-08
"11159",2018-02-20 04:42:48,1094241.7,1094241.70000002
"11160",2018-02-20 04:56:02,-1094241.7,1.86264514923096e-08
"11161",2018-02-20 07:00:03,1306046.41,1306046.41000002
"11162",2018-02-20 07:07:10,-1306046.41,1.86264514923096e-08
"11163",2018-02-20 07:38:17,1163231.22,1163231.22000002
"11164",2018-02-20 07:48:22,-1163231.22,1.86264514923096e-08
"11165",2018-02-20 16:16:17,599995.51,599995.510000019
"11166",2018-02-20 16:37:35,258650.56,858646.070000019
"11167",2018-02-20 16:37:35,-599995.51,258650.560000019
"11168",2018-02-20 16:44:40,-258650.56,1.8684659153223e-08
"11169",2018-02-20 23:14:05,1405431.95,1405431.95000002
"11170",2018-02-20 23:21:02,-1405431.95,1.86264514923096e-08
"11171",2018-02-21 00:06:22,322541.11,322541.110000019
"11172",2018-02-21 00:06:22,362731.75,685272.860000019
"11173",2018-02-21 00:09:17,370787.7,1056060.56000002
"11174",2018-02-21 00:17:45,-1056060.56,1.86264514923096e-08
"11175",2018-02-21 00:29:18,408862.92,408862.920000019
"11176",2018-02-21 00:41:03,-408862.92,1.86264514923096e-08
"11177",2018-02-21 00:45:24,499995.95,499995.950000019
"11178",2018-02-21 00:45:24,499995.96,999991.910000019
"11179",2018-02-21 00:45:24,91248.97,1091240.88000002
"11180",2018-02-21 01:23:23,-1091240.88,1.88592821359634e-08
"11181",2018-02-21 04:26:00,422016.64,422016.640000019
"11182",2018-02-21 04:26:00,433409.46,855426.100000019
"11183",2018-02-21 04:26:00,1165965.38,2021391.48000002
"11184",2018-02-21 04:36:45,-2021391.48,1.88592821359634e-08
"11185",2018-02-21 07:47:21,434895.79,434895.790000019
"11186",2018-02-21 08:22:39,-434895.79,1.88592821359634e-08
"11187",2018-02-21 09:09:52,627016.32,627016.320000019
"11188",2018-02-21 09:24:19,-627016.32,1.88592821359634e-08
"11189",2018-02-21 09:45:18,26773.61,26773.6100000189
"11190",2018-02-21 10:01:26,-26773.61,1.88592821359634e-08
"11191",2018-02-21 12:23:31,302354.78,302354.780000019
"11192",2018-02-21 12:29:07,-302354.78,1.88592821359634e-08
"11193",2018-02-21 12:43:57,48154.19,48154.1900000189
"11194",2018-02-21 12:53:55,-48154.19,1.88592821359634e-08
"11195",2018-02-21 14:08:11,426870.82,426870.820000019
"11196",2018-02-21 14:08:11,291310.44,718181.260000019
"11197",2018-02-21 14:16:13,-718181.26,1.88592821359634e-08
"11198",2018-02-21 14:16:13,227554.58,227554.580000019
"11199",2018-02-21 14:16:13,236366.65,463921.230000019
"11200",2018-02-21 14:40:44,33103.77,497025.000000019
"11201",2018-02-21 14:40:44,-463921.23,33103.7700000189
"11202",2018-02-21 14:48:39,-33103.77,1.8881110008806e-08
"11203",2018-02-21 15:44:57,446086.48,446086.480000019
"11204",2018-02-21 16:02:48,-446086.48,1.88592821359634e-08
"11205",2018-02-21 16:02:48,235041.75,235041.750000019
"11206",2018-02-21 16:30:42,-235041.75,1.88592821359634e-08
"11207",2018-02-21 16:48:21,844960.37,844960.370000019
"11208",2018-02-21 16:56:21,-844960.37,1.88592821359634e-08
"11209",2018-02-21 16:56:21,503233,503233.000000019
"11210",2018-02-21 17:06:44,-503233,1.88592821359634e-08
"11211",2018-02-21 17:06:44,676726.68,676726.680000019
"11212",2018-02-21 17:17:32,-676726.68,1.88592821359634e-08
"11213",2018-02-21 20:39:12,375313.83,375313.830000019
"11214",2018-02-21 20:49:09,-375313.83,1.88592821359634e-08
"11215",2018-02-21 20:49:09,326171.89,326171.890000019
"11216",2018-02-21 20:49:09,777783.91,1103955.80000002
"11217",2018-02-21 20:58:25,-1103955.8,1.88592821359634e-08
"11218",2018-02-22 09:54:31,425528.24,425528.240000019
"11219",2018-02-22 09:54:31,599997.23,1025525.47000002
"11220",2018-02-22 10:02:15,-1025525.47,1.88592821359634e-08
"11221",2018-02-22 10:50:51,457183.32,457183.320000019
"11222",2018-02-22 11:13:54,-457183.32,1.88592821359634e-08
"11223",2018-02-22 11:46:52,301930.88,301930.880000019
"11224",2018-02-22 11:46:52,283843.78,585774.660000019
"11225",2018-02-22 11:56:16,-585774.66,1.88592821359634e-08
"11226",2018-02-22 12:04:46,874842.75,874842.750000019
"11227",2018-02-22 12:19:40,-874842.75,1.88592821359634e-08
"11228",2018-02-22 12:38:22,569177.23,569177.230000019
"11229",2018-02-22 12:54:02,-569177.23,1.88592821359634e-08
"11230",2018-02-22 13:12:13,638284.42,638284.420000019
"11231",2018-02-22 13:23:14,-638284.42,1.88592821359634e-08
"11232",2018-02-22 13:40:55,1733243.04,1733243.04000002
"11233",2018-02-22 13:57:04,-1733243.04,1.88592821359634e-08
"11234",2018-02-22 13:57:04,1055796,1055796.00000002
"11235",2018-02-22 14:44:36,-1055796,1.88592821359634e-08
"11236",2018-02-22 15:22:06,1608332.51,1608332.51000002
"11237",2018-02-22 15:56:31,-1608332.51,1.88592821359634e-08
"11238",2018-02-22 18:11:44,1355917.93,1355917.93000002
"11239",2018-02-22 18:28:57,-1355917.93,1.88592821359634e-08
"11240",2018-02-23 00:17:47,1220327.92,1220327.92000002
"11241",2018-02-23 00:24:23,-1220327.92,1.88592821359634e-08
"11242",2018-02-23 00:52:06,1343156.48,1343156.48000002
"11243",2018-02-23 01:00:15,-1343156.48,1.88592821359634e-08
"11244",2018-02-23 02:09:41,993488.5,993488.500000019
"11245",2018-02-23 02:29:53,-993488.5,1.88592821359634e-08
"11246",2018-02-23 03:56:50,1786024.31,1786024.31000002
"11247",2018-02-23 04:05:23,-1786024.31,1.88592821359634e-08
"11248",2018-02-23 13:30:44,528961.45,528961.450000019
"11249",2018-02-23 13:36:01,-528961.45,1.88592821359634e-08
"11250",2018-02-23 16:56:33,1043618.22,1043618.22000002
"11251",2018-02-23 17:05:43,-1043618.22,1.88592821359634e-08
"11252",2018-02-23 19:55:03,281888.93,281888.930000019
"11253",2018-02-23 20:21:27,-281888.93,1.88592821359634e-08
"11254",2018-02-23 20:25:49,234546.1,234546.100000019
"11255",2018-02-23 20:25:49,599998.09,834544.190000019
"11256",2018-02-23 20:37:45,-834544.19,1.88592821359634e-08
"11257",2018-02-23 22:30:18,464650.59,464650.590000019
"11258",2018-02-23 22:43:37,-464650.59,1.88592821359634e-08
"11259",2018-02-23 23:30:57,874317.11,874317.110000019
"11260",2018-02-23 23:39:59,-874317.11,1.88592821359634e-08
"11261",2018-02-24 07:16:16,531468.41,531468.410000019
"11262",2018-02-24 07:35:54,-531468.41,1.88592821359634e-08
"11263",2018-02-24 08:19:24,140444.5,140444.500000019
"11264",2018-02-24 08:31:55,-140444.5,1.88592821359634e-08
"11265",2018-02-24 11:46:15,428150.79,428150.790000019
"11266",2018-02-24 11:57:36,-428150.79,1.88592821359634e-08
"11267",2018-02-24 14:12:35,39027.58,39027.5800000189
"11268",2018-02-24 14:57:38,18417.02,57444.6000000189
"11269",2018-02-24 14:57:38,-39027.58,18417.0200000189
"11270",2018-02-24 14:57:38,191636.98,210054.000000019
"11271",2018-02-24 14:57:38,166346.69,376400.690000019
"11272",2018-02-24 15:03:53,-376400.69,1.88592821359634e-08
"11273",2018-02-24 16:44:39,135819.53,135819.530000019
"11274",2018-02-24 16:58:04,-135819.53,1.88592821359634e-08
"11275",2018-02-24 16:58:04,599009.64,599009.640000019
"11276",2018-02-24 17:07:42,-599009.64,1.88592821359634e-08
"11277",2018-02-24 17:20:58,555564.71,555564.710000019
"11278",2018-02-24 17:40:05,-555564.71,1.88592821359634e-08
"11279",2018-02-24 21:06:27,217247.98,217247.980000019
"11280",2018-02-24 23:14:08,777789.93,995037.910000019
"11281",2018-02-24 23:45:31,777789.99,1772827.90000002
"11282",2018-02-25 17:12:39,1076421.63,2849249.53000002
"11283",2018-02-25 18:51:59,602543.73,3451793.26000002
"11284",2018-02-25 19:21:19,65026.54,3516819.80000002
"11285",2018-02-25 20:12:09,667430.12,4184249.92000002
"11286",2018-02-26 08:54:47,1047270.66,5231520.58000002
"11287",2018-02-26 15:05:52,1369272.37,6600792.95000002
"11288",2018-03-05 09:31:52,1777781.73,8378574.68000002
"11289",2018-03-05 09:31:52,599004.8,8977579.48000002
"11290",2018-03-05 12:30:21,599994.85,9577574.33000002
"11291",2018-03-05 12:30:21,599994.84,10177569.17
"11292",2018-03-05 12:30:21,599994.83,10777564
"11293",2018-03-05 12:37:26,599994.89,11377558.89
"11294",2018-03-05 12:37:26,599994.88,11977553.77
"11295",2018-03-05 12:37:26,599994.91,12577548.68
"11296",2018-03-05 12:37:26,599994.9,13177543.58
"11297",2018-03-05 12:37:26,599994.87,13777538.45
"11298",2018-03-05 12:37:26,599994.86,14377533.31
"11299",2018-03-08 13:40:53,608694.31,14986227.62
"11300",2018-03-08 18:22:17,499996.85,15486224.47
"11301",2018-03-08 18:22:17,499996.86,15986221.33
"11302",2018-03-08 18:40:00,465179.91,16451401.24
"11303",2018-03-08 19:16:34,-16451401.24,1.86264514923096e-08
"11304",2018-03-08 19:45:28,1037632.44,1037632.44000002
"11305",2018-03-09 00:47:41,-1037632.44,1.86264514923096e-08
"11306",2018-03-09 10:28:07,599997.35,599997.350000019
"11307",2018-03-09 10:28:07,599997.34,1199994.69000002
"11308",2018-03-09 10:28:07,420859.36,1620854.05000002
"11309",2018-03-09 17:02:15,664359.08,2285213.13000002
"11310",2018-03-09 17:11:11,750113.28,3035326.41000002
"11311",2018-03-09 17:11:11,170420.81,3205747.22000002
"11312",2018-03-10 07:05:20,473776.44,3679523.66000002
"11313",2018-03-10 19:05:29,811082.81,4490606.47000002
"11314",2018-03-10 19:18:09,322217.74,4812824.21000002
"11315",2018-03-10 21:45:27,599998.16,5412822.37000002
"11316",2018-03-10 21:45:27,437515.17,5850337.54000002
"11317",2018-03-10 21:45:27,599998.15,6450335.69000002
"11318",2018-03-11 16:52:32,224364.17,6674699.86000002
"11319",2018-03-12 06:33:54,1786548.9,8461248.76000002
"11320",2018-03-12 15:31:18,1078311.23,9539559.99000002
"11321",2018-03-12 20:36:00,599999.03,10139559.02
"11322",2018-03-12 20:36:00,599999.04,10739558.06
"11323",2018-03-12 20:36:00,351127.05,11090685.11
"11324",2018-03-13 17:57:43,713433.09,11804118.2
"11325",2018-03-14 12:50:12,650399.13,12454517.33
"11326",2018-03-14 13:37:55,1083596.98,13538114.31
"11327",2018-03-14 14:49:49,499999.94,14038114.25
"11328",2018-03-14 14:49:49,266852.95,14304967.2
"11329",2018-03-14 16:20:09,6e+05,14904967.2
"11330",2018-03-14 16:20:09,599999.99,15504967.19
"11331",2018-03-14 16:30:46,599990.11,16104957.3
"11332",2018-03-14 16:30:46,599990.13,16704947.43
"11333",2018-03-14 16:30:46,599990.12,17304937.55
"11334",2018-03-14 17:01:21,217148.15,17522085.7
"11335",2018-03-14 17:01:21,599990.14,18122075.84
"11336",2018-03-14 17:12:47,499990.17,18622066.01
"11337",2018-03-14 17:12:47,191916.18,18813982.19
"11338",2018-03-14 19:49:23,679798.78,19493780.97
"11339",2018-03-15 00:08:52,504947.84,19998728.81
"11340",2018-03-15 01:37:52,1178879.29,21177608.1
"11341",2018-03-15 01:37:52,1298015.19,22475623.29
"11342",2018-03-15 04:40:03,175996.1,22651619.39
"11343",2018-03-15 05:35:45,456983.17,23108602.56
"11344",2018-03-15 06:13:47,234743.35,23343345.91
"11345",2018-03-15 06:20:03,177646.15,23520992.06
"11346",2018-03-15 06:35:53,373015.1,23894007.16
"11347",2018-03-15 07:39:04,208822.93,24102830.09
"11348",2018-03-15 08:21:01,58451.16,24161281.25
"11349",2018-03-15 08:29:14,282886.28,24444167.53
"11350",2018-03-15 10:14:17,43872.2,24488039.73
"11351",2018-03-15 10:40:00,41260.01,24529299.74
"11352",2018-03-15 10:40:00,20131.44,24549431.18
"11353",2018-03-15 10:40:00,499991.3,25049422.48
"11354",2018-03-15 10:40:00,300620.31,25350042.79
"11355",2018-03-15 11:14:52,156105.18,25506147.97
"11356",2018-03-15 11:57:58,170233.7,25676381.67
"11357",2018-03-15 14:47:56,818951.53,26495333.2
"11358",2018-03-15 14:47:56,393569.09,26888902.29
"11359",2018-03-15 14:49:21,554300.99,27443203.28
"11360",2018-03-15 15:07:50,173735.21,27616938.49
"11361",2018-03-15 15:07:50,73689.61,27690628.1
"11362",2018-03-15 15:07:50,164611.26,27855239.36
"11363",2018-03-15 15:07:50,309537.77,28164777.13
"11364",2018-03-15 15:18:33,120604.77,28285381.9
"11365",2018-03-15 15:18:33,269233.78,28554615.68
"11366",2018-03-15 15:52:04,167493.79,28722109.47
"11367",2018-03-15 15:52:04,201461.92,28923571.39
"11368",2018-03-15 15:52:04,632256.47,29555827.86
"11369",2018-03-15 15:52:04,71694.91,29627522.77
"11370",2018-03-15 15:54:37,125830.23,29753353
"11371",2018-03-15 15:59:44,273963.74,30027316.74
"11372",2018-03-15 16:34:11,-30027316.74,3.35276126861572e-08
"11373",2018-03-15 16:48:47,647168.48,647168.480000034
"11374",2018-03-15 16:48:47,78908.32,726076.800000034
"11375",2018-03-15 16:48:47,499992.3,1226069.10000003
"11376",2018-03-15 16:48:47,499992.31,1726061.41000003
"11377",2018-03-15 16:48:47,329703.33,2055764.74000003
"11378",2018-03-15 17:13:36,111260.65,2167025.39000003
"11379",2018-03-15 17:13:36,-2055764.74,111260.650000034
"11380",2018-03-15 17:13:36,698635.71,809896.360000034
"11381",2018-03-15 17:13:36,439686.47,1249582.83000003
"11382",2018-03-15 17:13:36,500646.91,1750229.74000003
"11383",2018-03-15 17:24:28,-1750229.74,3.35276126861572e-08
"11384",2018-03-16 06:58:28,131882.82,131882.820000034
"11385",2018-03-16 06:58:28,499992.81,631875.630000034
"11386",2018-03-16 06:58:28,2573372.57,3205248.20000003
"11387",2018-03-16 08:22:06,162399.49,3367647.69000003
"11388",2018-03-16 08:34:37,3249752.32,6617400.01000003
"11389",2018-03-16 22:29:42,-6617400.01,3.35276126861572e-08
"11390",2018-03-17 09:11:12,2346830.34,2346830.34000003
"11391",2018-03-17 15:54:46,599993.66,2946824.00000003
"11392",2018-03-17 15:54:46,599993.67,3546817.67000003
"11393",2018-03-17 15:54:46,599993.64,4146811.31000003
"11394",2018-03-17 15:54:46,564022.68,4710833.99000003
"11395",2018-03-17 15:54:46,599993.65,5310827.64000003
"11396",2018-03-17 16:30:49,650749.7,5961577.34000003
"11397",2018-03-17 16:30:49,1999993.69,7961571.03000003
"11398",2018-03-17 23:36:50,-7961571.03,3.44589352607727e-08
"11399",2018-03-18 15:50:19,456386.27,456386.270000034
"11400",2018-03-18 15:50:19,599994.24,1056380.51000003
"11401",2018-03-18 15:50:19,599994.26,1656374.77000003
"11402",2018-03-18 15:50:19,599994.25,2256369.02000003
"11403",2018-03-18 16:05:45,-2256369.02,3.44589352607727e-08
"11404",2018-03-18 17:52:19,599994.34,599994.340000034
"11405",2018-03-18 17:52:19,599994.31,1199988.65000003
"11406",2018-03-18 17:52:19,599994.33,1799982.98000003
"11407",2018-03-18 17:52:19,115193.35,1915176.33000003
"11408",2018-03-18 17:52:19,599994.32,2515170.65000003
"11409",2018-03-18 17:52:19,599994.3,3115164.95000003
"11410",2018-03-18 17:58:52,-3115164.95,3.44589352607727e-08
"11411",2018-03-20 11:19:43,134027.16,134027.160000034
"11412",2018-03-20 11:45:22,-134027.16,3.44589352607727e-08
"11413",2018-03-20 15:41:38,711975.78,711975.780000034
"11414",2018-03-20 16:27:12,599996.13,1311971.91000003
"11415",2018-03-20 16:27:12,351886.14,1663858.05000003
"11416",2018-03-20 17:00:22,-1663858.05,3.46917659044266e-08
"11417",2018-03-20 19:44:20,1283710.73,1283710.73000003
"11418",2018-03-20 19:53:50,1210207.49,2493918.22000003
"11419",2018-03-20 20:09:22,-2493918.22,3.44589352607727e-08
"11420",2018-03-21 03:55:17,30418.12,30418.1200000345
"11421",2018-03-21 05:35:29,13836.56,44254.6800000345
"11422",2018-03-21 05:50:40,161634.04,205888.720000034
"11423",2018-03-21 07:59:18,355049.92,560938.640000034
"11424",2018-03-21 08:21:52,304855.71,865794.350000035
"11425",2018-03-21 08:41:58,777783.96,1643578.31000003
"11426",2018-03-21 09:40:10,93465.18,1737043.49000003
"11427",2018-03-21 09:40:10,499997.17,2237040.66000003
"11428",2018-03-21 13:42:57,381164.37,2618205.03000003
"11429",2018-03-21 17:24:07,480301.87,3098506.90000003
"11430",2018-03-21 18:05:50,599997.52,3698504.42000003
"11431",2018-03-21 18:05:50,273630.53,3972134.95000003
"11432",2018-03-21 18:21:27,336590.58,4308725.53000003
"11433",2018-03-21 18:21:27,385095.29,4693820.82000003
"11434",2018-03-21 20:19:24,499997.63,5193818.45000003
"11435",2018-03-21 20:19:24,53708.64,5247527.09000003
"11436",2018-03-22 00:55:50,599997.75,5847524.84000003
"11437",2018-03-22 00:55:50,195312.76,6042837.60000003
"11438",2018-03-22 01:00:31,599997.8,6642835.40000003
"11439",2018-03-22 01:00:31,444760.81,7087596.21000003
"11440",2018-03-23 04:31:49,274718.73,7362314.94000003
"11441",2018-03-23 09:31:12,230533.07,7592848.01000003
"11442",2018-03-23 10:43:59,255654.56,7848502.57000003
"11443",2018-03-23 11:03:32,139631.83,7988134.40000003
"11444",2018-03-23 12:09:02,208014.3,8196148.70000003
"11445",2018-03-23 13:02:48,182187.89,8378336.59000003
"11446",2018-03-23 13:03:22,220809.4,8599145.99000003
"11447",2018-03-23 13:06:28,193856.78,8793002.77000003
"11448",2018-03-23 13:40:38,9822.12,8802824.89000003
"11449",2018-03-23 14:00:47,124594.5,8927419.39000003
"11450",2018-03-23 14:24:03,141578.44,9068997.83000003
"11451",2018-03-23 14:24:03,89564.22,9158562.05000003
"11452",2018-03-23 14:40:27,96939.4,9255501.45000003
"11453",2018-03-23 15:16:43,107043.86,9362545.31000003
"11454",2018-03-23 15:16:43,599994,9962539.31000003
"11455",2018-03-23 15:16:43,227503.01,10190042.32
"11456",2018-03-23 15:16:43,599993.97,10790036.29
"11457",2018-03-23 15:16:43,599993.98,11390030.27
"11458",2018-03-23 15:16:43,599993.99,11990024.26
"11459",2018-03-23 15:38:53,599994.08,12590018.34
"11460",2018-03-23 15:38:53,346248.09,12936266.43
"11461",2018-03-23 23:57:43,480600.98,13416867.41
"11462",2018-03-24 05:54:31,1126956.73,14543824.14
"11463",2018-03-25 04:21:08,599994.82,15143818.96
"11464",2018-03-25 04:21:08,400358.83,15544177.79
"11465",2018-03-25 04:34:53,920314.13,16464491.92
"11466",2018-03-25 07:24:26,963960.25,17428452.17
"11467",2018-03-25 08:02:00,476635.33,17905087.5
"11468",2018-03-26 09:50:12,592551.4,18497638.9
"11469",2018-03-26 11:28:28,1181560.1,19679199
"11470",2018-03-26 12:10:29,599995.33,20279194.33
"11471",2018-03-26 12:10:29,500769.34,20779963.67
"11472",2018-03-26 17:55:56,13205.62,20793169.29
"11473",2018-03-26 17:58:38,599995.61,21393164.9
"11474",2018-03-26 17:58:38,599995.6,21993160.5
"11475",2018-03-26 22:20:43,588252.76,22581413.26
"11476",2018-03-26 22:31:19,599995.74,23181409
"11477",2018-03-26 22:31:19,273976.75,23455385.75
"11478",2018-03-27 11:50:31,-23455385.75,2.98023223876953e-08
"11479",2018-03-27 19:27:06,599996.31,599996.31000003
"11480",2018-03-27 19:27:06,213036.34,813032.65000003
"11481",2018-03-27 19:27:06,599996.32,1413028.97000003
"11482",2018-03-27 19:27:06,599996.33,2013025.30000003
"11483",2018-03-27 20:01:23,-2013025.3,2.95694917440414e-08
"11484",2018-03-28 02:39:44,566453.62,566453.62000003
"11485",2018-03-28 02:39:44,599996.61,1166450.23000003
"11486",2018-03-28 02:48:17,-1166450.23,2.95694917440414e-08
"11487",2018-03-28 08:42:44,1036905.74,1036905.74000003
"11488",2018-03-28 09:12:08,-1036905.74,2.95694917440414e-08
"11489",2018-03-29 10:16:58,552229.58,552229.58000003
"11490",2018-03-29 10:32:03,-552229.58,2.95694917440414e-08
"11491",2018-03-29 12:43:24,696773.89,696773.89000003
"11492",2018-03-29 12:53:59,496990.76,1193764.65000003
"11493",2018-03-29 13:41:39,-1193764.65,2.98023223876953e-08
"11494",2018-03-29 20:46:21,515495.96,515495.96000003
"11495",2018-03-29 20:46:21,599997.94,1115493.90000003
"11496",2018-03-29 20:46:21,599997.95,1715491.85000003
"11497",2018-03-29 20:46:21,599997.93,2315489.78000003
"11498",2018-03-29 20:59:11,522406,2837895.78000003
"11499",2018-03-29 20:59:11,599997.97,3437893.75000003
"11500",2018-03-29 20:59:11,599997.98,4037891.73000003
"11501",2018-03-29 20:59:11,599997.99,4637889.72000003
"11502",2018-03-30 01:20:52,-4637889.72,2.98023223876953e-08
"11503",2018-03-30 16:23:43,599998.82,599998.82000003
"11504",2018-03-30 16:23:43,599998.79,1199997.61000003
"11505",2018-03-30 16:23:43,599998.8,1799996.41000003
"11506",2018-03-30 16:23:43,599998.81,2399995.22000003
"11507",2018-03-30 16:23:43,577486.83,2977482.05000003
"11508",2018-03-30 16:43:42,-2977482.05,2.98023223876953e-08
"11509",2018-03-30 22:42:49,2075200.99,2075200.99000003
"11510",2018-03-30 23:10:54,-2075200.99,2.98023223876953e-08
"11511",2018-04-01 09:13:36,599999.56,599999.56000003
"11512",2018-04-01 09:13:36,423579.57,1023579.13000003
"11513",2018-04-01 09:13:36,599999.55,1623578.68000003
"11514",2018-04-01 09:13:36,599999.54,2223578.22000003
"11515",2018-04-01 09:25:38,-2223578.22,2.98023223876953e-08
"11516",2018-04-01 14:38:19,952163.9,952163.90000003
"11517",2018-04-01 14:47:11,-952163.9,2.98023223876953e-08
"11518",2018-04-03 03:20:48,1826294.65,1826294.65000003
"11519",2018-04-03 04:00:55,-1826294.65,2.98023223876953e-08
"11520",2018-04-04 05:12:33,464918.38,464918.38000003
"11521",2018-04-04 05:49:30,-464918.38,2.98023223876953e-08
"11522",2018-04-04 09:41:32,1200875.55,1200875.55000003
"11523",2018-04-04 10:09:14,-1200875.55,2.98023223876953e-08
"11524",2018-04-04 15:28:07,472919.44,472919.44000003
"11525",2018-04-04 15:44:57,-472919.44,2.98023223876953e-08
"11526",2018-04-04 16:34:40,599990.28,599990.28000003
"11527",2018-04-04 16:34:40,168355.29,768345.57000003
"11528",2018-04-04 16:34:40,599990.27,1368335.84000003
"11529",2018-04-04 16:51:05,-1368335.84,2.98023223876953e-08
"11530",2018-04-06 07:37:56,599990.58,599990.58000003
"11531",2018-04-06 07:37:56,34829.59,634820.17000003
"11532",2018-04-06 07:37:56,599990.57,1234810.74000003
"11533",2018-04-06 08:11:30,-1234810.74,2.95694917440414e-08
"11534",2018-04-06 12:01:10,599990.69,599990.69000003
"11535",2018-04-06 12:01:10,482166.7,1082157.39000003
"11536",2018-04-06 12:45:00,-1082157.39,2.95694917440414e-08
"11537",2018-04-09 23:14:03,599991.29,599991.29000003
"11538",2018-04-09 23:14:03,599991.3,1199982.59000003
"11539",2018-04-09 23:14:03,599991.31,1799973.90000003
"11540",2018-04-09 23:14:03,162361.32,1962335.22000003
"11541",2018-04-10 00:02:02,-1962335.22,2.98023223876953e-08
"11542",2018-04-12 11:35:53,379050.76,379050.76000003
"11543",2018-04-12 11:35:53,1999991.75,2379042.51000003
"11544",2018-04-12 12:31:44,-2379042.51,2.98023223876953e-08
"11545",2018-04-13 22:23:42,1999992.42,1999992.42000003
"11546",2018-04-13 22:23:42,656393.43,2656385.85000003
"11547",2018-04-13 22:34:53,-2656385.85,2.98023223876953e-08
"11548",2018-04-16 07:36:50,73125.96,73125.9600000298
"11549",2018-04-16 07:36:50,843317.67,916443.63000003
"11550",2018-04-16 07:51:56,965396.06,1881839.69000003
"11551",2018-04-16 08:05:11,-1881839.69,2.98023223876953e-08
"11552",2018-04-16 13:18:28,560268.46,560268.46000003
"11553",2018-04-16 14:02:21,1261287.57,1821556.03000003
"11554",2018-04-16 14:12:33,-1821556.03,2.98023223876953e-08
"11555",2018-04-17 02:43:36,600978.15,600978.15000003
"11556",2018-04-17 03:26:58,-600978.15,2.98023223876953e-08
"11557",2018-04-17 05:55:29,550480.14,550480.14000003
"11558",2018-04-17 05:55:29,599993.13,1150473.27000003
"11559",2018-04-17 06:17:19,-1150473.27,2.98023223876953e-08
"11560",2018-04-20 10:52:42,1999993.79,1999993.79000003
"11561",2018-04-20 10:52:42,1407256.8,3407250.59000003
"11562",2018-04-20 11:26:47,-3407250.59,2.98023223876953e-08
"11563",2018-04-20 16:37:14,599993.84,599993.84000003
"11564",2018-04-20 16:37:14,512519.86,1112513.70000003
"11565",2018-04-20 16:37:14,599993.82,1712507.52000003
"11566",2018-04-20 16:37:14,599993.85,2312501.37000003
"11567",2018-04-20 16:37:14,599993.83,2912495.20000003
"11568",2018-04-20 17:02:57,-2912495.2,2.98023223876953e-08
"11569",2018-04-20 23:44:44,223708.09,223708.09000003
"11570",2018-04-20 23:51:05,483778.02,707486.11000003
"11571",2018-04-21 00:04:04,-707486.11,2.98023223876953e-08
"11572",2018-04-21 12:08:53,1999994.2,1999994.20000003
"11573",2018-04-21 12:08:53,243216.21,2243210.41000003
"11574",2018-04-21 12:18:17,-2243210.41,2.98023223876953e-08
"11575",2018-04-23 01:08:00,751253.4,751253.40000003
"11576",2018-04-23 01:29:52,-751253.4,2.98023223876953e-08
"11577",2018-04-24 01:37:17,1999994.86,1999994.86000003
"11578",2018-04-24 01:51:13,1192813.87,3192808.73000003
"11579",2018-04-24 13:55:05,1876855.93,5069664.66000003
"11580",2018-04-24 18:56:16,-5069664.66,2.98023223876953e-08
"11581",2018-04-25 07:30:02,1999996.32,1999996.32000003
"11582",2018-04-25 07:30:02,1618500.34,3618496.66000003
"11583",2018-04-25 07:30:02,1999996.31,5618492.97000003
"11584",2018-04-25 07:30:02,1999996.33,7618489.30000003
"11585",2018-04-25 08:22:03,-7618489.3,3.07336449623108e-08
"11586",2018-04-25 08:22:03,599996.44,599996.440000031
"11587",2018-04-25 08:22:03,330580.46,930576.900000031
"11588",2018-04-25 08:22:03,599996.43,1530573.33000003
"11589",2018-04-25 08:22:03,599996.45,2130569.78000003
"11590",2018-04-25 09:02:22,-2130569.78,3.11993062496185e-08
"11591",2018-04-25 10:16:31,1215504.6,1215504.60000003
"11592",2018-04-25 11:05:42,-1215504.6,3.11993062496185e-08
"11593",2018-04-25 13:14:30,470611.41,470611.410000031
"11594",2018-04-25 13:14:30,599997.39,1070608.80000003
"11595",2018-04-25 13:14:30,599997.4,1670606.20000003
"11596",2018-04-25 13:14:30,599997.38,2270603.58000003
"11597",2018-04-25 13:14:30,599997.37,2870600.95000003
"11598",2018-04-25 13:44:55,-2870600.95,3.11993062496185e-08
"11599",2018-04-25 16:43:37,1013493.91,1013493.91000003
"11600",2018-04-25 16:47:51,1999997.52,3013491.43000003
"11601",2018-04-25 16:47:51,1999997.53,5013488.96000003
"11602",2018-04-25 16:47:51,1835427.54,6848916.50000003
"11603",2018-04-25 17:47:30,-6848916.5,3.16649675369263e-08
"11604",2018-04-25 19:55:36,2218993.11,2218993.11000003
"11605",2018-04-25 20:01:45,-2218993.11,3.16649675369263e-08
"11606",2018-05-03 19:49:38,599990.53,599990.530000032
"11607",2018-05-03 19:49:38,599990.55,1199981.08000003
"11608",2018-05-03 19:49:38,599990.54,1799971.62000003
"11609",2018-05-03 19:49:38,599990.56,2399962.18000003
"11610",2018-05-03 19:49:38,599990.52,2999952.70000003
"11611",2018-05-03 19:49:38,278911.57,3278864.27000003
"11612",2018-05-03 20:20:09,-3278864.27,3.16649675369263e-08
"11613",2018-05-05 12:45:35,597247.29,597247.290000032
"11614",2018-05-05 12:45:35,599991.28,1197238.57000003
"11615",2018-05-05 12:45:35,599991.27,1797229.84000003
"11616",2018-05-05 12:56:40,-1797229.84,3.16649675369263e-08
"11617",2018-05-05 23:31:15,599991.68,599991.680000032
"11618",2018-05-05 23:31:15,599991.7,1199983.38000003
"11619",2018-05-05 23:31:15,396579.71,1596563.09000003
"11620",2018-05-05 23:31:15,599991.67,2196554.76000003
"11621",2018-05-05 23:31:15,599991.69,2796546.45000003
"11622",2018-05-05 23:38:53,-2796546.45,3.11993062496185e-08
"11623",2018-05-08 12:57:30,3000020.88,3000020.88000003
"11624",2018-05-08 13:22:03,-3000020.88,3.11993062496185e-08
"11625",2018-05-09 14:51:13,3000021.37,3000021.37000003
"11626",2018-05-09 15:12:11,-3000021.37,3.11993062496185e-08
"11627",2018-05-10 15:42:26,3000021.67,3000021.67000003
"11628",2018-05-10 16:10:51,-3000021.67,3.11993062496185e-08
"11629",2018-05-12 16:17:44,1512232.78,1512232.78000003
"11630",2018-05-12 16:31:33,-1512232.78,3.11993062496185e-08
"11631",2018-05-16 10:22:24,1295959.97,1295959.97000003
"11632",2018-05-16 10:38:57,-1295959.97,3.11993062496185e-08
"11633",2018-05-18 04:43:55,1589194.02,1589194.02000003
"11634",2018-05-18 05:19:10,-1589194.02,3.11993062496185e-08
"11635",2018-05-22 10:37:55,258380.64,258380.640000031
"11636",2018-05-22 10:37:55,599990.63,858371.270000031
"11637",2018-05-22 10:49:41,-858371.27,3.11993062496185e-08
"11638",2018-05-23 15:58:58,332011.72,332011.720000031
"11639",2018-05-23 16:40:30,-332011.72,3.11993062496185e-08
"11640",2018-05-23 16:42:03,599993.85,599993.850000031
"11641",2018-05-23 16:42:03,599993.86,1199987.71000003
"11642",2018-05-23 16:42:03,4198.87,1204186.58000003
"11643",2018-05-23 17:02:29,-1204186.58,3.11993062496185e-08
"11644",2018-05-23 22:51:34,115699.06,115699.060000031
"11645",2018-05-23 22:51:34,599994.05,715693.110000031
"11646",2018-05-23 23:08:22,-715693.11,3.13157215714455e-08
"11647",2018-05-24 09:46:25,555559.42,555559.420000031
"11648",2018-05-24 09:58:41,-555559.42,3.13157215714455e-08
"11649",2018-05-24 10:20:07,954835.93,954835.930000031
"11650",2018-05-24 10:30:41,-954835.93,3.13157215714455e-08
"11651",2018-05-24 13:00:26,144346.59,144346.590000031
"11652",2018-05-24 13:00:26,599994.58,744341.170000031
"11653",2018-05-24 13:36:16,-744341.17,3.11993062496185e-08
"11654",2018-05-24 17:03:21,143185.81,143185.810000031
"11655",2018-05-24 17:03:21,599994.8,743180.610000031
"11656",2018-05-24 17:10:08,-743180.61,3.13157215714455e-08
"11657",2018-05-24 17:14:32,599994.82,599994.820000031
"11658",2018-05-24 17:14:32,94947.83,694942.650000031
"11659",2018-05-24 17:23:01,-694942.65,3.11993062496185e-08
"11660",2018-05-25 09:06:18,530014.13,530014.130000031
"11661",2018-05-25 10:34:13,-530014.13,3.11993062496185e-08
"11662",2018-05-27 09:32:29,33092.98,33092.9800000312
"11663",2018-05-27 09:51:34,795493.25,828586.230000031
"11664",2018-05-27 10:03:30,-828586.23,3.11993062496185e-08
"11665",2018-05-27 11:40:00,144185.14,144185.140000031
"11666",2018-05-27 11:40:00,142429.27,286614.410000031
"11667",2018-05-27 12:02:21,-286614.41,3.1257513910532e-08
"11668",2018-05-27 12:14:37,128546.31,128546.310000031
"11669",2018-05-27 12:42:49,-128546.31,3.1257513910532e-08
"11670",2018-05-27 13:27:39,87717.01,87717.0100000313
"11671",2018-05-27 13:27:39,117733.82,205450.830000031
"11672",2018-05-27 13:49:59,-205450.83,3.12866177409887e-08
"11673",2018-05-27 14:17:59,70173.07,70173.0700000313
"11674",2018-05-27 14:33:29,-70173.07,3.12866177409887e-08
"11675",2018-05-27 14:33:29,123401.45,123401.450000031
"11676",2018-05-27 14:33:29,121207.49,244608.940000031
"11677",2018-05-27 14:53:09,54519.06,299128.000000031
"11678",2018-05-27 15:10:56,-299128,3.13157215714455e-08
"11679",2018-05-27 15:10:56,85764.69,85764.6900000313
"11680",2018-05-27 15:27:09,-85764.69,3.13157215714455e-08
"11681",2018-05-27 15:27:09,57586.19,57586.1900000313
"11682",2018-05-27 15:27:09,33432.2,91018.3900000313
"11683",2018-05-27 15:57:16,-91018.39,3.13157215714455e-08
"11684",2018-05-27 15:57:16,24860.41,24860.4100000313
"11685",2018-05-27 16:17:10,-24860.41,3.13157215714455e-08
"11686",2018-05-27 16:17:10,38171.54,38171.5400000313
"11687",2018-05-27 16:20:19,377783.64,415955.180000031
"11688",2018-05-27 16:53:06,236957.93,652913.110000031
"11689",2018-05-27 16:53:06,-415955.18,236957.930000031
"11690",2018-05-27 17:01:48,229447.35,466405.280000031
"11691",2018-05-27 17:09:26,-466405.28,3.13157215714455e-08
"11692",2018-05-27 17:23:07,777784.07,777784.070000031
"11693",2018-05-27 17:43:36,206410.26,984194.330000031
"11694",2018-05-27 17:59:19,-777784.07,206410.260000031
"11695",2018-05-27 18:19:57,-206410.26,3.13157215714455e-08
"11696",2018-05-27 19:03:04,36180.33,36180.3300000313
"11697",2018-05-27 19:24:10,-36180.33,3.13157215714455e-08
"11698",2018-05-27 21:01:17,98349.48,98349.4800000313
"11699",2018-05-27 21:10:58,-98349.48,3.13157215714455e-08
"11700",2018-05-27 22:00:46,95990.76,95990.7600000313
"11701",2018-05-27 22:20:42,-95990.76,3.13157215714455e-08
"11702",2018-05-28 03:17:53,619312.04,619312.040000031
"11703",2018-05-28 03:32:12,-619312.04,3.13157215714455e-08
"11704",2018-05-28 03:32:12,563906.92,563906.920000031
"11705",2018-05-28 03:51:27,181880.69,745787.610000031
"11706",2018-05-28 04:03:09,32679.25,778466.860000031
"11707",2018-05-28 04:03:09,153917.79,932384.650000031
"11708",2018-05-28 04:03:09,23977.51,956362.160000031
"11709",2018-05-28 04:03:09,229904.66,1186266.82000003
"11710",2018-05-28 04:22:57,16826.4,1203093.22000003
"11711",2018-05-28 04:22:57,7507.09,1210600.31000003
"11712",2018-05-28 04:22:57,18403.83,1229004.14000003
"11713",2018-05-28 04:22:57,19919.86,1248924.00000003
"11714",2018-05-28 04:22:57,-1186266.82,62657.1800000314
"11715",2018-05-28 04:22:57,29939.88,92597.0600000314
"11716",2018-05-28 04:22:57,29313.13,121910.190000031
"11717",2018-05-28 04:22:57,29630.22,151540.410000031
"11718",2018-05-28 04:22:57,160073.84,311614.250000031
"11719",2018-05-28 04:22:57,79809.87,391424.120000031
"11720",2018-05-28 04:22:57,741882.69,1133306.81000003
"11721",2018-05-28 04:26:59,42894.62,1176201.43000003
"11722",2018-05-28 04:47:53,43134.51,1219335.94000003
"11723",2018-05-28 04:47:53,28885.49,1248221.43000003
"11724",2018-05-28 04:47:53,-1176201.43,72020.0000000314
"11725",2018-05-28 04:47:53,207617.15,279637.150000031
"11726",2018-05-28 04:47:53,37271.61,316908.760000031
"11727",2018-05-28 04:47:53,21120.97,338029.730000031
"11728",2018-05-28 04:47:53,158208.92,496238.650000031
"11729",2018-05-28 04:47:53,211036.52,707275.170000031
"11730",2018-05-28 04:51:27,49561.71,756836.880000031
"11731",2018-05-28 05:00:31,21728.42,778565.300000031
"11732",2018-05-28 05:00:31,15849.51,794414.810000031
"11733",2018-05-28 05:00:31,-756836.88,37577.9300000315
"11734",2018-05-28 05:00:31,134121.89,171699.820000031
"11735",2018-05-28 05:00:31,276895.22,448595.040000031
"11736",2018-05-28 05:00:31,86087.54,534682.580000032
"11737",2018-05-28 05:00:31,28462.09,563144.670000031
"11738",2018-05-28 05:00:31,36281.35,599426.020000031
"11739",2018-05-28 05:00:31,62110.76,661536.780000031
"11740",2018-05-28 05:00:31,17009.1,678545.880000031
"11741",2018-05-28 05:00:31,68177.01,746722.890000031
"11742",2018-05-28 05:02:32,27603.95,774326.840000031
"11743",2018-05-28 05:11:10,-774326.84,3.14321368932724e-08
"11744",2018-06-10 18:45:57,555559.19,555559.190000031
"11745",2018-06-10 18:52:44,-555559.19,3.14321368932724e-08
"11746",2018-06-11 18:17:08,777782.73,777782.730000031
"11747",2018-06-11 18:22:50,-777782.73,3.14321368932724e-08
"11748",2018-06-11 23:17:34,599995.78,599995.780000031
"11749",2018-06-11 23:17:34,489850.8,1089846.58000003
"11750",2018-06-11 23:17:34,599995.79,1689842.37000003
"11751",2018-06-11 23:24:16,-1689842.37,3.14321368932724e-08
"11752",2018-06-12 00:15:40,1046170.81,1046170.81000003
"11753",2018-06-12 00:25:32,-1046170.81,3.14321368932724e-08
"11754",2018-06-12 17:24:10,287971.68,287971.680000031
"11755",2018-06-12 18:17:26,-287971.68,3.14321368932724e-08
"11756",2018-06-12 18:44:30,519136.78,519136.780000031
"11757",2018-06-12 19:27:29,-519136.78,3.14321368932724e-08
"11758",2018-06-12 22:04:05,599996.8,599996.800000031
"11759",2018-06-12 22:11:10,-599996.8,3.14321368932724e-08
"11760",2018-06-12 22:36:47,69323.22,69323.2200000314
"11761",2018-06-12 22:36:47,365340.42,434663.640000031
"11762",2018-06-12 22:36:47,175823.06,610486.700000031
"11763",2018-06-12 22:43:01,900146.85,1510633.55000003
"11764",2018-06-12 22:58:40,-1510633.55,3.14321368932724e-08
"11765",2018-06-13 02:10:41,425922.51,425922.510000031
"11766",2018-06-13 02:35:03,-425922.51,3.14321368932724e-08
"11767",2018-06-13 10:02:37,225068.94,225068.940000031
"11768",2018-06-13 10:26:27,465193.29,690262.230000031
"11769",2018-06-13 11:04:23,-690262.23,3.14321368932724e-08
"11770",2018-06-13 11:04:23,248008.04,248008.040000031
"11771",2018-06-13 11:36:36,-248008.04,3.14321368932724e-08
"11772",2018-06-13 11:54:59,234796.44,234796.440000031
"11773",2018-06-13 12:40:08,-234796.44,3.14321368932724e-08
"11774",2018-06-13 13:29:26,360887.63,360887.630000031
"11775",2018-06-13 14:56:18,-360887.63,3.14321368932724e-08
"11776",2018-06-13 14:56:18,189293.49,189293.490000031
"11777",2018-06-13 15:55:13,-189293.49,3.14321368932724e-08
"11778",2018-06-13 16:08:18,198259.96,198259.960000031
"11779",2018-06-13 16:33:12,-198259.96,3.14321368932724e-08
"11780",2018-06-13 16:53:38,80606.85,80606.8500000314
"11781",2018-06-13 16:53:38,531830.23,612437.080000031
"11782",2018-06-13 17:24:39,-612437.08,3.14321368932724e-08
"11783",2018-06-13 17:24:39,599999.46,599999.460000031
"11784",2018-06-13 17:40:53,-599999.46,3.14321368932724e-08
"11785",2018-06-13 17:47:07,599999.5,599999.500000031
"11786",2018-06-13 19:23:53,-599999.5,3.14321368932724e-08
"11787",2018-06-13 21:00:52,582790.35,582790.350000031
"11788",2018-06-13 21:00:52,721670.37,1304460.72000003
"11789",2018-06-13 21:08:51,599999.53,1904460.25000003
"11790",2018-06-13 21:41:07,-1904460.25,3.14321368932724e-08
"11791",2018-06-13 23:15:38,599999.68,599999.680000031
"11792",2018-06-13 23:36:24,-599999.68,3.14321368932724e-08
"11793",2018-06-14 02:46:56,769480.59,769480.590000031
"11794",2018-06-14 03:04:09,-769480.59,3.14321368932724e-08
"11795",2018-06-14 17:00:32,599990.04,599990.040000031
"11796",2018-06-14 17:14:20,-599990.04,3.14321368932724e-08
"11797",2018-06-14 17:14:20,599990.1,599990.100000031
"11798",2018-06-14 17:28:38,-599990.1,3.14321368932724e-08
"11799",2018-06-14 17:28:38,599990.14,599990.140000031
"11800",2018-06-14 17:37:33,-599990.14,3.14321368932724e-08
"11801",2018-06-16 16:29:49,599990.76,599990.760000031
"11802",2018-06-16 16:39:17,-599990.76,3.14321368932724e-08
"11803",2018-06-16 16:47:13,599990.82,599990.820000031
"11804",2018-06-16 16:58:08,-599990.82,3.14321368932724e-08
"11805",2018-06-18 08:30:55,825781.02,825781.020000031
"11806",2018-06-18 09:03:39,-825781.02,3.14321368932724e-08
"11807",2018-06-20 05:04:44,599991.85,599991.850000031
"11808",2018-06-20 05:08:43,-599991.85,3.14321368932724e-08
"11809",2018-06-20 10:39:25,599991.9,599991.900000031
"11810",2018-06-20 10:50:44,-599991.9,3.14321368932724e-08
"11811",2018-06-20 12:13:38,599991.88,599991.880000031
"11812",2018-06-20 12:23:19,-599991.88,3.14321368932724e-08
"11813",2018-06-22 09:25:13,523127.28,523127.280000031
"11814",2018-06-22 09:39:42,431093.04,954220.320000031
"11815",2018-06-22 09:39:42,-523127.28,431093.040000031
"11816",2018-06-22 09:51:09,-431093.04,3.14903445541859e-08
"11817",2018-06-22 15:29:07,393501.98,393501.980000031
"11818",2018-06-22 15:57:08,599992.37,993494.350000032
"11819",2018-06-22 16:12:06,97740.97,1091235.32000003
"11820",2018-06-22 16:12:06,-993494.35,97740.9700000315
"11821",2018-06-22 16:12:06,599992.41,697733.380000032
"11822",2018-06-22 16:29:35,599992.42,1297725.80000003
"11823",2018-06-22 16:36:01,-1297725.8,3.14321368932724e-08
"11824",2018-06-22 16:47:46,599992.44,599992.440000031
"11825",2018-06-22 17:22:36,-599992.44,3.14321368932724e-08
"11826",2018-06-22 18:11:02,599992.46,599992.460000031
"11827",2018-06-22 18:32:41,-599992.46,3.14321368932724e-08
"11828",2018-06-22 21:30:42,599992.51,599992.510000031
"11829",2018-06-22 21:45:28,-599992.51,3.14321368932724e-08
"11830",2018-06-23 01:58:01,599992.57,599992.570000031
"11831",2018-06-23 02:33:46,-599992.57,3.14321368932724e-08
"11832",2018-06-24 06:31:54,210102.43,210102.430000031
"11833",2018-06-24 06:46:37,-210102.43,3.14321368932724e-08
"11834",2018-06-24 07:48:32,694397.68,694397.680000031
"11835",2018-06-24 08:00:17,-694397.68,3.14321368932724e-08
"11836",2018-06-24 08:47:19,953901.11,953901.110000031
"11837",2018-06-24 09:12:14,-953901.11,3.14321368932724e-08
"11838",2018-06-24 09:34:59,527099.36,527099.360000031
"11839",2018-06-24 09:49:17,-527099.36,3.14321368932724e-08
"11840",2018-06-24 10:41:57,867883.48,867883.480000031
"11841",2018-06-24 11:03:20,-867883.48,3.14321368932724e-08
"11842",2018-06-24 17:34:58,1072274.9,1072274.90000003
"11843",2018-06-24 18:16:59,-1072274.9,3.14321368932724e-08
"11844",2018-06-26 15:59:23,599994.08,599994.080000031
"11845",2018-06-26 16:07:27,-599994.08,3.14321368932724e-08
"11846",2018-06-26 21:59:34,599994.11,599994.110000031
"11847",2018-06-26 22:10:44,-599994.11,3.14321368932724e-08
"11848",2018-06-27 11:11:18,599994.17,599994.170000031
"11849",2018-06-27 11:38:57,-599994.17,3.14321368932724e-08
"11850",2018-06-29 12:33:19,599994.45,599994.450000031
"11851",2018-06-29 13:27:51,599994.46,1199988.91000003
"11852",2018-06-29 13:34:54,-1199988.91,3.14321368932724e-08
"11853",2018-06-29 14:09:34,599994.47,599994.470000031
"11854",2018-06-29 14:39:26,-599994.47,3.14321368932724e-08
"11855",2018-06-29 14:39:26,599994.49,599994.490000031
"11856",2018-06-29 14:55:02,599994.5,1199988.99000003
"11857",2018-06-29 15:19:18,-1199988.99,3.14321368932724e-08
"11858",2018-06-29 15:19:18,599994.51,599994.510000031
"11859",2018-06-29 15:55:02,-599994.51,3.14321368932724e-08
"11860",2018-06-29 21:21:44,599994.53,599994.530000031
"11861",2018-06-29 21:49:50,-599994.53,3.14321368932724e-08
"11862",2018-06-30 00:42:33,1559773.05,1559773.05000003
"11863",2018-06-30 01:08:23,-1559773.05,3.14321368932724e-08
"11864",2018-07-05 18:32:32,599995.56,599995.560000031
"11865",2018-07-05 19:29:02,-599995.56,3.14321368932724e-08
"11866",2018-07-06 01:44:24,599995.64,599995.640000031
"11867",2018-07-06 02:45:42,-599995.64,3.14321368932724e-08
"11868",2018-07-06 08:26:30,617760.77,617760.770000031
"11869",2018-07-06 08:43:17,-617760.77,3.14321368932724e-08
"11870",2018-07-06 12:16:42,811202.41,811202.410000031
"11871",2018-07-06 13:42:55,-811202.41,3.14321368932724e-08
"11872",2018-07-10 10:33:22,581695.82,581695.820000031
"11873",2018-07-10 11:58:57,-581695.82,3.14321368932724e-08
"11874",2018-07-12 06:46:18,428372.37,428372.370000031
"11875",2018-07-12 07:19:10,438131.44,866503.810000031
"11876",2018-07-12 07:33:04,248827.26,1115331.07000003
"11877",2018-07-12 07:33:04,599996.64,1715327.71000003
"11878",2018-07-12 07:48:02,-1715327.71,3.16649675369263e-08
"11879",2018-07-12 08:07:15,568983.59,568983.590000032
"11880",2018-07-12 08:22:46,-568983.59,3.16649675369263e-08
"11881",2018-07-12 08:22:46,599996.67,599996.670000032
"11882",2018-07-12 08:40:32,404019.49,1004016.16000003
"11883",2018-07-12 08:40:32,465561.04,1469577.20000003
"11884",2018-07-12 08:49:32,-1469577.2,3.16649675369263e-08
"11885",2018-07-12 09:03:58,456244.97,456244.970000032
"11886",2018-07-12 11:39:18,-456244.97,3.16649675369263e-08
"11887",2018-07-12 20:47:17,682182.55,682182.550000032
"11888",2018-07-12 20:56:08,-682182.55,3.16649675369263e-08
"11889",2018-07-13 00:25:34,1204444.3,1204444.30000003
"11890",2018-07-13 00:44:12,-1204444.3,3.16649675369263e-08
"11891",2018-07-14 19:02:21,612382.32,612382.320000032
"11892",2018-07-14 19:12:58,-612382.32,3.16649675369263e-08
"11893",2018-07-15 10:33:45,599997.09,599997.090000032
"11894",2018-07-15 11:00:29,-599997.09,3.16649675369263e-08
"11895",2018-07-15 17:16:09,599997.22,599997.220000032
"11896",2018-07-16 10:20:17,599997.29,1199994.51000003
"11897",2018-07-16 11:38:10,599997.32,1799991.83000003
"11898",2018-07-16 17:45:59,930042.62,2730034.45000003
"11899",2018-07-17 18:19:20,760269,3490303.45000003
"11900",2018-07-18 03:17:14,521203.6,4011507.05000003
"11901",2018-07-18 16:39:44,599998.46,4611505.51000003
"11902",2018-07-18 21:23:31,599998.62,5211504.13000003
"11903",2018-07-19 16:15:26,-5211504.13,3.16649675369263e-08
"11904",2018-07-19 23:13:07,600390.75,600390.750000032
"11905",2018-07-20 00:10:26,-600390.75,3.16649675369263e-08
"11906",2018-07-20 08:21:50,599998.86,599998.860000032
"11907",2018-07-20 08:35:06,-599998.86,3.16649675369263e-08
"11908",2018-07-24 18:09:09,754238.52,754238.520000032
"11909",2018-07-24 19:34:19,416864.14,1171102.66000003
"11910",2018-07-24 21:23:04,-1171102.66,3.18977981805801e-08
"11911",2018-07-24 21:23:04,543391.96,543391.960000032
"11912",2018-07-24 21:50:40,-543391.96,3.18977981805801e-08
"11913",2018-07-25 16:04:28,735160.7,735160.700000032
"11914",2018-07-25 16:17:58,-735160.7,3.18977981805801e-08
"11915",2018-07-26 23:28:26,923849.02,923849.020000032
"11916",2018-07-26 23:32:42,-923849.02,3.18977981805801e-08
"11917",2018-07-27 15:24:21,848124.24,848124.240000032
"11918",2018-07-27 15:38:48,-848124.24,3.18977981805801e-08
"11919",2018-07-28 08:49:03,589664.18,589664.180000032
"11920",2018-07-28 09:35:41,-589664.18,3.18977981805801e-08
"11921",2018-07-28 16:38:21,901042.18,901042.180000032
"11922",2018-07-28 17:03:47,-901042.18,3.18977981805801e-08
"11923",2018-07-30 06:47:30,883904.36,883904.360000032
"11924",2018-07-30 08:02:11,-883904.36,3.18977981805801e-08
"11925",2018-07-30 18:09:51,599993.31,599993.310000032
"11926",2018-07-30 19:02:04,-599993.31,3.18977981805801e-08
"11927",2018-07-30 20:38:08,658240.12,658240.120000032
"11928",2018-07-30 20:52:40,-658240.12,3.18977981805801e-08
"11929",2018-08-03 14:08:36,693215.61,693215.610000032
"11930",2018-08-03 14:36:34,-693215.61,3.18977981805801e-08
"11931",2018-08-04 00:28:36,411904.32,411904.320000032
"11932",2018-08-04 00:59:30,-411904.32,3.18977981805801e-08
"11933",2018-08-04 08:28:48,599995.21,599995.210000032
"11934",2018-08-04 08:50:41,-599995.21,3.18977981805801e-08
"11935",2018-08-07 02:01:05,599995.59,599995.590000032
"11936",2018-08-07 02:10:21,-599995.59,3.18977981805801e-08
"11937",2018-08-07 03:28:11,599995.62,599995.620000032
"11938",2018-08-07 03:47:03,-599995.62,3.18977981805801e-08
"11939",2018-08-08 14:47:38,237047.86,237047.860000032
"11940",2018-08-08 14:59:14,-237047.86,3.18977981805801e-08
"11941",2018-08-08 15:06:03,204327.99,204327.990000032
"11942",2018-08-08 15:08:51,228424.35,432752.340000032
"11943",2018-08-08 15:18:18,-432752.34,3.18395905196667e-08
"11944",2018-08-08 15:35:08,214666.69,214666.690000032
"11945",2018-08-08 16:27:19,-214666.69,3.18395905196667e-08
"11946",2018-08-08 16:30:01,599996.75,599996.750000032
"11947",2018-08-08 17:21:43,-599996.75,3.18977981805801e-08
"11948",2018-08-08 17:47:51,599996.85,599996.850000032
"11949",2018-08-08 17:57:51,599996.88,1199993.73000003
"11950",2018-08-08 18:04:03,-1199993.73,3.18977981805801e-08
"11951",2018-08-10 21:19:12,599997.48,599997.480000032
"11952",2018-08-10 21:31:35,-599997.48,3.18977981805801e-08
"11953",2018-08-10 21:41:18,642762.47,642762.470000032
"11954",2018-08-10 21:49:26,-642762.47,3.18977981805801e-08
"11955",2018-08-11 18:14:00,495169.58,495169.580000032
"11956",2018-08-11 18:44:22,-495169.58,3.18977981805801e-08
"11957",2018-08-13 16:33:15,301329.13,301329.130000032
"11958",2018-08-13 16:44:58,-301329.13,3.18977981805801e-08
"11959",2018-08-13 18:42:13,599998.45,599998.450000032
"11960",2018-08-13 19:55:46,-599998.45,3.18977981805801e-08
"11961",2018-08-14 06:33:17,528251.21,528251.210000032
"11962",2018-08-14 07:24:39,-528251.21,3.18977981805801e-08
"11963",2018-08-14 11:17:29,573204.38,573204.380000032
"11964",2018-08-14 12:16:53,-573204.38,3.18977981805801e-08
"11965",2018-08-14 13:18:01,721157.54,721157.540000032
"11966",2018-08-14 14:01:19,-721157.54,3.18977981805801e-08
"11967",2018-08-14 18:18:13,304171.57,304171.570000032
"11968",2018-08-14 18:30:52,-304171.57,3.18977981805801e-08
"11969",2018-08-14 19:25:02,612995.6,612995.600000032
"11970",2018-08-14 19:34:56,-612995.6,3.18977981805801e-08
"11971",2018-08-14 21:35:00,566295.98,566295.980000032
"11972",2018-08-14 22:24:02,-566295.98,3.18977981805801e-08
"11973",2018-08-14 23:36:27,837913.31,837913.310000032
"11974",2018-08-15 00:22:09,-837913.31,3.18977981805801e-08
"11975",2018-08-15 07:49:10,551473.41,551473.410000032
"11976",2018-08-15 08:04:13,-551473.41,3.18977981805801e-08
"11977",2018-08-15 12:12:42,616844.1,616844.100000032
"11978",2018-08-15 12:12:42,250,617094.100000032
"11979",2018-08-15 12:34:54,-616844.1,250.000000031898
"11980",2018-08-15 17:47:21,1436164.63,1436414.63000003
"11981",2018-08-15 18:16:05,-1436164.63,250.000000031898
"11982",2018-08-16 01:09:35,518246.52,518496.520000032
"11983",2018-08-16 01:21:07,-518246.52,250.000000031898
"11984",2018-08-16 14:51:40,489824.73,490074.730000032
"11985",2018-08-16 15:10:40,-489824.73,250.000000031898
"11986",2018-08-16 18:31:53,401962.47,402212.470000032
"11987",2018-08-16 18:55:22,-401962.47,250.000000031898
"11988",2018-08-17 01:41:22,550739.83,550989.830000032
"11989",2018-08-17 02:14:53,-550739.83,250.000000031898
"11990",2018-08-17 17:37:24,546973.36,547223.360000032
"11991",2018-08-17 18:20:41,-546973.36,250.000000031898
"11992",2018-08-17 20:19:18,557856.82,558106.820000032
"11993",2018-08-17 20:59:26,-557856.82,250.000000031898
"11994",2018-08-20 22:32:11,599995.37,600245.370000032
"11995",2018-08-20 22:41:25,-599995.37,250.000000031898
"11996",2018-08-21 08:17:12,730633.41,730883.410000032
"11997",2018-08-21 08:36:00,-730633.41,250.000000031898
"11998",2018-08-22 01:50:47,699281.82,699531.820000032
"11999",2018-08-22 02:28:33,-699281.82,250.000000031898
"12000",2018-08-22 20:31:04,599996.18,600246.180000032
"12001",2018-08-22 21:22:03,-599996.18,250.000000031898
"12002",2018-08-22 22:59:03,599996.3,600246.300000032
"12003",2018-08-22 23:30:21,-599996.3,250.000000031898
"12004",2018-08-24 17:07:41,599996.52,600246.520000032
"12005",2018-08-24 17:49:26,-599996.52,250.000000031898
"12006",2018-08-26 11:25:54,728031.27,728281.270000032
"12007",2018-08-26 11:40:32,-728031.27,250.000000031898
"12008",2018-08-27 16:46:57,811471.22,811721.220000032
"12009",2018-08-27 17:23:16,-811471.22,250.000000031898
"12010",2018-08-31 17:32:20,599997.44,600247.440000032
"12011",2018-08-31 19:03:11,-599997.44,250.000000031898
"12012",2018-09-02 09:02:46,848736.88,848986.880000032
"12013",2018-09-02 09:29:08,-848736.88,250.000000031898
"12014",2018-09-03 07:05:29,485574.92,485824.920000032
"12015",2018-09-03 07:59:40,-485574.92,250.000000031898
"12016",2018-09-07 17:36:28,599992.17,600242.170000032
"12017",2018-09-07 18:01:31,-599992.17,250.000000031898
"12018",2018-09-09 09:53:09,571990.72,572240.720000032
"12019",2018-09-09 10:59:32,-571990.72,250.000000031898
"12020",2018-09-10 01:59:50,599992.56,600242.560000032
"12021",2018-09-10 02:52:17,-599992.56,250.000000031898
"12022",2018-09-10 16:46:00,599992.74,600242.740000032
"12023",2018-09-10 16:54:26,-599992.74,250.000000031898
"12024",2018-09-11 16:46:10,485664.84,485914.840000032
"12025",2018-09-11 17:27:34,-485664.84,250.000000031898
"12026",2018-09-11 23:49:04,512324.92,512574.920000032
"12027",2018-09-12 00:02:37,-512324.92,250.000000031898
"12028",2018-09-14 13:32:31,1050099.35,1050349.35000003
"12029",2018-09-14 13:48:57,-1050099.35,250.000000031898
"12030",2018-09-14 19:08:35,448697.98,448947.980000032
"12031",2018-09-14 19:36:26,-448697.98,250.000000031898
"12032",2018-09-16 05:14:05,599993.92,600243.920000032
"12033",2018-09-16 07:39:53,-599993.92,250.000000031898
"12034",2018-09-16 19:38:34,527860.31,528110.310000032
"12035",2018-09-16 20:20:02,-527860.31,250.000000031898
"12036",2018-09-17 16:13:02,599994.16,600244.160000032
"12037",2018-09-17 16:22:34,-599994.16,250.000000031898
"12038",2018-09-18 13:32:27,845586.58,845836.580000032
"12039",2018-09-18 13:55:32,-845586.58,250.000000031898
"12040",2018-09-20 23:04:48,888790.84,889040.840000032
"12041",2018-09-20 23:27:45,-888790.84,250.000000031898
"12042",2018-09-21 07:39:43,743760.67,744010.670000032
"12043",2018-09-21 08:02:02,-743760.67,250.000000031898
"12044",2018-09-21 13:47:14,624087.25,624337.250000032
"12045",2018-09-21 14:06:26,-624087.25,250.000000031898
"12046",2018-09-21 21:06:56,178742.02,178992.020000032
"12047",2018-09-21 21:22:34,-178742.02,250.000000031898
"12048",2018-09-21 21:22:34,139761.59,140011.590000032
"12049",2018-09-21 21:44:39,-139761.59,250.000000031898
"12050",2018-09-21 22:52:59,599995.47,600245.470000032
"12051",2018-09-21 23:25:52,-599995.47,250.000000031898
"12052",2018-09-22 04:47:53,599995.64,600245.640000032
"12053",2018-09-22 05:28:33,-599995.64,250.000000031898
"12054",2018-09-22 10:12:12,599995.73,600245.730000032
"12055",2018-09-22 10:51:18,-599995.73,250.000000031898
"12056",2018-09-24 09:11:58,541308.45,541558.450000032
"12057",2018-09-24 10:01:46,-541308.45,250.000000031898
"12058",2018-09-24 11:33:30,895691.95,895941.950000032
"12059",2018-09-24 11:47:07,-895691.95,250.000000031898
"12060",2018-09-24 18:21:35,231301.59,231551.590000032
"12061",2018-09-24 18:38:20,-231301.59,250.000000031898
"12062",2018-09-26 07:11:26,766931.86,767181.860000032
"12063",2018-09-27 00:31:21,403342.85,1170524.71000003
"12064",2018-09-27 07:04:15,709320.43,1879845.14000003
"12065",2018-09-27 20:00:50,482720.23,2362565.37000003
"12066",2018-09-29 02:26:33,-2362315.37,250.000000031665
"12067",2018-09-29 09:17:54,347373.26,347623.260000032
"12068",2018-09-29 10:09:05,-347373.26,250.000000031665
"12069",2018-09-29 11:08:22,725278.27,725528.270000032
"12070",2018-09-29 11:18:43,-725278.27,250.000000031665
"12071",2018-09-30 07:21:52,347958.87,348208.870000032
"12072",2018-09-30 07:40:42,-347958.87,250.000000031665
"12073",2018-09-30 15:49:42,684718.77,684968.770000032
"12074",2018-09-30 16:40:48,-684718.77,250.000000031665
"12075",2018-10-02 21:54:54,486753.49,487003.490000032
"12076",2018-10-02 22:09:20,-486753.49,250.000000031665
"12077",2018-10-03 04:30:36,338481.33,338731.330000032
"12078",2018-10-03 04:35:58,-338481.33,250.000000031665
"12079",2018-10-04 01:56:08,468294.86,468544.860000032
"12080",2018-10-04 02:21:46,-468294.86,250.000000031665
"12081",2018-10-08 13:12:50,89724.75,89974.7500000317
"12082",2018-10-08 13:25:35,-89724.75,250.000000031665
"12083",2018-10-11 05:11:14,599991.76,600241.760000032
"12084",2018-10-11 05:17:28,-599991.76,250.000000031665
"12085",2018-10-11 05:44:08,599991.82,600241.820000032
"12086",2018-10-11 05:55:34,-599991.82,250.000000031665
"12087",2018-10-15 05:59:56,599993.63,600243.630000032
"12088",2018-10-15 06:11:04,599993.78,1200237.41000003
"12089",2018-10-15 06:27:55,-1199987.41,250.000000031898
"12090",2018-10-15 07:00:20,135422.92,135672.920000032
"12091",2018-10-15 08:15:35,-135422.92,250.000000031898
"12092",2018-10-15 12:09:23,609374.84,609624.840000032
"12093",2018-10-15 12:40:21,-609374.84,250.000000031898
"12094",2018-10-15 13:45:27,307093.58,307343.580000032
"12095",2018-10-15 13:53:10,-307093.58,250.000000031898
"12096",2018-10-15 20:53:30,599999.24,600249.240000032
"12097",2018-10-15 21:44:00,-599999.24,250.000000031898
"12098",2018-11-05 15:26:09,364597.41,364847.410000032
"12099",2018-11-06 00:27:53,-364597.41,250.000000031898
"12100",2018-11-06 11:10:44,387492.54,387742.540000032
"12101",2018-11-06 11:20:01,-387492.54,250.000000031898
"12102",2018-11-06 14:02:48,252789.79,253039.790000032
"12103",2018-11-06 14:40:25,-252789.79,250.000000031898
"12104",2018-11-06 18:33:27,386576.38,386826.380000032
"12105",2018-11-06 19:15:10,-386576.38,250.000000031898
"12106",2018-11-08 05:43:14,175588.97,175838.970000032
"12107",2018-11-08 05:48:10,-175588.97,250.000000031898
"12108",2018-11-08 08:46:51,167868.02,168118.020000032
"12109",2018-11-08 08:59:01,-167868.02,250.000000031898
"12110",2018-11-10 07:46:40,101646.51,101896.510000032
"12111",2018-11-10 08:40:51,376792.57,478689.080000032
"12112",2018-11-10 08:46:29,-478439.08,250.000000031898
"12113",2018-11-14 17:31:53,266997.21,267247.210000032
"12114",2018-11-14 18:30:05,-266997.21,250.000000031898
"12115",2018-11-14 19:19:13,58466.31,58716.3100000319
"12116",2018-11-14 19:19:13,25874.47,84590.7800000319
"12117",2018-11-14 19:22:05,101705.87,186296.650000032
"12118",2018-11-14 20:10:58,-186046.65,250.000000031898
"12119",2018-11-14 20:56:35,58995.48,59245.4800000319
"12120",2018-11-14 20:56:35,46130.2,105375.680000032
"12121",2018-11-14 20:56:11,50946.05,156321.730000032
"12122",2018-11-14 21:11:42,-156071.73,250.000000031869
"12123",2018-11-14 21:11:42,28302.05,28552.0500000319
"12124",2018-11-14 21:25:12,31096.83,59648.8800000319
"12125",2018-11-14 21:25:12,57767.73,117416.610000032
"12126",2018-11-14 21:28:49,28143.28,145559.890000032
"12127",2018-11-14 21:28:49,44745.14,190305.030000032
"12128",2018-11-14 21:28:49,200271.08,390576.110000032
"12129",2018-11-14 21:57:25,-117166.61,273409.500000032
"12130",2018-11-14 21:57:25,192352.6,465762.100000032
"12131",2018-11-14 22:02:17,-465512.1,250.000000031898
"12132",2018-11-14 22:02:17,109659.56,109909.560000032
"12133",2018-11-14 22:05:11,128570.1,238479.660000032
"12134",2018-11-14 22:10:33,-238229.66,250.000000031898
"12135",2018-11-14 22:58:43,61620.22,61870.2200000319
"12136",2018-11-14 23:06:33,-61620.22,250.000000031898
"12137",2018-11-14 23:50:16,69125.79,69375.7900000319
"12138",2018-11-15 00:01:30,46757.52,116133.310000032
"12139",2018-11-15 00:01:30,49575.31,165708.620000032
"12140",2018-11-15 00:01:30,24636.17,190344.790000032
"12141",2018-11-15 00:16:56,-69125.79,121219.000000032
"12142",2018-11-15 00:16:56,137453.94,258672.940000032
"12143",2018-11-15 01:11:50,-258422.94,250.000000031898
"12144",2018-11-15 01:46:46,22066.21,22316.2100000319
"12145",2018-11-15 01:46:46,28791.21,51107.4200000319
"12146",2018-11-15 01:55:06,-50857.42,250.000000031898
"12147",2018-11-15 03:02:16,38166.74,38416.7400000319
"12148",2018-11-15 03:08:16,-38166.74,250.000000031898
"12149",2018-11-15 03:08:16,393709.78,393959.780000032
"12150",2018-11-15 03:16:52,-393709.78,250.000000031898
"12151",2018-11-15 03:26:45,146030.03,146280.030000032
"12152",2018-11-15 03:37:07,238419.84,384699.870000032
"12153",2018-11-15 03:56:00,-384449.87,250.000000031898
"12154",2018-11-15 03:56:00,423861.25,424111.250000032
"12155",2018-11-15 04:03:08,-423861.25,250.000000031898
"12156",2018-11-15 05:53:37,147229.51,147479.510000032
"12157",2018-11-15 06:02:15,-147229.51,250.000000031898
"12158",2018-11-15 12:27:18,376491.77,376741.770000032
"12159",2018-11-15 12:54:40,-376491.77,250.000000031898
"12160",2018-11-15 17:11:17,87212.35,87462.3500000319
"12161",2018-11-15 17:33:29,348548.63,436010.980000032
"12162",2018-11-15 18:06:08,-435760.98,250.000000031898
"12163",2018-11-15 18:35:05,425968.27,426218.270000032
"12164",2018-11-15 19:02:08,-425968.27,250.000000031898
"12165",2018-11-15 20:22:53,30426.68,30676.6800000319
"12166",2018-11-15 20:29:23,-30426.68,250.000000031898
"12167",2018-11-19 18:42:54,377782.74,378032.740000032
"12168",2018-11-19 19:02:20,177782.87,555815.610000032
"12169",2018-11-19 19:14:54,-555565.61,250.000000031898
"12170",2018-11-19 19:32:26,177782.91,178032.910000032
"12171",2018-11-19 19:32:26,349397.29,527430.200000032
"12172",2018-11-19 19:32:26,222719.79,750149.990000032
"12173",2018-11-19 19:32:26,187753.23,937903.220000032
"12174",2018-11-19 19:32:26,247081.84,1184985.06000003
"12175",2018-11-19 19:32:26,115236.95,1300222.01000003
"12176",2018-11-19 19:32:26,324651.07,1624873.08000003
"12177",2018-11-19 19:46:37,-1624623.08,250.000000031898
"12178",2018-11-20 10:37:11,177804.23,178054.230000032
"12179",2018-11-20 11:00:05,-177804.23,250.000000031898
"12180",2018-11-20 11:51:54,177784.03,178034.030000032
"12181",2018-11-20 12:32:58,-177784.03,250.000000031898
"12182",2018-11-20 12:32:58,377783.94,378033.940000032
"12183",2018-11-20 13:31:08,-377783.94,250.000000031898
"12184",2018-11-20 23:38:08,196306.63,196556.630000032
"12185",2018-11-20 23:38:08,300007.39,496564.020000032
"12186",2018-11-21 00:35:39,-496314.02,250.000000031898
"12187",2018-11-21 00:35:39,93721.22,93971.2200000319
"12188",2018-11-21 00:35:40,395215.29,489186.510000032
"12189",2018-11-21 01:42:18,-488936.51,250.000000031898
"12190",2018-11-21 03:49:30,239351.48,239601.480000032
"12191",2018-11-21 03:56:48,-239351.48,250.000000031898
"12192",2018-11-21 07:39:59,135844.65,136094.650000032
"12193",2018-11-21 08:23:58,-135844.65,250.000000031898
"12194",2018-11-21 08:37:29,44469.87,44719.8700000319
"12195",2018-11-21 08:37:29,70274.14,114994.010000032
"12196",2018-11-21 08:37:29,197684.93,312678.940000032
"12197",2018-11-21 08:59:48,-312428.94,250.000000031898
"12198",2018-11-23 03:27:54,315347.31,315597.310000032
"12199",2018-11-23 04:08:26,-315347.31,250.000000031898
"12200",2018-11-23 09:03:58,196704.5,196954.500000032
"12201",2018-11-23 09:21:27,-196704.5,250.000000031898
"12202",2018-11-25 00:04:31,248204.58,248454.580000032
"12203",2018-11-25 14:22:36,-248204.58,250.000000031898
"12204",2018-11-25 22:36:26,421768.78,422018.780000032
"12205",2018-11-25 22:54:51,-421768.78,250.000000031898
"12206",2018-11-28 04:57:05,34925.52,35175.5200000319
"12207",2018-11-28 05:07:24,-34925.52,250.000000031898
"12208",2018-11-28 09:08:14,7672.46,7922.4600000319
"12209",2018-11-28 09:40:35,-7672.46,250.000000031898
"12210",2018-11-28 16:03:37,377784.21,378034.210000032
"12211",2018-11-28 17:04:52,-377784.21,250.000000031898
"12212",2018-11-28 18:11:54,483469.13,483719.130000032
"12213",2018-11-28 18:37:05,-483469.13,250.000000031898
"12214",2018-11-29 09:48:38,377785.75,378035.750000032
"12215",2018-11-29 09:58:59,167946.28,545982.030000032
"12216",2018-11-29 10:11:59,-545732.03,250.000000031898
"12217",2018-11-29 14:07:40,222246.44,222496.440000032
"12218",2018-11-29 14:21:20,-222246.44,250.000000031898
"12219",2018-11-30 00:33:05,178262.43,178512.430000032
"12220",2018-11-30 01:18:42,-178262.43,250.000000031898
"12221",2018-11-30 12:12:44,334704.38,334954.380000032
"12222",2018-11-30 12:24:26,-334704.38,250.000000031898
"12223",2018-12-02 08:11:19,256600.81,256850.810000032
"12224",2018-12-02 08:16:11,-256600.81,250.000000031898
"12225",2018-12-03 22:13:21,155035.31,155285.310000032
"12226",2018-12-03 22:30:44,-155035.31,250.000000031898
"12227",2018-12-04 06:10:58,263914.05,264164.050000032
"12228",2018-12-04 06:22:44,-263914.05,250.000000031898
"12229",2018-12-05 01:13:35,494565.13,494815.130000032
"12230",2018-12-05 01:13:35,247331.56,742146.690000032
"12231",2018-12-05 01:27:27,-741896.69,250.000000031898
"12232",2018-12-07 20:27:51,777784.02,778034.020000032
"12233",2018-12-07 20:43:01,-777784.02,250.000000031898
"12234",2018-12-09 00:52:03,377785.41,378035.410000032
"12235",2018-12-09 01:39:14,-377785.41,250.000000031898
"12236",2019-01-22 14:40:09,478260.55,478510.550000032
"12237",2019-01-22 14:47:45,-478260.55,250.000000031898
"12238",2019-01-26 07:54:46,254422.27,254672.270000032
"12239",2019-01-26 08:27:44,-254422.27,250.000000031898
"12240",2019-01-26 20:12:00,200003.84,200253.840000032
"12241",2019-01-26 21:01:04,-200003.84,250.000000031898
"12242",2019-01-27 09:24:38,100004.19,100254.190000032
"12243",2019-01-27 09:39:14,-100004.19,250.000000031898
"12244",2019-01-28 06:50:30,97602.39,97852.3900000319
"12245",2019-01-28 07:17:51,-97602.39,250.000000031898
"12246",2019-01-29 06:14:03,100005.13,100255.130000032
"12247",2019-01-29 07:14:07,-100005.13,250.000000031898
"12248",2019-01-29 21:25:59,150005.32,150255.320000032
"12249",2019-01-29 21:38:53,-150005.32,250.000000031898
"12250",2019-02-08 16:20:41,40860.52,41110.5200000319
"12251",2019-02-08 16:47:08,-40860.52,250.000000031898
"12252",2019-02-08 16:50:54,77685.63,77935.6300000319
"12253",2019-02-08 17:15:11,83157.11,161092.740000032
"12254",2019-02-08 17:37:23,64161.17,225253.910000032
"12255",2019-02-08 17:45:28,85987.89,311241.800000032
"12256",2019-02-08 18:09:42,-310991.8,250.000000031898
"12257",2019-02-08 18:24:29,68210.55,68460.5500000319
"12258",2019-02-08 18:40:39,-68210.55,250.000000031898
"12259",2019-02-08 20:15:49,57540.98,57790.9800000319
"12260",2019-02-08 20:43:04,-57540.98,250.000000031898
"12261",2019-02-08 21:35:58,89542.62,89792.6200000319
"12262",2019-02-08 22:17:27,-89542.62,250.000000031898
"12263",2019-02-14 18:00:15,101845.11,102095.110000032
"12264",2019-02-14 19:01:56,-101845.11,250.000000031898
