"","Time","Amount","Balance"
"9486",2016-06-27 19:02:53,3,3
"9487",2016-06-27 19:22:39,-3,0
"9488",2016-06-27 22:24:36,754.78,754.78
"9489",2016-06-27 22:38:35,-754.78,0
"9490",2016-06-27 22:38:35,3476.29,3476.29
"9491",2016-06-27 22:59:57,1829.53,5305.82
"9492",2016-06-27 23:10:51,-5305.82,0
"9493",2016-06-27 23:52:39,2471.59,2471.59
"9494",2016-06-28 00:07:34,583.31,3054.9
"9495",2016-06-28 00:07:34,2652.34,5707.24
"9496",2016-06-28 00:07:34,-2471.59,3235.65
"9497",2016-06-28 00:43:17,2726.65,5962.3
"9498",2016-06-28 00:43:17,-3235.65,2726.65
"9499",2016-06-28 01:34:07,-2726.65,-9.09494701772928e-13
"9500",2016-06-28 02:17:44,2069.77,2069.77
"9501",2016-06-28 02:33:21,-2069.77,-9.09494701772928e-13
"9502",2016-06-28 04:06:46,2043.91,2043.91
"9503",2016-06-28 04:14:43,3575.57,5619.48
"9504",2016-06-28 04:54:20,-5619.48,0
"9505",2016-06-28 17:45:27,13699.33,13699.33
"9506",2016-06-28 18:17:37,-3476.29,10223.04
"9507",2016-06-28 18:44:17,-1829.53,8393.51
"9508",2016-06-28 23:52:14,-583.31,7810.2
"9509",2016-06-29 06:16:22,-2652.34,5157.86
"9510",2016-06-29 07:08:28,-2043.91,3113.95
"9511",2016-06-29 07:20:35,-3113.95,9.09494701772928e-13
"9512",2016-06-29 08:37:26,10959.33,10959.33
"9513",2016-06-29 09:34:49,12294.18,23253.51
"9514",2016-06-29 09:41:11,-3575.57,19677.94
"9515",2016-06-29 09:52:47,-13699.33,5978.61
"9516",2016-06-29 11:33:15,-5978.61,2.72848410531878e-12
"9517",2016-06-29 13:40:42,15695.05,15695.05
"9518",2016-06-29 14:34:08,-10959.33,4735.72
"9519",2016-06-29 15:16:02,-4735.72,2.72848410531878e-12
"9520",2016-06-30 02:31:11,2735.94,2735.94
"9521",2016-06-30 02:44:29,-2735.94,2.72848410531878e-12
"9522",2016-06-30 07:23:15,2338.35,2338.35
"9523",2016-06-30 07:39:27,-2338.35,2.72848410531878e-12
"9524",2016-06-30 10:00:39,16933.6,16933.6
"9525",2016-06-30 10:14:39,-12294.18,4639.42
"9526",2016-06-30 10:33:01,-4639.42,1.81898940354586e-12
"9527",2016-06-30 14:10:15,20798.15,20798.15
"9528",2016-06-30 14:37:23,-15695.05,5103.1
"9529",2016-06-30 15:22:14,11240.83,16343.93
"9530",2016-06-30 15:22:14,497.07,16841
"9531",2016-06-30 15:22:14,-5103.1,11737.9
"9532",2016-06-30 15:38:27,5480.97,17218.87
"9533",2016-06-30 15:38:27,10497.9,27716.77
"9534",2016-06-30 15:38:27,-11737.9,15978.87
"9535",2016-06-30 15:50:23,-15978.87,3.63797880709171e-12
"9536",2016-06-30 21:06:42,7720.09,7720.09
"9537",2016-06-30 21:37:13,-7720.09,3.63797880709171e-12
"9538",2016-06-30 21:42:00,4915.73,4915.73
"9539",2016-06-30 22:25:35,6208.77,11124.5
"9540",2016-06-30 22:25:35,-4915.73,6208.77
"9541",2016-06-30 22:38:57,-6208.77,3.63797880709171e-12
"9542",2016-06-30 22:54:28,24747.29,24747.29
"9543",2016-06-30 23:14:23,6667.43,31414.72
"9544",2016-06-30 23:37:02,-16933.6,14481.12
"9545",2016-07-01 00:05:52,-14481.12,5.45696821063757e-12
"9546",2016-07-01 00:26:51,5539.15,5539.15000000001
"9547",2016-07-01 00:50:25,-5539.15,5.45696821063757e-12
"9548",2016-07-01 00:53:42,6639.62,6639.62000000001
"9549",2016-07-01 01:14:09,3280.12,9919.74000000001
"9550",2016-07-01 01:14:09,-6639.62,3280.12000000001
"9551",2016-07-01 01:25:47,13032.05,16312.17
"9552",2016-07-01 01:48:06,4654.43,20966.6
"9553",2016-07-01 01:48:06,-16312.17,4654.43000000001
"9554",2016-07-01 01:58:55,3304.89,7959.32000000001
"9555",2016-07-01 02:18:42,-7959.32,5.45696821063757e-12
"9556",2016-07-01 02:58:14,7972.22,7972.22000000001
"9557",2016-07-01 03:19:01,-7972.22,5.45696821063757e-12
"9558",2016-07-01 04:26:46,11001.97,11001.97
"9559",2016-07-01 04:46:50,-11001.97,5.45696821063757e-12
"9560",2016-07-01 06:39:06,4200.26,4200.26000000001
"9561",2016-07-01 07:04:37,-4200.26,5.45696821063757e-12
"9562",2016-07-01 07:19:07,10461.31,10461.31
"9563",2016-07-01 07:59:38,-10461.31,5.45696821063757e-12
"9564",2016-07-01 15:20:48,14356.82,14356.82
"9565",2016-07-01 15:43:23,-14356.82,5.45696821063757e-12
"9566",2016-07-01 20:45:24,9852.11,9852.11000000001
"9567",2016-07-01 21:21:54,-9852.11,5.45696821063757e-12
"9568",2016-07-02 10:16:43,3285.18,3285.18000000001
"9569",2016-07-02 11:02:21,-3285.18,5.45696821063757e-12
"9570",2016-07-02 12:37:08,12173.85,12173.85
"9571",2016-07-02 13:12:43,-12173.85,5.45696821063757e-12
"9572",2016-07-03 08:44:11,5825.43,5825.43000000001
"9573",2016-07-03 09:14:39,-5825.43,5.45696821063757e-12
"9574",2016-07-03 15:23:05,262.61,262.610000000005
"9575",2016-07-03 15:39:17,-262.61,5.45696821063757e-12
"9576",2016-07-03 16:56:01,16231.68,16231.68
"9577",2016-07-03 17:19:19,-16231.68,5.45696821063757e-12
"9578",2016-07-03 22:14:43,17619.75,17619.75
"9579",2016-07-03 23:27:16,-11240.83,6378.92000000001
"9580",2016-07-04 01:26:38,-497.07,5881.85000000001
"9581",2016-07-04 03:26:51,-5480.97,400.880000000007
"9582",2016-07-04 05:36:59,20003.34,20404.22
"9583",2016-07-04 08:24:31,14864.96,35269.18
"9584",2016-07-04 11:08:24,-24747.29,10521.89
"9585",2016-07-04 11:44:48,-6667.43,3854.46000000001
"9586",2016-07-04 12:05:12,-3280.12,574.340000000007
"9587",2016-07-04 12:57:03,31889.86,32464.2
"9588",2016-07-04 12:57:03,-574.34,31889.86
"9589",2016-07-04 13:21:57,-3304.89,28584.97
"9590",2016-07-04 14:05:23,-17619.75,10965.22
"9591",2016-07-04 14:48:10,-10965.22,9.09494701772928e-12
"9592",2016-07-04 16:18:01,17369.15,17369.15
"9593",2016-07-04 16:54:13,-17369.15,7.27595761418343e-12
"9594",2016-07-04 17:40:32,34869.62,34869.62
"9595",2016-07-04 18:00:10,-20003.34,14866.28
"9596",2016-07-04 18:54:54,-14864.96,1.32000000001062
"9597",2016-07-04 19:29:10,4221.19,4222.51000000001
"9598",2016-07-04 19:29:10,31653.82,35876.33
"9599",2016-07-04 19:29:10,-1.32,35875.01
"9600",2016-07-04 19:51:16,-31889.86,3985.15000000001
"9601",2016-07-04 20:34:24,-3985.15,8.64019966684282e-12
"9602",2016-07-05 00:05:46,7934.87,7934.87000000001
"9603",2016-07-05 00:41:33,-7934.87,8.18545231595635e-12
"9604",2016-07-05 01:54:48,9185.26,9185.26000000001
"9605",2016-07-05 02:21:47,-9185.26,9.09494701772928e-12
"9606",2016-07-05 10:05:24,11081.37,11081.37
"9607",2016-07-05 10:13:27,8815.52,19896.89
"9608",2016-07-05 10:31:53,15016.92,34913.81
"9609",2016-07-05 10:31:53,-19896.89,15016.92
"9610",2016-07-05 11:27:13,-15016.92,1.2732925824821e-11
"9611",2016-07-05 13:32:40,19993.96,19993.96
"9612",2016-07-05 14:19:44,-19993.96,1.45519152283669e-11
"9613",2016-07-05 16:01:06,9642.23,9642.23000000001
"9614",2016-07-05 16:20:28,-9642.23,1.45519152283669e-11
"9615",2016-07-05 18:30:16,9024.03,9024.03000000002
"9616",2016-07-05 18:52:42,-9024.03,1.45519152283669e-11
"9617",2016-07-05 20:13:17,8654.74,8654.74000000001
"9618",2016-07-05 20:33:20,-8654.74,1.45519152283669e-11
"9619",2016-07-06 02:11:01,8155.32,8155.32000000001
"9620",2016-07-06 03:42:06,-8155.32,1.45519152283669e-11
"9621",2016-07-06 04:24:44,9340.8,9340.80000000001
"9622",2016-07-06 05:04:01,-9340.8,1.45519152283669e-11
"9623",2016-07-06 20:27:42,8761.65,8761.65000000001
"9624",2016-07-06 21:10:05,-8761.65,1.45519152283669e-11
"9625",2016-07-07 06:00:56,13997.25,13997.25
"9626",2016-07-07 06:00:56,5295.21,19292.46
"9627",2016-07-07 06:00:56,8222.8,27515.26
"9628",2016-07-07 06:37:31,-20798.15,6717.11000000001
"9629",2016-07-07 06:54:27,6091.16,12808.27
"9630",2016-07-07 07:02:49,-10497.9,2310.37000000001
"9631",2016-07-07 07:37:26,24218.43,26528.8
"9632",2016-07-07 07:45:00,-13032.05,13496.75
"9633",2016-07-07 08:21:27,-4654.43,8842.32000000001
"9634",2016-07-07 08:41:20,6935.73,15778.05
"9635",2016-07-07 08:41:20,13380,29158.05
"9636",2016-07-07 08:46:59,-29158.05,1.09139364212751e-11
"9637",2016-07-07 13:00:05,15446.45,15446.45
"9638",2016-07-07 13:19:51,-15446.45,1.09139364212751e-11
"9639",2016-07-07 15:35:37,14243.57,14243.57
"9640",2016-07-07 15:56:38,-14243.57,1.09139364212751e-11
"9641",2016-07-07 17:04:40,37101.21,37101.21
"9642",2016-07-07 17:14:49,17870.4,54971.61
"9643",2016-07-07 17:14:49,3766.31,58737.92
"9644",2016-07-07 17:27:22,7360.24,66098.16
"9645",2016-07-07 17:27:22,-34869.62,31228.54
"9646",2016-07-07 17:39:05,-4221.19,27007.35
"9647",2016-07-07 17:59:47,-27007.35,3.63797880709171e-12
"9648",2016-07-07 21:04:21,16341.33,16341.33
"9649",2016-07-07 21:44:22,38649.8,54991.13
"9650",2016-07-07 21:44:22,21376.28,76367.41
"9651",2016-07-07 21:52:06,-31653.82,44713.59
"9652",2016-07-07 22:08:07,22525.68,67239.27
"9653",2016-07-07 22:08:07,28730.96,95970.23
"9654",2016-07-07 22:11:09,-11081.37,84888.86
"9655",2016-07-07 22:37:45,5635.16,90524.02
"9656",2016-07-07 22:42:11,-8815.52,81708.5
"9657",2016-07-07 22:57:27,7162.43,88870.93
"9658",2016-07-07 22:57:27,-13997.25,74873.68
"9659",2016-07-07 23:21:47,7952.25,82825.93
"9660",2016-07-07 23:28:35,-5295.21,77530.72
"9661",2016-07-07 23:39:41,6910.51,84441.23
"9662",2016-07-08 00:06:30,-8222.8,76218.43
"9663",2016-07-08 00:27:49,10656.24,86874.67
"9664",2016-07-08 01:01:36,6337.78,93212.45
"9665",2016-07-08 05:38:02,-6091.16,87121.29
"9666",2016-07-08 05:47:46,-24218.43,62902.86
"9667",2016-07-08 06:12:59,-6935.73,55967.13
"9668",2016-07-08 06:44:07,-37101.21,18865.92
"9669",2016-07-08 06:44:07,-13380,5485.92000000001
"9670",2016-07-08 06:54:23,-5485.92,5.45696821063757e-12
"9671",2016-07-09 12:15:27,17406.81,17406.81
"9672",2016-07-09 12:37:18,-17406.81,3.63797880709171e-12
"9673",2016-07-09 15:09:57,17537.44,17537.44
"9674",2016-07-09 15:25:54,-17537.44,3.63797880709171e-12
"9675",2016-07-09 17:54:34,19245.48,19245.48
"9676",2016-07-09 18:12:52,-17870.4,1375.08
"9677",2016-07-09 18:15:15,-1375.08,1.81898940354586e-12
"9678",2016-07-14 18:48:51,19417.21,19417.21
"9679",2016-07-14 18:54:35,-19417.21,0
"9680",2016-07-14 21:50:02,26590.3,26590.3
"9681",2016-07-14 22:03:20,-26590.3,0
"9682",2016-07-15 04:00:58,17716.27,17716.27
"9683",2016-07-15 04:11:41,-17716.27,0
"9684",2016-07-15 09:38:24,22057.19,22057.19
"9685",2016-07-15 09:44:14,-22057.19,0
"9686",2016-07-17 17:54:08,24682.71,24682.71
"9687",2016-07-17 17:58:29,-24682.71,0
"9688",2016-07-17 22:35:29,22653.89,22653.89
"9689",2016-07-17 23:01:21,-22653.89,0
"9690",2016-07-22 17:30:20,24697.92,24697.92
"9691",2016-07-22 17:38:07,-24697.92,0
"9692",2016-07-22 20:31:53,66756.98,66756.98
"9693",2016-07-22 20:44:53,-66756.98,0
"9694",2016-07-23 00:03:19,44458.64,44458.64
"9695",2016-07-23 00:05:50,-44458.64,0
"9696",2016-07-23 00:52:16,24450.8,24450.8
"9697",2016-07-23 01:14:18,-24450.8,0
"9698",2016-07-24 07:07:01,16108.54,16108.54
"9699",2016-07-24 07:25:39,-16108.54,0
"9700",2016-07-24 08:20:24,16319.91,16319.91
"9701",2016-07-24 08:20:24,15850.31,32170.22
"9702",2016-07-24 08:50:25,-32170.22,0
"9703",2016-07-26 10:37:36,22533.49,22533.49
"9704",2016-07-26 10:43:14,-22533.49,0
"9705",2016-07-26 11:57:03,39479.98,39479.98
"9706",2016-07-26 12:07:59,-39479.98,0
"9707",2016-07-26 12:26:33,20685.65,20685.65
"9708",2016-07-26 12:33:12,-20685.65,0
"9709",2016-07-26 13:10:05,20878.67,20878.67
"9710",2016-07-26 13:10:05,17382.02,38260.69
"9711",2016-07-26 13:35:05,-38260.69,0
"9712",2016-07-26 13:35:05,30529.33,30529.33
"9713",2016-07-26 14:03:26,-30529.33,0
"9714",2016-07-27 10:52:02,18801.65,18801.65
"9715",2016-07-27 10:52:02,13857.21,32658.86
"9716",2016-07-27 10:52:02,11434.56,44093.42
"9717",2016-07-27 11:32:16,-44093.42,0
"9718",2016-07-28 13:20:33,33081.78,33081.78
"9719",2016-07-28 13:40:05,-33081.78,0
"9720",2016-07-28 18:21:15,64009.9,64009.9
"9721",2016-07-28 18:32:39,-64009.9,0
"9722",2016-07-30 14:01:31,20220.52,20220.52
"9723",2016-07-30 14:42:48,-20220.52,0
"9724",2016-07-31 10:36:36,19465.26,19465.26
"9725",2016-07-31 10:42:43,-19465.26,0
"9726",2016-07-31 12:45:36,31664.03,31664.03
"9727",2016-07-31 12:49:27,-31664.03,0
"9728",2016-07-31 20:34:43,22531.98,22531.98
"9729",2016-07-31 20:57:42,-22531.98,0
"9730",2016-08-01 01:40:18,22537.78,22537.78
"9731",2016-08-01 01:57:38,22485.58,45023.36
"9732",2016-08-01 03:33:28,-45023.36,0
"9733",2016-08-01 03:59:03,22316.27,22316.27
"9734",2016-08-01 05:03:33,-22316.27,0
"9735",2016-08-01 07:42:27,22945.42,22945.42
"9736",2016-08-01 09:14:58,-22945.42,0
"9737",2016-08-01 18:02:14,27175.29,27175.29
"9738",2016-08-01 18:23:18,25441.04,52616.33
"9739",2016-08-01 18:23:18,-27175.29,25441.04
"9740",2016-08-01 18:35:58,-25441.04,0
"9741",2016-08-01 19:42:19,99318.56,99318.56
"9742",2016-08-01 19:52:48,-99318.56,0
"9743",2016-08-01 20:54:41,25975.05,25975.05
"9744",2016-08-01 22:07:15,-25975.05,0
"9745",2016-08-01 22:51:40,22807.83,22807.83
"9746",2016-08-01 23:00:07,-22807.83,0
"9747",2016-08-02 01:02:24,23036.83,23036.83
"9748",2016-08-02 02:01:52,-23036.83,0
"9749",2016-08-02 02:58:35,16408.59,16408.59
"9750",2016-08-02 03:25:46,-16408.59,0
"9751",2016-08-02 03:51:31,24971.59,24971.59
"9752",2016-08-02 04:19:03,29553.63,54525.22
"9753",2016-08-02 04:52:01,48937.2,103462.42
"9754",2016-08-02 05:27:44,26953.7,130416.12
"9755",2016-08-02 05:27:44,19343.75,149759.87
"9756",2016-08-02 05:27:44,-103462.42,46297.45
"9757",2016-08-02 06:22:20,-46297.45,0
"9758",2016-08-02 06:51:46,27852.13,27852.13
"9759",2016-08-02 07:12:33,-27852.13,0
"9760",2016-08-02 08:17:44,17619.05,17619.05
"9761",2016-08-02 09:02:45,-17619.05,0
"9762",2016-08-02 09:13:09,22822.28,22822.28
"9763",2016-08-02 10:11:45,-22822.28,0
"9764",2016-08-02 20:39:51,1043.39,1043.39
"9765",2016-08-02 22:08:23,-1043.39,0
"9766",2016-08-14 14:12:47,16857.62,16857.62
"9767",2016-08-14 14:12:47,12934.51,29792.13
"9768",2016-08-14 14:28:58,-29792.13,-3.63797880709171e-12
"9769",2016-08-14 15:34:53,7529.85,7529.85
"9770",2016-08-14 15:41:37,-7529.85,-3.63797880709171e-12
"9771",2016-08-14 23:17:33,10240.23,10240.23
"9772",2016-08-15 00:49:30,15471.65,25711.88
"9773",2016-08-15 05:24:02,-25711.88,-3.63797880709171e-12
"9774",2016-08-17 19:29:37,6386.53,6386.53
"9775",2016-08-17 20:18:19,-6386.53,-3.63797880709171e-12
"9776",2016-08-17 22:00:14,7789.08,7789.08
"9777",2016-08-17 22:10:54,-7789.08,-3.63797880709171e-12
"9778",2016-08-18 04:53:45,6786.13,6786.13
"9779",2016-08-18 05:09:35,-6786.13,-3.63797880709171e-12
"9780",2016-08-18 10:01:45,13121.29,13121.29
"9781",2016-08-18 11:48:52,-13121.29,-3.63797880709171e-12
"9782",2016-08-19 16:51:59,6843.65,6843.65
"9783",2016-08-19 17:45:39,6398.27,13241.92
"9784",2016-08-19 17:45:39,6952.3,20194.22
"9785",2016-08-19 17:45:39,-6843.65,13350.57
"9786",2016-08-19 18:27:33,-13350.57,-1.81898940354586e-12
"9787",2016-08-20 12:04:14,8382.73,8382.73
"9788",2016-08-20 12:47:42,-8382.73,-1.81898940354586e-12
"9789",2016-08-28 14:54:58,7856.6,7856.6
"9790",2016-08-28 15:44:32,-7856.6,-1.81898940354586e-12
"9791",2016-08-29 00:27:34,6202.05,6202.05
"9792",2016-08-29 00:27:34,6079.86,12281.91
"9793",2016-08-29 00:46:36,-12281.91,-1.81898940354586e-12
"9794",2016-08-29 01:49:17,7212.61,7212.61
"9795",2016-08-29 02:07:56,-7212.61,-1.81898940354586e-12
"9796",2016-08-29 02:47:36,7955.72,7955.72
"9797",2016-08-29 02:47:36,6093.25,14048.97
"9798",2016-08-29 02:53:04,-14048.97,-1.81898940354586e-12
"9799",2016-08-29 09:26:17,7310.43,7310.43
"9800",2016-08-29 11:01:36,-7310.43,-1.81898940354586e-12
"9801",2016-09-01 04:00:58,6515.32,6515.32
"9802",2016-09-01 04:29:16,-6515.32,-1.81898940354586e-12
"9803",2016-09-01 07:41:54,6349.1,6349.1
"9804",2016-09-01 07:46:52,-6349.1,-1.81898940354586e-12
"9805",2016-09-01 08:30:08,6329.72,6329.72
"9806",2016-09-01 08:57:17,-6329.72,-1.81898940354586e-12
"9807",2016-09-02 19:25:26,8050.63,8050.63
"9808",2016-09-02 19:54:44,-8050.63,-1.81898940354586e-12
"9809",2016-09-03 08:57:59,9184.37,9184.37
"9810",2016-09-03 08:57:59,7160.12,16344.49
"9811",2016-09-03 11:44:53,-16344.49,-1.81898940354586e-12
"9812",2016-09-03 16:40:03,13556.1,13556.1
"9813",2016-09-03 16:40:03,6234.54,19790.64
"9814",2016-09-03 17:44:13,-19790.64,0
"9815",2016-09-03 23:44:58,11930.1,11930.1
"9816",2016-09-03 23:44:58,11701.39,23631.49
"9817",2016-09-03 23:44:58,9626.56,33258.05
"9818",2016-09-03 23:44:58,9474.75,42732.8
"9819",2016-09-03 23:44:58,9470.09,52202.89
"9820",2016-09-03 23:44:58,6270.35,58473.24
"9821",2016-09-04 00:47:42,-58473.24,0
"9822",2016-09-04 03:42:52,6751.85,6751.85
"9823",2016-09-04 04:40:01,-6751.85,0
"9824",2016-09-04 05:50:18,11564.81,11564.81
"9825",2016-09-04 06:04:13,-11564.81,0
"9826",2016-09-04 06:51:02,7380.08,7380.08
"9827",2016-09-04 08:09:51,-7380.08,0
"9828",2016-09-04 10:42:07,7302.11,7302.11
"9829",2016-09-04 11:19:08,-7302.11,0
"9830",2016-09-04 18:38:58,9198.44,9198.44
"9831",2016-09-04 18:38:58,6173.58,15372.02
"9832",2016-09-04 19:13:10,-15372.02,0
"9833",2016-09-04 22:26:43,6638.81,6638.81
"9834",2016-09-04 22:47:50,-6638.81,0
"9835",2016-09-05 00:00:18,9089.54,9089.54
"9836",2016-09-05 00:01:40,7649.51,16739.05
"9837",2016-09-05 00:17:48,-16739.05,3.63797880709171e-12
"9838",2016-09-05 01:27:48,8442.56,8442.56
"9839",2016-09-05 01:51:34,-8442.56,3.63797880709171e-12
"9840",2016-09-05 05:41:05,7354.6,7354.6
"9841",2016-09-05 06:06:05,-7354.6,3.63797880709171e-12
"9842",2016-09-05 06:16:28,8059.67,8059.67
"9843",2016-09-05 06:47:14,7738.02,15797.69
"9844",2016-09-05 07:21:34,-15797.69,3.63797880709171e-12
"9845",2016-09-05 09:26:52,6678.73,6678.73
"9846",2016-09-05 09:57:38,-6678.73,3.63797880709171e-12
"9847",2016-09-05 21:35:19,20003.9,20003.9
"9848",2016-09-05 21:47:21,-20003.9,3.63797880709171e-12
"9849",2016-09-06 01:27:39,8046.43,8046.43
"9850",2016-09-06 01:42:30,30003.92,38050.35
"9851",2016-09-06 01:56:42,-38050.35,7.27595761418343e-12
"9852",2016-09-06 15:34:20,9211.6,9211.60000000001
"9853",2016-09-06 15:39:23,-9211.6,7.27595761418343e-12
"9854",2016-09-06 19:11:59,11883.57,11883.57
"9855",2016-09-06 19:51:28,-11883.57,7.27595761418343e-12
"9856",2016-09-08 09:20:42,22568.21,22568.21
"9857",2016-09-08 09:46:52,8702.13,31270.34
"9858",2016-09-08 10:50:41,-31270.34,3.63797880709171e-12
"9859",2016-09-11 00:51:13,10395.66,10395.66
"9860",2016-09-11 01:08:49,10013.39,20409.05
"9861",2016-09-11 01:44:33,-20409.05,3.63797880709171e-12
"9862",2016-09-12 00:04:45,10261.01,10261.01
"9863",2016-09-12 01:17:58,12339.6,22600.61
"9864",2016-09-12 01:17:58,-10261.01,12339.6
"9865",2016-09-12 02:21:13,-12339.6,3.63797880709171e-12
"9866",2016-09-12 13:22:12,8723.61,8723.61
"9867",2016-09-12 13:46:31,-8723.61,3.63797880709171e-12
"9868",2016-09-13 03:18:38,10510.63,10510.63
"9869",2016-09-13 03:18:38,8836.99,19347.62
"9870",2016-09-13 03:53:47,-19347.62,3.63797880709171e-12
"9871",2016-09-14 11:14:16,18239.32,18239.32
"9872",2016-09-14 11:39:34,-18239.32,3.63797880709171e-12
"9873",2016-09-15 17:33:29,10290.92,10290.92
"9874",2016-09-15 17:48:43,-10290.92,3.63797880709171e-12
"9875",2016-09-15 20:09:33,8526.72,8526.72
"9876",2016-09-15 20:38:29,-8526.72,3.63797880709171e-12
"9877",2016-09-16 20:43:09,10602.68,10602.68
"9878",2016-09-16 21:53:15,-10602.68,3.63797880709171e-12
"9879",2016-09-18 17:35:22,12045.62,12045.62
"9880",2016-09-18 19:31:56,-12045.62,3.63797880709171e-12
"9881",2016-09-18 20:57:55,10323.8,10323.8
"9882",2016-09-18 21:10:48,-10323.8,3.63797880709171e-12
"9883",2016-09-20 10:40:04,9978.42,9978.42
"9884",2016-09-20 11:17:20,-9978.42,3.63797880709171e-12
"9885",2016-09-20 15:00:35,10846.28,10846.28
"9886",2016-09-20 16:39:06,-10846.28,3.63797880709171e-12
"9887",2016-09-20 23:22:49,8723.76,8723.76
"9888",2016-09-20 23:22:49,13199.45,21923.21
"9889",2016-09-20 23:51:18,-21923.21,7.27595761418343e-12
"9890",2016-09-21 16:33:34,8751.79,8751.79000000001
"9891",2016-09-21 17:03:59,-8751.79,7.27595761418343e-12
"9892",2016-09-22 16:01:07,5605.04,5605.04000000001
"9893",2016-09-22 16:01:07,17781.84,23386.88
"9894",2016-09-22 16:24:59,-23386.88,7.27595761418343e-12
"9895",2016-09-23 20:38:54,11080.67,11080.67
"9896",2016-09-23 21:17:55,-11080.67,7.27595761418343e-12
"9897",2016-09-25 13:11:13,81.91,81.9100000000073
"9898",2016-09-29 11:51:09,-81.91,7.27595761418343e-12
"9899",2016-09-29 21:09:27,1581.24,1581.24000000001
"9900",2016-09-30 01:17:49,-1581.24,7.27595761418343e-12
"9901",2016-09-30 18:48:17,901.69,901.690000000007
"9902",2016-09-30 20:14:09,-901.69,7.27595761418343e-12
"9903",2016-10-03 10:57:40,17634.27,17634.27
"9904",2016-10-03 13:39:05,-17634.27,7.27595761418343e-12
"9905",2016-10-03 20:53:11,3892.83,3892.83000000001
"9906",2016-10-03 21:22:43,-3892.83,7.27595761418343e-12
"9907",2016-10-04 08:41:53,8152,8152.00000000001
"9908",2016-10-04 09:41:58,-8152,7.27595761418343e-12
"9909",2016-10-05 13:57:44,8780.12,8780.12000000001
"9910",2016-10-05 14:31:32,-8780.12,7.27595761418343e-12
"9911",2016-10-08 07:17:45,10470.22,10470.22
"9912",2016-10-08 08:01:35,-10470.22,7.27595761418343e-12
"9913",2016-10-11 06:18:07,9841.73,9841.73000000001
"9914",2016-10-11 06:18:07,9467.42,19309.15
"9915",2016-10-11 06:32:45,-19309.15,7.27595761418343e-12
"9916",2016-10-11 17:47:04,25388.87,25388.87
"9917",2016-10-11 17:56:51,-25388.87,7.27595761418343e-12
"9918",2016-10-11 20:01:00,15653.01,15653.01
"9919",2016-10-11 20:01:00,12744.96,28397.97
"9920",2016-10-11 20:01:00,11318.75,39716.72
"9921",2016-10-11 20:15:26,-39716.72,7.27595761418343e-12
"9922",2016-10-11 23:57:30,16428.43,16428.43
"9923",2016-10-12 00:24:59,-16428.43,7.27595761418343e-12
"9924",2016-10-12 08:57:06,4487.34,4487.34000000001
"9925",2016-10-12 15:10:54,14965.23,19452.57
"9926",2016-10-12 22:10:37,12251.7,31704.27
"9927",2016-10-13 02:53:30,-31704.27,7.27595761418343e-12
"9928",2016-10-13 02:53:30,6014.06,6014.06000000001
"9929",2016-10-13 03:30:12,13236.15,19250.21
"9930",2016-10-14 08:45:30,-19250.21,7.27595761418343e-12
"9931",2016-10-14 20:50:19,14090.42,14090.42
"9932",2016-10-14 22:02:02,-14090.42,7.27595761418343e-12
"9933",2016-10-15 07:55:43,4143.3,4143.30000000001
"9934",2016-10-15 09:31:08,-4143.3,7.27595761418343e-12
"9935",2016-10-15 11:14:52,4207.96,4207.96000000001
"9936",2016-10-15 11:34:47,-4207.96,7.27595761418343e-12
"9937",2016-10-17 06:11:15,11370.69,11370.69
"9938",2016-10-17 09:58:28,1089.87,12460.56
"9939",2016-10-17 11:12:27,1000.36,13460.92
"9940",2016-10-17 11:12:27,-12460.56,1000.36000000001
"9941",2016-10-17 12:50:13,-1000.36,9.66338120633736e-12
"9942",2016-10-18 22:43:38,4052.76,4052.76000000001
"9943",2016-10-18 23:35:18,-4052.76,9.54969436861575e-12
"9944",2016-10-19 01:29:12,14078,14078
"9945",2016-10-19 02:24:23,-14078,9.09494701772928e-12
"9946",2016-10-19 13:01:00,11793.77,11793.77
"9947",2016-10-19 19:11:52,-11793.77,9.09494701772928e-12
"9948",2016-10-21 00:05:39,8109.86,8109.86000000001
"9949",2016-10-21 00:26:57,-8109.86,9.09494701772928e-12
"9950",2016-10-21 03:38:03,6915.26,6915.26000000001
"9951",2016-10-21 03:56:19,-6915.26,9.09494701772928e-12
"9952",2016-10-21 15:59:48,7270.12,7270.12000000001
"9953",2016-10-21 18:26:12,-7270.12,9.09494701772928e-12
"9954",2016-10-22 01:50:32,7427.46,7427.46000000001
"9955",2016-10-22 01:51:52,6751.22,14178.68
"9956",2016-10-22 02:10:18,-14178.68,9.09494701772928e-12
"9957",2016-10-22 07:24:49,7168.95,7168.95000000001
"9958",2016-10-22 07:30:33,-7168.95,9.09494701772928e-12
"9959",2016-10-22 15:36:09,4139.53,4139.53000000001
"9960",2016-10-22 15:36:09,11485.22,15624.75
"9961",2016-10-22 15:36:09,10005.97,25630.72
"9962",2016-10-22 16:00:17,1021.54,26652.26
"9963",2016-10-22 16:27:34,-26652.26,1.09139364212751e-11
"9964",2016-10-22 16:27:34,17005.99,17005.99
"9965",2016-10-22 16:49:23,-17005.99,1.09139364212751e-11
"9966",2016-10-22 20:23:08,17006,17006
"9967",2016-10-22 20:23:08,17506.03,34512.03
"9968",2016-10-22 20:48:02,-34512.03,1.45519152283669e-11
"9969",2016-10-22 21:03:58,18006.02,18006.02
"9970",2016-10-22 21:27:13,-18006.02,1.45519152283669e-11
"9971",2016-10-23 01:20:01,1783.08,1783.08000000001
"9972",2016-10-23 01:20:01,10675.87,12458.95
"9973",2016-10-23 01:20:01,8753.11,21212.06
"9974",2016-10-23 01:54:56,-21212.06,1.45519152283669e-11
"9975",2016-10-23 07:28:43,9039.18,9039.18000000001
"9976",2016-10-23 07:46:53,-9039.18,1.45519152283669e-11
"9977",2016-10-25 05:20:18,9794.18,9794.18000000001
"9978",2016-10-25 05:40:57,-9794.18,1.45519152283669e-11
"9979",2016-10-26 00:02:45,16991.62,16991.62
"9980",2016-10-26 00:58:38,-16991.62,1.45519152283669e-11
"9981",2016-10-26 04:52:46,9469.61,9469.61000000002
"9982",2016-10-26 05:13:24,-9469.61,1.45519152283669e-11
"9983",2016-10-26 12:32:00,17006.37,17006.37
"9984",2016-10-26 12:32:00,7074.09,24080.46
"9985",2016-10-26 13:11:01,-24080.46,1.45519152283669e-11
"9986",2016-10-26 15:10:41,30006.39,30006.39
"9987",2016-10-26 15:10:41,16220.02,46226.41
"9988",2016-10-26 15:33:54,-46226.41,1.45519152283669e-11
"9989",2016-10-26 17:56:08,5873.39,5873.39000000001
"9990",2016-10-26 18:04:55,-5873.39,1.45519152283669e-11
"9991",2016-10-27 02:06:27,6960.26,6960.26000000001
"9992",2016-10-27 02:49:52,8756.87,15717.13
"9993",2016-10-27 03:25:26,-15717.13,1.63709046319127e-11
"9994",2016-10-27 13:36:16,30006.55,30006.55
"9995",2016-10-27 13:36:16,4699.48,34706.03
"9996",2016-10-27 13:51:26,-34706.03,1.45519152283669e-11
"9997",2016-10-27 19:00:11,9727.75,9727.75000000001
"9998",2016-10-27 19:45:16,-9727.75,1.45519152283669e-11
"9999",2016-10-27 22:37:41,5029.6,5029.60000000001
"10000",2016-10-27 23:02:05,-5029.6,1.45519152283669e-11
"10001",2016-10-28 01:31:41,9216.25,9216.25000000001
"10002",2016-10-28 01:34:40,-9216.25,1.45519152283669e-11
"10003",2016-10-28 16:37:55,27128.59,27128.59
"10004",2016-10-28 16:37:55,13783.64,40912.23
"10005",2016-10-28 16:59:53,-40912.23,7.27595761418343e-12
"10006",2016-10-28 21:49:34,8470.83,8470.83000000001
"10007",2016-10-28 22:37:01,-8470.83,7.27595761418343e-12
"10008",2016-10-29 00:04:20,17783.7,17783.7
"10009",2016-10-29 00:24:29,-17783.7,7.27595761418343e-12
"10010",2016-10-29 03:32:01,4579.98,4579.98000000001
"10011",2016-10-29 05:34:50,-4579.98,7.27595761418343e-12
"10012",2016-10-29 13:10:56,8133.89,8133.89000000001
"10013",2016-10-29 13:42:22,8006.74,16140.63
"10014",2016-10-29 13:52:52,-16140.63,9.09494701772928e-12
"10015",2016-10-29 16:20:00,18894.76,18894.76
"10016",2016-10-29 16:42:14,37783.78,56678.54
"10017",2016-10-29 16:42:14,4843.44,61521.98
"10018",2016-10-29 16:42:14,-18894.76,42627.22
"10019",2016-10-29 17:24:07,-42627.22,1.45519152283669e-11
"10020",2016-10-29 17:57:26,13006.81,13006.81
"10021",2016-10-29 17:57:26,5600.42,18607.23
"10022",2016-10-29 18:14:13,-18607.23,1.45519152283669e-11
"10023",2016-10-29 20:33:06,6006.87,6006.87000000001
"10024",2016-10-29 20:59:30,14435.32,20442.19
"10025",2016-10-29 20:59:30,17341.89,37784.08
"10026",2016-10-29 20:59:30,9317.12,47101.2
"10027",2016-10-29 21:05:32,-47101.2,2.18278728425503e-11
"10028",2016-10-30 02:10:25,17006.93,17006.93
"10029",2016-10-30 02:10:25,4518.05,21524.98
"10030",2016-10-30 03:12:50,24355.95,45880.93
"10031",2016-10-30 03:54:35,-45880.93,2.18278728425503e-11
"10032",2016-10-30 14:43:47,17783.96,17783.96
"10033",2016-10-30 14:55:18,-17783.96,2.18278728425503e-11
"10034",2016-10-30 16:19:45,12697.22,12697.22
"10035",2016-10-30 16:36:26,-12697.22,2.18278728425503e-11
"10036",2016-10-30 18:21:38,14867.23,14867.23
"10037",2016-10-30 18:21:38,12635.97,27503.2
"10038",2016-10-30 18:51:36,-27503.2,1.81898940354586e-11
"10039",2016-10-30 21:47:25,37784.02,37784.02
"10040",2016-10-30 21:52:09,17784.03,55568.05
"10041",2016-10-30 21:52:09,13804.82,69372.87
"10042",2016-10-30 23:21:57,-69372.87,2.91038304567337e-11
"10043",2016-10-31 04:49:07,11923.53,11923.53
"10044",2016-10-31 05:22:13,-11923.53,2.91038304567337e-11
"10045",2016-10-31 05:50:59,12552.04,12552.04
"10046",2016-10-31 06:03:13,-12552.04,2.91038304567337e-11
"10047",2016-10-31 13:46:44,12177.42,12177.42
"10048",2016-10-31 18:04:21,-12177.42,2.91038304567337e-11
"10049",2016-11-01 07:43:15,15012.92,15012.92
"10050",2016-11-01 09:14:06,14746.16,29759.08
"10051",2016-11-01 09:14:06,12472.76,42231.84
"10052",2016-11-01 09:14:06,11253,53484.84
"10053",2016-11-01 09:36:00,-53484.84,3.63797880709171e-11
"10054",2016-11-01 10:49:13,14122.76,14122.76
"10055",2016-11-01 11:07:11,-14122.76,3.63797880709171e-11
"10056",2016-11-01 12:00:03,18008.33,18008.33
"10057",2016-11-01 12:15:55,-18008.33,3.63797880709171e-11
"10058",2016-11-01 14:04:07,11268.54,11268.54
"10059",2016-11-01 14:40:45,-11268.54,3.63797880709171e-11
"10060",2016-11-01 15:43:59,11266.22,11266.22
"10061",2016-11-01 16:07:02,-11266.22,3.63797880709171e-11
"10062",2016-11-02 07:34:54,29261.79,29261.79
"10063",2016-11-02 08:11:53,24719.4,53981.19
"10064",2016-11-02 09:03:39,-53981.19,3.63797880709171e-11
"10065",2016-11-02 16:17:38,11254.91,11254.91
"10066",2016-11-02 16:40:08,-11254.91,3.63797880709171e-11
"10067",2016-11-03 01:22:11,13703.72,13703.72
"10068",2016-11-03 02:03:23,-13703.72,3.63797880709171e-11
"10069",2016-11-03 11:51:57,15797.91,15797.91
"10070",2016-11-03 11:51:57,12545.96,28343.87
"10071",2016-11-03 12:07:50,-28343.87,3.63797880709171e-11
"10072",2016-11-03 17:06:31,11902.27,11902.27
"10073",2016-11-03 17:06:31,21576.27,33478.54
"10074",2016-11-03 17:12:59,5007.3,38485.84
"10075",2016-11-03 18:57:17,-38485.84,4.36557456851006e-11
"10076",2016-11-04 00:56:53,32694.69,32694.69
"10077",2016-11-04 01:22:04,-32694.69,4.36557456851006e-11
"10078",2016-11-04 19:11:28,12027.63,12027.63
"10079",2016-11-04 19:29:26,-12027.63,4.36557456851006e-11
"10080",2016-11-04 19:45:24,14854.48,14854.48
"10081",2016-11-04 20:23:50,-14854.48,4.36557456851006e-11
"10082",2016-11-04 23:08:00,11946.33,11946.33
"10083",2016-11-05 02:39:58,-11946.33,4.36557456851006e-11
"10084",2016-11-05 15:29:28,11834.71,11834.71
"10085",2016-11-05 16:26:20,-11834.71,4.36557456851006e-11
"10086",2016-11-07 18:12:31,11523.48,11523.48
"10087",2016-11-07 18:38:34,-11523.48,4.36557456851006e-11
"10088",2016-11-07 20:51:02,11385.7,11385.7
"10089",2016-11-07 20:54:39,-11385.7,4.36557456851006e-11
"10090",2016-11-08 04:11:16,16044.64,16044.64
"10091",2016-11-08 05:01:16,-16044.64,4.36557456851006e-11
"10092",2016-11-08 13:35:21,14718.14,14718.14
"10093",2016-11-08 13:54:17,-14718.14,4.36557456851006e-11
"10094",2016-11-08 18:54:50,11761.89,11761.89
"10095",2016-11-08 19:18:53,-11761.89,4.36557456851006e-11
"10096",2016-11-09 07:42:26,14405.05,14405.05
"10097",2016-11-09 10:12:16,12495.85,26900.9
"10098",2016-11-09 10:35:40,12391.33,39292.23
"10099",2016-11-09 10:35:40,-26900.9,12391.33
"10100",2016-11-09 11:05:20,12595.68,24987.01
"10101",2016-11-09 11:09:33,-24987.01,4.72937244921923e-11
"10102",2016-11-09 12:51:33,3551.62,3551.62000000005
"10103",2016-11-09 13:13:59,5672.18,9223.80000000005
"10104",2016-11-09 13:52:55,2766.22,11990.02
"10105",2016-11-09 14:08:52,-11990.02,4.54747350886464e-11
"10106",2016-11-09 14:28:31,3452.08,3452.08000000005
"10107",2016-11-09 14:28:31,7160.19,10612.27
"10108",2016-11-09 14:54:31,-10612.27,4.36557456851006e-11
"10109",2016-11-09 15:06:27,5601.99,5601.99000000004
"10110",2016-11-09 15:06:27,21693.69,27295.68
"10111",2016-11-09 15:43:07,5134.65,32430.33
"10112",2016-11-09 15:43:07,-27295.68,5134.65000000005
"10113",2016-11-09 15:57:24,-5134.65,4.54747350886464e-11
"10114",2016-11-09 16:10:32,3259.68,3259.68000000005
"10115",2016-11-09 17:09:58,2643.39,5903.07000000005
"10116",2016-11-09 17:09:58,5398.09,11301.16
"10117",2016-11-09 17:47:14,1940.08,13241.24
"10118",2016-11-09 18:37:30,-13241.24,4.54747350886464e-11
"10119",2016-11-09 20:48:51,3480.23,3480.23000000005
"10120",2016-11-09 20:48:51,2675.98,6156.21000000005
"10121",2016-11-09 21:22:40,1479.39,7635.60000000005
"10122",2016-11-09 23:09:20,11539.94,19175.54
"10123",2016-11-13 13:19:49,10163.14,29338.68
"10124",2016-11-13 14:36:26,12888.57,42227.25
"10125",2016-11-13 14:47:15,9886.82,52114.07
"10126",2016-11-13 15:45:05,10315.23,62429.3
"10127",2016-11-13 16:27:44,13145.41,75574.7100000001
"10128",2016-11-13 16:27:44,12406.04,87980.7500000001
"10129",2016-11-13 17:14:10,8663.59,96644.3400000001
"10130",2016-11-13 19:10:25,8347.8,104992.14
"10131",2016-11-14 01:53:49,8658.61,113650.75
"10132",2016-11-14 09:14:56,-113650.75,5.82076609134674e-11
"10133",2016-11-16 07:46:13,8605.48,8605.48000000006
"10134",2016-11-16 09:29:41,-8605.48,5.82076609134674e-11
"10135",2016-11-16 11:46:19,24619.35,24619.3500000001
"10136",2016-11-16 12:36:58,17538.52,42157.8700000001
"10137",2016-11-16 12:54:21,13882.87,56040.7400000001
"10138",2016-11-16 13:01:36,12808.49,68849.2300000001
"10139",2016-11-16 13:15:12,8392.45,77241.6800000001
"10140",2016-11-16 13:15:12,17785.02,95026.7000000001
"10141",2016-11-16 15:19:20,-95026.7,5.82076609134674e-11
"10142",2016-11-17 01:30:04,12904.88,12904.8800000001
"10143",2016-11-17 01:46:23,-12904.88,5.82076609134674e-11
"10144",2016-11-17 02:44:21,9623.91,9623.91000000006
"10145",2016-11-17 02:56:47,-9623.91,5.82076609134674e-11
"10146",2016-11-17 03:32:47,24201.08,24201.0800000001
"10147",2016-11-17 04:14:04,10588.14,34789.2200000001
"10148",2016-11-17 04:14:04,15637.07,50426.2900000001
"10149",2016-11-17 04:18:05,-50426.29,5.82076609134674e-11
"10150",2016-11-17 05:09:43,11273.9,11273.9000000001
"10151",2016-11-17 06:12:06,9973,21246.9000000001
"10152",2016-11-17 07:27:20,16978.18,38225.0800000001
"10153",2016-11-17 08:53:55,8282.13,46507.2100000001
"10154",2016-11-17 08:53:55,-38225.08,8282.13000000006
"10155",2016-11-17 09:20:43,13819.16,22101.2900000001
"10156",2016-11-17 09:25:22,-22101.29,5.45696821063757e-11
"10157",2016-11-17 10:01:40,8914.17,8914.17000000005
"10158",2016-11-17 10:56:12,-8914.17,5.45696821063757e-11
"10159",2016-11-17 15:05:47,9119.72,9119.72000000005
"10160",2016-11-17 15:11:03,-9119.72,5.45696821063757e-11
"10161",2016-11-17 19:46:07,8331.64,8331.64000000005
"10162",2016-11-17 20:08:26,-8331.64,5.45696821063757e-11
"10163",2016-11-18 07:27:04,8733.25,8733.25000000005
"10164",2016-11-18 10:04:58,11735.43,20468.6800000001
"10165",2016-11-18 10:33:04,-20468.68,5.45696821063757e-11
"10166",2016-11-23 02:24:24,11277.25,11277.2500000001
"10167",2016-11-23 02:35:09,11227.46,22504.7100000001
"10168",2016-11-23 02:47:37,-11277.25,11227.4600000001
"10169",2016-11-23 03:01:40,-11227.46,5.45696821063757e-11
"10170",2016-11-23 07:06:58,7114.46,7114.46000000005
"10171",2016-11-23 07:18:46,-7114.46,5.45696821063757e-11
"10172",2016-11-23 09:49:20,11249.43,11249.4300000001
"10173",2016-11-23 18:58:00,-11249.43,5.45696821063757e-11
"10174",2016-11-23 22:22:49,11938.33,11938.3300000001
"10175",2016-11-24 03:23:26,-11938.33,5.45696821063757e-11
"10176",2016-11-24 16:51:12,1255.76,1255.76000000005
"10177",2016-11-24 20:14:39,-1255.76,5.45696821063757e-11
"10178",2016-11-25 16:24:00,22468.82,22468.8200000001
"10179",2016-11-25 17:07:04,-22468.82,5.45696821063757e-11
"10180",2016-11-27 09:29:21,3785.57,3785.57000000005
"10181",2016-11-27 12:12:52,-3785.57,5.45696821063757e-11
"10182",2016-11-27 12:42:57,32148.74,32148.7400000001
"10183",2016-11-27 14:46:46,-32148.74,5.45696821063757e-11
"10184",2016-11-28 09:30:07,33043.99,33043.99
"10185",2016-11-28 09:59:42,-33043.99,5.0931703299284e-11
"10186",2016-11-30 09:54:46,37395.25,37395.2500000001
"10187",2016-11-30 10:26:10,-37395.25,5.0931703299284e-11
"10188",2016-11-30 10:47:53,11936.79,11936.7900000001
"10189",2016-11-30 13:10:09,-11936.79,5.0931703299284e-11
"10190",2016-11-30 20:46:07,1434.39,1434.39000000005
"10191",2016-11-30 21:40:16,-1434.39,5.0931703299284e-11
"10192",2016-12-01 04:11:20,36364.34,36364.34
"10193",2016-12-01 04:33:13,19929.63,56293.97
"10194",2016-12-01 04:33:13,-36364.34,19929.63
"10195",2016-12-01 04:51:43,11826.13,31755.76
"10196",2016-12-01 05:19:17,12659.12,44414.88
"10197",2016-12-01 07:44:54,12559.12,56974.0000000001
"10198",2016-12-01 10:55:40,-44414.88,12559.1200000001
"10199",2016-12-01 11:20:09,-12559.12,5.27506927028298e-11
"10200",2016-12-01 17:21:57,12117.45,12117.4500000001
"10201",2016-12-01 18:08:53,-12117.45,5.27506927028298e-11
"10202",2016-12-01 19:02:30,11264.52,11264.5200000001
"10203",2016-12-01 19:10:48,-11264.52,5.27506927028298e-11
"10204",2016-12-01 21:45:28,12804.29,12804.2900000001
"10205",2016-12-02 01:32:22,11778.1,24582.3900000001
"10206",2016-12-02 01:40:00,26958.41,51540.8000000001
"10207",2016-12-02 02:28:38,15878.73,67419.5300000001
"10208",2016-12-02 02:28:38,19571.05,86990.5800000001
"10209",2016-12-02 02:46:26,14674.72,101665.3
"10210",2016-12-02 04:00:35,12617.42,114282.72
"10211",2016-12-02 05:08:01,13220.36,127503.08
"10212",2016-12-02 05:40:26,18672.23,146175.31
"10213",2016-12-02 06:02:26,16130.05,162305.36
"10214",2016-12-02 14:06:29,16060.88,178366.24
"10215",2016-12-03 05:01:54,-51540.8,126825.44
"10216",2016-12-03 05:28:24,-126825.44,4.36557456851006e-11
"10217",2016-12-05 12:05:44,12602.41,12602.41
"10218",2016-12-05 16:13:41,-12602.41,4.36557456851006e-11
"10219",2016-12-05 21:59:07,18233.26,18233.26
"10220",2016-12-05 22:06:08,-18233.26,4.36557456851006e-11
"10221",2016-12-06 00:46:15,5009.3,5009.30000000004
"10222",2016-12-06 02:18:57,7786.35,12795.65
"10223",2016-12-06 06:23:44,7786.36,20582.01
"10224",2016-12-06 07:23:02,7262.1,27844.11
"10225",2016-12-06 07:26:15,17786.38,45630.49
"10226",2016-12-06 08:46:07,4775.02,50405.5100000001
"10227",2016-12-06 10:19:35,15119.69,65525.2000000001
"10228",2016-12-06 12:54:49,-12795.65,52729.5500000001
"10229",2016-12-06 16:58:38,-52729.55,5.0931703299284e-11
"10230",2016-12-07 10:21:35,39242.08,39242.0800000001
"10231",2016-12-07 11:14:28,-39242.08,5.0931703299284e-11
"10232",2016-12-07 15:20:24,11276.21,11276.2100000001
"10233",2016-12-07 15:34:18,-11276.21,5.0931703299284e-11
"10234",2016-12-07 19:07:33,22297.92,22297.92
"10235",2016-12-07 19:41:45,-22297.92,5.0931703299284e-11
"10236",2016-12-07 20:00:12,11242.07,11242.0700000001
"10237",2016-12-07 20:34:06,-11242.07,5.0931703299284e-11
"10238",2016-12-08 00:45:16,11345.2,11345.2000000001
"10239",2016-12-08 00:51:01,-11345.2,5.0931703299284e-11
"10240",2016-12-08 06:06:20,11583.32,11583.3200000001
"10241",2016-12-08 06:32:13,-11583.32,5.0931703299284e-11
"10242",2016-12-08 13:22:59,4111.04,4111.04000000005
"10243",2016-12-08 14:02:19,-4111.04,5.0931703299284e-11
"10244",2016-12-08 17:01:27,5738.73,5738.73000000005
"10245",2016-12-08 17:44:04,5421.64,11160.37
"10246",2016-12-08 17:51:41,-5738.73,5421.64000000005
"10247",2016-12-08 18:10:02,-5421.64,5.00222085975111e-11
"10248",2016-12-09 19:34:43,616.05,616.05000000005
"10249",2016-12-09 19:56:58,-616.05,5.00222085975111e-11
"10250",2016-12-10 16:38:26,10009.75,10009.7500000001
"10251",2016-12-10 19:03:55,-10009.75,5.0931703299284e-11
"10252",2016-12-10 20:00:07,5009.74,5009.74000000005
"10253",2016-12-10 20:25:02,-5009.74,5.0931703299284e-11
"10254",2016-12-11 09:45:38,7786.76,7786.76000000005
"10255",2016-12-11 10:50:06,-7786.76,5.0931703299284e-11
"10256",2016-12-12 01:06:34,9552.08,9552.08000000005
"10257",2016-12-12 02:02:45,6235.57,15787.6500000001
"10258",2016-12-12 02:26:52,-15787.65,5.0931703299284e-11
"10259",2016-12-12 02:54:54,4633.55,4633.55000000005
"10260",2016-12-12 03:10:27,-4633.55,5.0931703299284e-11
"10261",2016-12-12 10:14:12,10065.56,10065.5600000001
"10262",2016-12-12 10:41:40,-10065.56,5.0931703299284e-11
"10263",2016-12-12 11:51:34,7786.87,7786.87000000005
"10264",2016-12-12 11:51:34,30009.88,37796.7500000001
"10265",2016-12-12 12:23:26,12228.79,50025.5400000001
"10266",2016-12-12 13:30:13,11410.21,61435.7500000001
"10267",2016-12-12 14:46:40,1309.86,62745.6100000001
"10268",2016-12-12 15:48:15,11699.39,74445.0000000001
"10269",2016-12-12 15:48:15,11468.09,85913.0900000001
"10270",2016-12-12 22:05:14,-50025.54,35887.5500000001
"10271",2016-12-12 22:10:02,-35887.55,5.0931703299284e-11
"10272",2016-12-13 02:09:22,23954.86,23954.8600000001
"10273",2016-12-13 02:30:35,22217.3,46172.16
"10274",2016-12-13 03:05:23,-46172.16,4.36557456851006e-11
"10275",2016-12-13 18:11:34,12113.32,12113.32
"10276",2016-12-13 18:48:07,-12113.32,4.36557456851006e-11
"10277",2016-12-14 19:47:18,49789.64,49789.64
"10278",2016-12-14 22:25:13,-49789.64,4.36557456851006e-11
"10279",2016-12-15 04:26:47,11431.1,11431.1
"10280",2016-12-15 04:50:27,-11431.1,4.36557456851006e-11
"10281",2016-12-15 15:35:34,11382.87,11382.87
"10282",2016-12-15 20:30:12,-11382.87,4.36557456851006e-11
"10283",2016-12-16 06:35:57,13265.4,13265.4
"10284",2016-12-16 06:35:57,14552.33,27817.73
"10285",2016-12-16 10:23:35,-27817.73,4.36557456851006e-11
"10286",2016-12-17 02:51:33,13149.72,13149.72
"10287",2016-12-17 03:34:18,-13149.72,4.36557456851006e-11
"10288",2016-12-17 09:48:00,12065.04,12065.04
"10289",2016-12-17 11:16:51,-12065.04,4.36557456851006e-11
"10290",2016-12-17 15:00:20,11234.48,11234.48
"10291",2016-12-17 16:42:25,-11234.48,4.36557456851006e-11
"10292",2016-12-17 18:24:45,11290.42,11290.42
"10293",2016-12-17 19:03:55,-11290.42,4.36557456851006e-11
"10294",2016-12-19 00:56:31,12398.04,12398.04
"10295",2016-12-19 01:13:05,-12398.04,4.36557456851006e-11
"10296",2016-12-19 19:55:55,8239.21,8239.21000000004
"10297",2016-12-19 21:25:39,-8239.21,4.36557456851006e-11
"10298",2016-12-21 16:21:13,13016.38,13016.38
"10299",2016-12-21 16:40:36,22692.44,35708.82
"10300",2016-12-21 17:19:40,-35708.82,4.36557456851006e-11
"10301",2016-12-21 18:05:22,15866.53,15866.53
"10302",2016-12-21 18:50:12,-15866.53,4.36557456851006e-11
"10303",2016-12-22 09:41:13,27823.11,27823.11
"10304",2016-12-22 10:05:31,22938.73,50761.84
"10305",2016-12-22 10:42:54,-50761.84,4.36557456851006e-11
"10306",2016-12-22 11:48:38,24680.73,24680.73
"10307",2016-12-22 11:48:38,11861.94,36542.67
"10308",2016-12-22 12:39:37,11446.58,47989.25
"10309",2016-12-22 13:51:48,-47989.25,4.36557456851006e-11
"10310",2016-12-22 14:35:48,10206.06,10206.06
"10311",2016-12-22 14:54:40,7787.46,17993.52
"10312",2016-12-22 14:54:40,-10206.06,7787.46000000004
"10313",2016-12-22 15:34:38,17787.49,25574.95
"10314",2016-12-22 15:34:38,4459.25,30034.2
"10315",2016-12-22 15:34:38,-7787.46,22246.74
"10316",2016-12-22 16:09:43,-22246.74,4.72937244921923e-11
"10317",2016-12-22 16:12:20,5010.47,5010.47000000005
"10318",2016-12-22 16:32:04,-5010.47,4.72937244921923e-11
"10319",2016-12-22 17:29:44,7787.5,7787.50000000005
"10320",2016-12-22 17:37:03,-7787.5,4.72937244921923e-11
"10321",2016-12-22 20:27:13,14935.59,14935.59
"10322",2016-12-22 20:47:57,7372.14,22307.73
"10323",2016-12-22 23:03:51,-22307.73,4.72937244921923e-11
"10324",2016-12-23 04:08:07,12213.91,12213.91
"10325",2016-12-23 04:19:38,10893.23,23107.14
"10326",2016-12-23 04:39:33,15921.14,39028.28
"10327",2016-12-23 04:39:33,7067.7,46095.98
"10328",2016-12-23 05:29:07,13787.58,59883.56
"10329",2016-12-23 05:33:08,-23107.14,36776.42
"10330",2016-12-23 06:05:11,18143.96,54920.38
"10331",2016-12-23 06:05:11,-36776.42,18143.96
"10332",2016-12-23 06:52:57,7863.93,26007.89
"10333",2016-12-23 06:57:20,8756.17,34764.06
"10334",2016-12-23 08:10:11,15539.39,50303.45
"10335",2016-12-23 09:26:38,9938.29,60241.74
"10336",2016-12-23 09:29:32,3912.35,64154.09
"10337",2016-12-23 12:38:54,-50303.45,13850.64
"10338",2016-12-23 13:50:38,-13850.64,4.36557456851006e-11
"10339",2016-12-23 14:17:47,18016.49,18016.49
"10340",2016-12-23 14:22:19,-18016.49,4.36557456851006e-11
"10341",2016-12-23 16:00:47,10935.8,10935.8
"10342",2016-12-23 16:28:46,-10935.8,4.36557456851006e-11
"10343",2016-12-23 16:38:02,30010.7,30010.7
"10344",2016-12-23 17:46:10,7787.71,37798.41
"10345",2016-12-23 19:17:26,-30010.7,7787.71000000005
"10346",2016-12-23 19:37:22,-7787.71,4.63842297904193e-11
"10347",2016-12-23 19:47:05,5010.69,5010.69000000005
"10348",2016-12-23 20:10:44,-5010.69,4.63842297904193e-11
"10349",2016-12-23 20:37:44,7787.72,7787.72000000005
"10350",2016-12-23 20:37:44,7787.73,15575.45
"10351",2016-12-23 21:15:43,-15575.45,4.54747350886464e-11
"10352",2016-12-23 21:43:15,7787.74,7787.74000000005
"10353",2016-12-23 22:00:57,6379.41,14167.15
"10354",2016-12-23 22:00:57,-7787.74,6379.41000000005
"10355",2016-12-23 22:13:22,-6379.41,4.54747350886464e-11
"10356",2016-12-24 08:55:26,17235.98,17235.98
"10357",2016-12-24 09:31:16,8388.15,25624.13
"10358",2016-12-24 09:37:40,7557.25,33181.38
"10359",2016-12-24 09:57:39,13750.37,46931.7500000001
"10360",2016-12-24 14:43:25,18252.01,65183.7600000001
"10361",2016-12-24 16:22:12,9004.61,74188.3700000001
"10362",2016-12-25 01:28:39,8186.07,82374.4400000001
"10363",2016-12-25 03:57:33,-82374.44,5.82076609134674e-11
"10364",2016-12-25 07:21:33,7848.93,7848.93000000006
"10365",2016-12-25 08:05:40,-7848.93,5.82076609134674e-11
"10366",2016-12-25 08:46:37,9338.49,9338.49000000006
"10367",2016-12-25 09:24:17,16029.57,25368.0600000001
"10368",2016-12-25 09:36:55,7846.2,33214.2600000001
"10369",2016-12-25 09:44:15,9072.7,42286.9600000001
"10370",2016-12-25 10:16:24,18466.53,60753.49
"10371",2016-12-25 10:16:24,-42286.96,18466.53
"10372",2016-12-25 10:37:19,7284.64,25751.17
"10373",2016-12-25 10:37:19,-18466.53,7284.64000000005
"10374",2016-12-25 10:59:32,-7284.64,5.00222085975111e-11
"10375",2016-12-25 21:35:42,13364.2,13364.2000000001
"10376",2016-12-25 22:12:57,-13364.2,5.0931703299284e-11
"10377",2016-12-26 00:14:01,13031.27,13031.2700000001
"10378",2016-12-26 00:48:46,8150.43,21181.7000000001
"10379",2016-12-26 00:57:31,9299.33,30481.03
"10380",2016-12-26 01:12:24,10365.34,40846.3700000001
"10381",2016-12-26 01:12:24,-30481.03,10365.3400000001
"10382",2016-12-26 01:21:35,11653.5,22018.8400000001
"10383",2016-12-26 01:21:35,-10365.34,11653.5000000001
"10384",2016-12-26 01:33:06,15836.06,27489.5600000001
"10385",2016-12-26 03:57:50,-27489.56,5.45696821063757e-11
"10386",2016-12-26 09:34:21,16826.33,16826.3300000001
"10387",2016-12-26 09:34:21,30011.93,46838.2600000001
"10388",2016-12-26 09:48:35,30011.94,76850.2000000001
"10389",2016-12-26 11:37:56,-76850.2,5.82076609134674e-11
"10390",2016-12-26 13:39:40,8104.28,8104.28000000006
"10391",2016-12-26 13:54:40,-8104.28,5.82076609134674e-11
"10392",2016-12-26 16:45:49,12870.89,12870.8900000001
"10393",2016-12-26 19:39:33,-12870.89,5.82076609134674e-11
"10394",2016-12-26 19:51:17,8011.07,8011.07000000006
"10395",2016-12-26 21:38:42,7335.42,15346.4900000001
"10396",2016-12-26 22:34:30,12160.94,27507.4300000001
"10397",2016-12-27 00:11:27,6734.37,34241.8000000001
"10398",2016-12-27 01:14:57,10412.89,44654.6900000001
"10399",2016-12-27 02:01:32,-44654.69,5.82076609134674e-11
"10400",2016-12-27 10:41:29,9387.24,9387.24000000006
"10401",2016-12-27 10:48:17,-9387.24,5.82076609134674e-11
"10402",2016-12-27 12:03:43,8834.54,8834.54000000006
"10403",2016-12-27 12:32:38,14387.24,23221.7800000001
"10404",2016-12-27 12:32:38,30012.05,53233.8300000001
"10405",2016-12-27 12:32:38,-8834.54,44399.2900000001
"10406",2016-12-27 12:42:53,30012.06,74411.3500000001
"10407",2016-12-27 13:32:26,37789.07,112200.42
"10408",2016-12-27 14:17:52,18336.24,130536.66
"10409",2016-12-27 14:37:29,9569.31,140105.97
"10410",2016-12-27 14:47:39,8081.94,148187.91
"10411",2016-12-27 15:22:03,7604.96,155792.87
"10412",2016-12-27 15:32:01,4417.05,160209.92
"10413",2016-12-27 15:40:36,3923.33,164133.25
"10414",2016-12-27 16:24:29,-74411.35,89721.9000000001
"10415",2016-12-27 16:48:47,-89721.9,5.82076609134674e-11
"10416",2016-12-27 17:32:34,6305.81,6305.81000000006
"10417",2016-12-27 17:58:19,4385.14,10690.9500000001
"10418",2016-12-27 18:27:04,7720.2,18411.1500000001
"10419",2016-12-27 18:32:59,-18411.15,5.82076609134674e-11
"10420",2016-12-27 19:04:55,12869.47,12869.4700000001
"10421",2016-12-27 19:13:58,-12869.47,5.82076609134674e-11
"10422",2016-12-27 19:34:17,6704.73,6704.73000000006
"10423",2016-12-27 19:58:34,17213.67,23918.4000000001
"10424",2016-12-27 19:58:34,9724.55,33642.9500000001
"10425",2016-12-27 19:58:34,9280.95,42923.9000000001
"10426",2016-12-27 20:22:14,-42923.9,5.0931703299284e-11
"10427",2016-12-27 22:14:07,13777.79,13777.7900000001
"10428",2016-12-27 22:59:46,-13777.79,5.0931703299284e-11
"10429",2016-12-28 00:24:39,11370.21,11370.2100000001
"10430",2016-12-28 00:24:39,19047.25,30417.4600000001
"10431",2016-12-28 00:31:27,-30417.46,5.0931703299284e-11
"10432",2016-12-28 02:57:49,12503.88,12503.8800000001
"10433",2016-12-28 03:08:57,-12503.88,5.0931703299284e-11
"10434",2016-12-28 04:16:05,12511.15,12511.1500000001
"10435",2016-12-28 04:40:03,-12511.15,5.0931703299284e-11
"10436",2016-12-28 05:20:13,9114.52,9114.52000000005
"10437",2016-12-28 05:40:42,29733.99,38848.5100000001
"10438",2016-12-28 05:40:42,-9114.52,29733.9900000001
"10439",2016-12-28 06:26:14,11290.68,41024.6700000001
"10440",2016-12-28 06:26:14,14922.91,55947.5800000001
"10441",2016-12-28 06:26:14,-29733.99,26213.5900000001
"10442",2016-12-28 06:48:14,-26213.59,5.82076609134674e-11
"10443",2016-12-28 06:51:12,16650.68,16650.6800000001
"10444",2016-12-28 09:02:53,14400.68,31051.3600000001
"10445",2016-12-28 09:05:19,-16650.68,14400.6800000001
"10446",2016-12-28 09:15:00,-14400.68,5.82076609134674e-11
"10447",2016-12-28 11:48:04,798.33,798.330000000058
"10448",2016-12-28 14:56:04,-798.33,5.82076609134674e-11
"10449",2016-12-28 16:01:45,12449.38,12449.3800000001
"10450",2016-12-28 16:01:45,13178.74,25628.1200000001
"10451",2016-12-28 16:24:35,13789.45,39417.5700000001
"10452",2016-12-28 16:24:35,17207.02,56624.5900000001
"10453",2016-12-28 17:05:34,19471.31,76095.9000000001
"10454",2016-12-28 17:12:08,-56624.59,19471.3100000001
"10455",2016-12-28 17:30:27,-19471.31,5.45696821063757e-11
"10456",2016-12-28 21:07:14,30219.52,30219.5200000001
"10457",2016-12-28 21:39:06,-30219.52,5.45696821063757e-11
"10458",2016-12-29 00:38:28,15098.62,15098.6200000001
"10459",2016-12-29 00:44:01,13718.16,28816.7800000001
"10460",2016-12-29 01:04:31,17789.59,46606.3700000001
"10461",2016-12-29 01:28:08,5521.23,52127.6
"10462",2016-12-29 01:47:48,1436.2,53563.8
"10463",2016-12-29 01:47:48,-52127.6,1436.20000000005
"10464",2016-12-29 03:31:07,18931.04,20367.24
"10465",2016-12-29 03:43:50,4033.38,24400.62
"10466",2016-12-29 03:43:50,-1436.2,22964.42
"10467",2016-12-29 04:06:31,-22964.42,5.0931703299284e-11
"10468",2016-12-29 06:27:49,7789.64,7789.64000000005
"10469",2016-12-29 06:55:38,-7789.64,5.0931703299284e-11
"10470",2016-12-29 06:55:38,3789.65,3789.65000000005
"10471",2016-12-29 07:24:32,8955.77,12745.4200000001
"10472",2016-12-29 07:57:22,29150.91,41896.3300000001
"10473",2016-12-29 07:57:22,17789.68,59686.0100000001
"10474",2016-12-29 07:59:15,-12745.42,46940.5900000001
"10475",2016-12-29 08:16:47,-46940.59,5.82076609134674e-11
"10476",2016-12-29 08:20:52,6702.81,6702.81000000006
"10477",2016-12-29 08:30:10,10090.26,16793.0700000001
"10478",2016-12-29 08:31:00,-6702.81,10090.2600000001
"10479",2016-12-29 09:05:17,3925.92,14016.1800000001
"10480",2016-12-29 10:32:17,-14016.18,5.63886715099216e-11
"10481",2016-12-29 10:41:02,1308.74,1308.74000000006
"10482",2016-12-29 13:56:06,38463.12,39771.8600000001
"10483",2016-12-29 13:56:06,-1308.74,38463.1200000001
"10484",2016-12-29 14:04:58,15349.74,53812.8600000001
"10485",2016-12-29 14:04:58,-38463.12,15349.7400000001
"10486",2016-12-29 14:23:09,-15349.74,5.63886715099216e-11
"10487",2016-12-29 17:01:22,13711.06,13711.0600000001
"10488",2016-12-29 17:01:22,13926.85,27637.9100000001
"10489",2016-12-29 17:01:22,11497.49,39135.4000000001
"10490",2016-12-29 19:57:45,-39135.4,5.0931703299284e-11
"10491",2016-12-29 21:50:09,12624.74,12624.7400000001
"10492",2016-12-29 21:55:05,-12624.74,5.0931703299284e-11
"10493",2016-12-29 22:48:24,14810.25,14810.2500000001
"10494",2016-12-29 23:55:03,19822.09,34632.3400000001
"10495",2016-12-29 23:57:40,-34632.34,5.82076609134674e-11
"10496",2016-12-30 02:38:45,20566.68,20566.6800000001
"10497",2016-12-30 02:58:49,-20566.68,5.82076609134674e-11
"10498",2016-12-30 05:23:34,3947.93,3947.93000000006
"10499",2016-12-30 05:43:21,-3947.93,5.82076609134674e-11
"10500",2016-12-30 08:00:58,1265.87,1265.87000000006
"10501",2016-12-30 08:26:29,-1265.87,5.82076609134674e-11
"10502",2016-12-30 09:18:48,13790.12,13790.1200000001
"10503",2016-12-30 09:37:47,7790.14,21580.2600000001
"10504",2016-12-30 09:37:47,13790.13,35370.3900000001
"10505",2016-12-30 09:37:47,20367.39,55737.7800000001
"10506",2016-12-30 10:07:25,39594.4,95332.1800000001
"10507",2016-12-30 10:26:13,34484.91,129817.09
"10508",2016-12-30 10:26:13,37790.19,167607.28
"10509",2016-12-30 10:46:54,-167607.28,5.82076609134674e-11
"10510",2016-12-30 12:23:16,30978.12,30978.1200000001
"10511",2016-12-30 13:03:55,18210.53,49188.6500000001
"10512",2016-12-30 13:33:43,18587.76,67776.41
"10513",2016-12-30 14:02:34,32303.88,100080.29
"10514",2016-12-30 14:34:17,4365.19,104445.48
"10515",2016-12-30 14:34:17,37790.3,142235.78
"10516",2016-12-30 14:34:17,25731.34,167967.12
"10517",2016-12-30 14:45:38,-67776.41,100190.71
"10518",2016-12-30 15:00:31,-100190.71,4.36557456851006e-11
"10519",2016-12-30 17:10:24,11284.84,11284.84
"10520",2016-12-30 17:34:16,14838.08,26122.92
"10521",2016-12-30 19:09:54,-26122.92,4.36557456851006e-11
"10522",2016-12-31 00:35:03,12710,12710
"10523",2016-12-31 01:47:59,-12710,4.36557456851006e-11
"10524",2016-12-31 02:21:17,9186.15,9186.15000000004
"10525",2016-12-31 02:28:24,-9186.15,4.36557456851006e-11
"10526",2016-12-31 06:57:44,11464.89,11464.89
"10527",2016-12-31 07:36:28,12488.75,23953.64
"10528",2016-12-31 08:26:12,-23953.64,4.36557456851006e-11
"10529",2016-12-31 09:28:37,11466.02,11466.02
"10530",2016-12-31 09:39:28,24192.15,35658.17
"10531",2016-12-31 12:31:51,-35658.17,4.36557456851006e-11
"10532",2016-12-31 13:15:30,13754.65,13754.65
"10533",2016-12-31 13:38:28,-13754.65,4.36557456851006e-11
"10534",2016-12-31 23:44:04,22382.69,22382.69
"10535",2017-01-01 04:07:16,14815.63,37198.32
"10536",2017-01-01 04:07:16,-22382.69,14815.63
"10537",2017-01-01 04:30:32,14263.95,29079.58
"10538",2017-01-01 04:30:32,-14815.63,14263.95
"10539",2017-01-01 06:24:36,-14263.95,4.54747350886464e-11
"10540",2017-01-01 11:28:17,37790.48,37790.48
"10541",2017-01-01 11:28:17,21310.6,59101.08
"10542",2017-01-01 11:43:35,-59101.08,4.36557456851006e-11
"10543",2017-01-01 15:12:10,11320.94,11320.94
"10544",2017-01-01 15:50:10,-11320.94,4.36557456851006e-11
"10545",2017-01-01 16:05:37,14042.87,14042.87
"10546",2017-01-01 16:33:01,11431.55,25474.42
"10547",2017-01-01 16:33:01,23500.45,48974.87
"10548",2017-01-01 17:25:42,21544.68,70519.55
"10549",2017-01-01 17:28:48,-48974.87,21544.68
"10550",2017-01-01 17:44:02,-21544.68,4.36557456851006e-11
"10551",2017-01-01 20:08:18,14119.4,14119.4
"10552",2017-01-01 21:53:02,12174.36,26293.76
"10553",2017-01-01 23:53:15,17182.74,43476.5
"10554",2017-01-02 02:52:19,15787.09,59263.59
"10555",2017-01-02 03:36:13,12213.4,71476.99
"10556",2017-01-02 04:31:24,27521.68,98998.67
"10557",2017-01-02 04:43:31,20587.82,119586.49
"10558",2017-01-02 09:41:52,13283.02,132869.51
"10559",2017-01-02 10:52:43,19095.8,151965.31
"10560",2017-01-02 12:13:09,12737.77,164703.08
"10561",2017-01-02 12:40:58,15352.67,180055.75
"10562",2017-01-02 13:40:58,13616.17,193671.92
"10563",2017-01-02 15:57:16,12814.68,206486.6
"10564",2017-01-02 16:37:52,24539.13,231025.73
"10565",2017-01-02 17:47:38,11340.7,242366.43
"10566",2017-01-02 18:43:19,17130.99,259497.42
"10567",2017-01-02 18:47:22,9628.43,269125.85
"10568",2017-01-02 20:23:31,13790.83,282916.68
"10569",2017-01-02 20:50:56,13790.84,296707.52
"10570",2017-01-03 02:14:51,-296707.52,5.82076609134674e-11
"10571",2017-01-03 05:12:14,8678.61,8678.61000000006
"10572",2017-01-03 05:38:04,-8678.61,5.82076609134674e-11
"10573",2017-01-03 06:42:55,12442.06,12442.0600000001
"10574",2017-01-03 07:41:04,12943.41,25385.4700000001
"10575",2017-01-03 07:43:36,-12442.06,12943.4100000001
"10576",2017-01-03 08:50:02,-12943.41,6.00266503170133e-11
"10577",2017-01-03 11:02:29,17519.73,17519.7300000001
"10578",2017-01-03 11:10:21,-17519.73,6.18456397205591e-11
"10579",2017-01-03 12:22:55,6931.18,6931.18000000006
"10580",2017-01-03 12:41:16,6781.49,13712.6700000001
"10581",2017-01-03 13:12:26,-6931.18,6781.49000000006
"10582",2017-01-03 13:33:17,-6781.49,6.18456397205591e-11
"10583",2017-01-03 14:00:00,10617.14,10617.1400000001
"10584",2017-01-03 14:00:00,17790.94,28408.0800000001
"10585",2017-01-03 14:58:02,11906.92,40315.0000000001
"10586",2017-01-03 14:58:30,-28408.08,11906.9200000001
"10587",2017-01-03 15:09:09,9973.95,21880.8700000001
"10588",2017-01-03 15:12:48,-21880.87,5.82076609134674e-11
"10589",2017-01-03 15:34:58,8692.52,8692.52000000006
"10590",2017-01-03 15:43:38,8283.57,16976.0900000001
"10591",2017-01-03 15:43:38,18901.99,35878.0800000001
"10592",2017-01-03 15:52:29,-35878.08,5.82076609134674e-11
"10593",2017-01-03 16:51:25,37791,37791.0000000001
"10594",2017-01-03 17:09:09,-37791,5.82076609134674e-11
"10595",2017-01-03 17:14:19,10351.89,10351.8900000001
"10596",2017-01-03 17:37:09,18902.02,29253.9100000001
"10597",2017-01-03 18:02:09,-29253.91,5.82076609134674e-11
"10598",2017-01-03 20:49:28,7791.03,7791.03000000006
"10599",2017-01-03 21:26:07,21079.54,28870.5700000001
"10600",2017-01-03 21:43:52,37791.05,66661.6200000001
"10601",2017-01-03 21:43:52,17791.06,84452.6800000001
"10602",2017-01-03 22:32:25,-7791.03,76661.6500000001
"10603",2017-01-03 22:40:12,18902.07,95563.7200000001
"10604",2017-01-03 22:45:33,30014.08,125577.8
"10605",2017-01-03 22:45:33,-95563.72,30014.0800000001
"10606",2017-01-03 22:46:55,-30014.08,5.82076609134674e-11
"10607",2017-01-03 23:36:51,17791.09,17791.0900000001
"10608",2017-01-03 23:36:51,37791.1,55582.1900000001
"10609",2017-01-03 23:54:16,-55582.19,5.82076609134674e-11
"10610",2017-01-04 02:06:25,17026.73,17026.7300000001
"10611",2017-01-04 03:12:26,-17026.73,5.82076609134674e-11
"10612",2017-01-04 03:34:50,8902.14,8902.14000000006
"10613",2017-01-04 03:50:25,-8902.14,5.82076609134674e-11
"10614",2017-01-04 04:16:20,5014.15,5014.15000000006
"10615",2017-01-04 07:00:00,31926.54,36940.6900000001
"10616",2017-01-04 07:16:36,-5014.15,31926.5400000001
"10617",2017-01-04 07:27:32,17902.17,49828.7100000001
"10618",2017-01-04 08:11:33,-49828.71,5.82076609134674e-11
"10619",2017-01-04 09:27:37,17338.45,17338.4500000001
"10620",2017-01-04 10:26:29,7040.21,24378.6600000001
"10621",2017-01-04 10:26:29,13014.2,37392.8600000001
"10622",2017-01-04 10:58:33,30014.21,67407.0700000001
"10623",2017-01-04 11:07:38,-30014.21,37392.8600000001
"10624",2017-01-04 11:50:36,17791.24,55184.1000000001
"10625",2017-01-04 12:15:19,18902.25,74086.3500000001
"10626",2017-01-04 12:15:19,7791.26,81877.6100000001
"10627",2017-01-04 12:56:35,37791.27,119668.88
"10628",2017-01-04 13:36:33,13766.11,133434.99
"10629",2017-01-04 13:36:33,37791.29,171226.28
"10630",2017-01-04 14:44:12,17791.3,189017.58
"10631",2017-01-04 15:15:12,17791.31,206808.89
"10632",2017-01-04 15:48:31,12600.15,219409.04
"10633",2017-01-04 15:50:42,-37392.86,182016.18
"10634",2017-01-04 17:13:15,37791.33,219807.51
"10635",2017-01-04 17:13:15,37791.34,257598.85
"10636",2017-01-04 17:26:10,37791.36,295390.21
"10637",2017-01-04 17:43:23,18784.25,314174.46
"10638",2017-01-04 18:09:27,21787.89,335962.35
"10639",2017-01-04 18:09:27,37791.39,373753.74
"10640",2017-01-04 18:33:16,17791.4,391545.14
"10641",2017-01-04 19:24:52,18902.42,410447.56
"10642",2017-01-04 19:24:52,17791.41,428238.97
"10643",2017-01-04 19:24:52,18902.43,447141.4
"10644",2017-01-04 19:43:03,17791.45,464932.85
"10645",2017-01-04 20:01:28,37791.46,502724.31
"10646",2017-01-04 20:01:28,37791.48,540515.79
"10647",2017-01-04 20:45:12,11222.29,551738.08
"10648",2017-01-04 20:51:28,37791.5,589529.58
"10649",2017-01-04 21:01:16,37791.51,627321.09
"10650",2017-01-04 22:37:34,37791.53,665112.62
"10651",2017-01-04 22:37:34,17791.54,682904.16
"10652",2017-01-04 23:01:06,37791.55,720695.71
"10653",2017-01-04 23:11:27,17791.56,738487.27
"10654",2017-01-04 23:19:05,37791.57,776278.84
"10655",2017-01-04 23:19:05,17791.58,794070.42
"10656",2017-01-04 23:21:34,-44484.75,749585.67
"10657",2017-01-04 23:34:32,30014.59,779600.26
"10658",2017-01-04 23:49:47,-779600.26,2.3283064365387e-10
"10659",2017-01-05 00:06:39,30014.61,30014.6100000002
"10660",2017-01-05 00:06:39,30014.6,60029.2100000002
"10661",2017-01-05 00:30:59,-60029.21,2.3283064365387e-10
"10662",2017-01-05 04:49:38,5014.65,5014.65000000023
"10663",2017-01-05 05:29:07,-5014.65,2.3283064365387e-10
"10664",2017-01-05 07:58:12,37791.64,37791.6400000002
"10665",2017-01-05 08:57:44,-37791.64,2.3283064365387e-10
"10666",2017-01-05 12:33:43,37747.52,37747.5200000002
"10667",2017-01-05 12:39:28,-37747.52,2.3283064365387e-10
"10668",2017-01-05 22:45:19,23483.24,23483.2400000002
"10669",2017-01-06 00:27:39,36029.42,59512.6600000002
"10670",2017-01-06 04:19:47,-23483.24,36029.4200000002
"10671",2017-01-06 08:49:54,37792.64,73822.0600000002
"10672",2017-01-06 08:49:54,20974.38,94796.4400000002
"10673",2017-01-06 08:49:54,17792.66,112589.1
"10674",2017-01-06 10:07:39,30015.69,142604.79
"10675",2017-01-06 10:07:39,14540.82,157145.61
"10676",2017-01-06 10:07:39,11400.03,168545.64
"10677",2017-01-06 10:29:06,37792.72,206338.36
"10678",2017-01-06 10:29:06,17857.63,224195.99
"10679",2017-01-06 14:07:08,38903.75,263099.74
"10680",2017-01-06 16:51:52,20776.27,283876.01
"10681",2017-01-06 17:44:20,21399.89,305275.9
"10682",2017-01-06 19:14:53,20638.58,325914.48
"10683",2017-01-06 19:41:15,29965.32,355879.8
"10684",2017-01-06 19:41:15,9452.69,365332.49
"10685",2017-01-06 21:02:43,37792.83,403125.32
"10686",2017-01-06 21:02:43,19988.74,423114.06
"10687",2017-01-06 22:02:12,17179.74,440293.8
"10688",2017-01-07 00:09:30,7016.87,447310.67
"10689",2017-01-07 00:09:30,7977.32,455287.99
"10690",2017-01-07 01:06:03,15428.63,470716.62
"10691",2017-01-07 02:42:20,-470716.62,2.91038304567337e-10
"10692",2017-01-07 08:46:59,20059.83,20059.8300000003
"10693",2017-01-07 09:08:37,-20059.83,2.91038304567337e-10
"10694",2017-01-07 09:08:37,20787.67,20787.6700000003
"10695",2017-01-07 09:13:56,-20787.67,2.91038304567337e-10
"10696",2017-01-07 09:53:39,61069.86,61069.8600000003
"10697",2017-01-07 09:53:39,78904.01,139973.87
"10698",2017-01-07 10:48:13,-139973.87,2.91038304567337e-10
"10699",2017-01-08 03:04:54,55880.2,55880.2000000003
"10700",2017-01-08 03:15:29,-55880.2,2.91038304567337e-10
"10701",2017-01-08 05:19:46,65189.42,65189.4200000003
"10702",2017-01-08 05:19:46,38904.07,104093.49
"10703",2017-01-08 05:26:49,-104093.49,2.7648638933897e-10
"10704",2017-01-08 06:09:47,18616.91,18616.9100000003
"10705",2017-01-08 06:44:21,-18616.91,2.7648638933897e-10
"10706",2017-01-08 07:08:10,38904.1,38904.1000000003
"10707",2017-01-08 07:08:10,38904.09,77808.1900000003
"10708",2017-01-08 07:25:44,-77808.19,2.61934474110603e-10
"10709",2017-01-11 11:28:39,21136.43,21136.4300000003
"10710",2017-01-11 11:41:03,-21136.43,2.61934474110603e-10
"10711",2017-01-11 11:41:03,16663.59,16663.5900000003
"10712",2017-01-11 12:06:36,-16663.59,2.61934474110603e-10
"10713",2017-01-11 12:51:14,41022.23,41022.2300000003
"10714",2017-01-11 13:35:57,-41022.23,2.61934474110603e-10
"10715",2017-01-11 15:47:02,64674.63,64674.6300000003
"10716",2017-01-11 15:47:02,-41022.23,23652.4000000003
"10717",2017-01-11 16:05:53,-23652.4,2.5465851649642e-10
"10718",2017-01-11 18:12:03,29964.35,29964.3500000003
"10719",2017-01-11 18:27:22,-29964.35,2.5465851649642e-10
"10720",2017-01-11 20:10:56,13793.43,13793.4300000003
"10721",2017-01-11 20:10:56,11276.11,25069.5400000003
"10722",2017-01-11 20:10:56,9422.25,34491.7900000003
"10723",2017-01-11 20:10:56,7040.08,41531.8700000003
"10724",2017-01-11 20:28:59,-41531.87,2.5465851649642e-10
"10725",2017-01-11 21:56:25,5471.49,5471.49000000025
"10726",2017-01-11 22:00:03,-5471.49,2.5465851649642e-10
"10727",2017-01-12 06:19:51,26435.06,26435.0600000003
"10728",2017-01-12 06:22:59,11316.49,37751.5500000003
"10729",2017-01-12 06:22:59,6174.74,43926.2900000003
"10730",2017-01-12 06:22:59,18904.58,62830.8700000003
"10731",2017-01-12 06:38:51,-62830.87,2.5465851649642e-10
"10732",2017-01-12 10:05:11,11714.06,11714.0600000003
"10733",2017-01-12 10:17:13,-11714.06,2.5465851649642e-10
"10734",2017-01-12 11:05:52,17052.98,17052.9800000003
"10735",2017-01-12 11:11:25,-17052.98,2.5465851649642e-10
"10736",2017-01-12 13:43:15,16043.2,16043.2000000003
"10737",2017-01-12 14:01:57,-16043.2,2.5465851649642e-10
"10738",2017-01-12 16:22:06,22276.36,22276.3600000003
"10739",2017-01-12 16:22:06,16070.67,38347.0300000003
"10740",2017-01-12 16:39:45,-38347.03,2.5465851649642e-10
"10741",2017-01-13 07:51:49,16719.07,16719.0700000003
"10742",2017-01-13 08:07:55,-16719.07,2.5465851649642e-10
"10743",2017-01-13 10:27:58,24487.08,24487.0800000003
"10744",2017-01-13 10:32:18,-24487.08,2.5465851649642e-10
"10745",2017-01-13 10:53:44,1999.59,1999.59000000025
"10746",2017-01-13 11:08:56,-1999.59,2.5465851649642e-10
"10747",2017-01-13 13:04:17,23853.43,23853.4300000003
"10748",2017-01-13 13:04:17,13817.05,37670.4800000003
"10749",2017-01-13 13:09:51,-37670.48,2.5465851649642e-10
"10750",2017-01-13 15:50:01,6100.35,6100.35000000026
"10751",2017-01-13 15:50:01,5662.75,11763.1000000003
"10752",2017-01-13 16:33:09,-11763.1,2.5465851649642e-10
"10753",2017-01-13 16:54:43,14464.39,14464.3900000003
"10754",2017-01-13 16:54:43,11336.93,25801.3200000003
"10755",2017-01-13 16:54:43,10561.79,36363.1100000003
"10756",2017-01-13 17:13:14,-36363.11,2.5465851649642e-10
"10757",2017-01-13 18:27:07,8241.54,8241.54000000026
"10758",2017-01-13 19:14:10,-8241.54,2.5465851649642e-10
"10759",2017-01-13 20:27:44,8420.44,8420.44000000026
"10760",2017-01-13 20:27:44,7810.19,16230.6300000003
"10761",2017-01-13 20:27:44,5465.85,21696.4800000003
"10762",2017-01-13 20:39:40,-21696.48,2.58296495303512e-10
"10763",2017-01-13 23:05:48,13016.94,13016.9400000003
"10764",2017-01-13 23:05:48,22253.26,35270.2000000003
"10765",2017-01-13 23:05:48,6637.34,41907.5400000003
"10766",2017-01-13 23:08:55,-41907.54,2.5465851649642e-10
"10767",2017-01-14 00:17:16,32712.42,32712.4200000003
"10768",2017-01-14 00:17:16,6120.39,38832.8100000003
"10769",2017-01-14 00:39:28,-38832.81,2.5465851649642e-10
"10770",2017-01-14 01:52:32,16005.76,16005.7600000003
"10771",2017-01-14 01:52:32,10640.03,26645.7900000003
"10772",2017-01-14 01:52:32,8647.45,35293.2400000003
"10773",2017-01-14 01:52:32,6341.42,41634.6600000003
"10774",2017-01-14 01:58:47,-41634.66,2.47382558882236e-10
"10775",2017-01-14 07:11:43,9561.99,9561.99000000025
"10776",2017-01-14 07:33:11,-9561.99,2.47382558882236e-10
"10777",2017-01-15 23:28:46,10199.12,10199.1200000002
"10778",2017-01-15 23:28:46,18905.35,29104.4700000002
"10779",2017-01-15 23:28:46,6940.66,36045.1300000003
"10780",2017-01-15 23:45:31,-36045.13,2.5465851649642e-10
"10781",2017-01-16 02:45:06,25676.44,25676.4400000003
"10782",2017-01-16 02:45:06,9960.67,35637.1100000003
"10783",2017-01-16 02:45:06,5480.12,41117.2300000003
"10784",2017-01-16 02:50:32,-41117.23,2.5465851649642e-10
"10785",2017-01-16 04:53:21,7335.51,7335.51000000025
"10786",2017-01-16 04:59:26,-7335.51,2.5465851649642e-10
"10787",2017-01-16 07:29:21,5634.41,5634.41000000025
"10788",2017-01-16 07:42:49,8626.04,14260.4500000003
"10789",2017-01-16 07:42:49,-5634.41,8626.04000000026
"10790",2017-01-16 07:42:49,-5634.41,2991.63000000026
"10791",2017-01-16 07:52:22,-2991.63,2.55568011198193e-10
"10792",2017-01-16 08:49:31,7589.04,7589.04000000026
"10793",2017-01-16 09:02:34,-7589.04,2.55568011198193e-10
"10794",2017-01-16 09:45:27,9119.33,9119.33000000026
"10795",2017-01-16 09:45:27,6306.04,15425.3700000003
"10796",2017-01-16 09:57:42,-15425.37,2.56477505899966e-10
"10797",2017-01-17 04:06:51,37368.07,37368.0700000003
"10798",2017-01-17 04:06:51,13794.49,51162.5600000003
"10799",2017-01-17 04:06:51,5755.72,56918.2800000003
"10800",2017-01-17 04:06:51,6056.08,62974.3600000003
"10801",2017-01-17 05:35:10,-62974.36,2.5465851649642e-10
"10802",2017-01-17 05:51:03,36277.04,36277.0400000003
"10803",2017-01-17 08:52:59,-36277.04,2.5465851649642e-10
"10804",2017-01-17 09:29:14,6168.17,6168.17000000025
"10805",2017-01-17 09:29:14,30017.56,36185.7300000003
"10806",2017-01-17 09:29:14,30017.58,66203.3100000003
"10807",2017-01-17 09:29:14,13402.22,79605.5300000003
"10808",2017-01-17 09:51:42,-79605.53,2.61934474110603e-10
"10809",2017-01-17 13:18:41,33785.47,33785.4700000003
"10810",2017-01-17 13:18:41,18905.62,52691.0900000003
"10811",2017-01-17 13:23:21,-52691.09,2.61934474110603e-10
"10812",2017-01-17 14:30:58,8996.66,8996.66000000026
"10813",2017-01-17 14:38:09,6665.52,15662.1800000003
"10814",2017-01-17 14:38:09,-8996.66,6665.52000000026
"10815",2017-01-17 15:05:44,-6665.52,2.61934474110603e-10
"10816",2017-01-17 16:41:14,7181.09,7181.09000000026
"10817",2017-01-17 16:56:25,-7181.09,2.61934474110603e-10
"10818",2017-01-17 17:13:40,14764.53,14764.5300000003
"10819",2017-01-17 17:29:24,-14764.53,2.61934474110603e-10
"10820",2017-01-17 17:29:24,20400.95,20400.9500000003
"10821",2017-01-17 17:56:50,19116.07,39517.0200000003
"10822",2017-01-17 17:56:50,-20400.95,19116.0700000003
"10823",2017-01-17 18:19:23,-19116.07,2.65572452917695e-10
"10824",2017-01-17 18:29:50,8617.85,8617.85000000027
"10825",2017-01-17 18:43:47,-8617.85,2.65572452917695e-10
"10826",2017-01-17 18:43:47,755.84,755.840000000266
"10827",2017-01-17 18:55:13,16093.06,16848.9000000003
"10828",2017-01-17 18:55:13,-755.84,16093.0600000003
"10829",2017-01-17 19:04:58,-16093.06,2.63753463514149e-10
"10830",2017-01-17 19:08:41,10554.53,10554.5300000003
"10831",2017-01-17 19:19:40,-10554.53,2.63753463514149e-10
"10832",2017-01-17 19:45:19,29269.03,29269.0300000003
"10833",2017-01-17 19:53:53,-29269.03,2.61934474110603e-10
"10834",2017-01-17 20:13:58,18726.47,18726.4700000003
"10835",2017-01-17 20:13:58,24553.78,43280.2500000003
"10836",2017-01-17 20:18:16,-43280.25,2.61934474110603e-10
"10837",2017-01-17 21:12:10,15329.86,15329.8600000003
"10838",2017-01-17 21:24:06,-15329.86,2.61934474110603e-10
"10839",2017-01-17 21:50:02,11703.7,11703.7000000003
"10840",2017-01-17 22:02:08,-11703.7,2.61934474110603e-10
"10841",2017-01-17 22:29:52,21753.72,21753.7200000003
"10842",2017-01-17 22:45:09,12801.47,34555.1900000003
"10843",2017-01-17 22:45:09,-21753.72,12801.4700000003
"10844",2017-01-17 23:09:15,-12801.47,2.63753463514149e-10
"10845",2017-01-17 23:32:44,7796.71,7796.71000000026
"10846",2017-01-17 23:55:42,-7796.71,2.63753463514149e-10
"10847",2017-01-17 23:56:32,2500.21,2500.21000000026
"10848",2017-01-17 23:59:07,-2500.21,2.63753463514149e-10
"10849",2017-01-18 00:47:05,7739.27,7739.27000000026
"10850",2017-01-18 00:53:47,-7739.27,2.63753463514149e-10
"10851",2017-01-18 00:58:45,6445.31,6445.31000000026
"10852",2017-01-18 01:06:52,-6445.31,2.63753463514149e-10
"10853",2017-01-18 01:45:00,6658.2,6658.20000000026
"10854",2017-01-18 02:05:52,-6658.2,2.63753463514149e-10
"10855",2017-01-18 06:40:24,14809.54,14809.5400000003
"10856",2017-01-18 07:16:29,-14809.54,2.63753463514149e-10
"10857",2017-01-18 13:48:59,16358.93,16358.9300000003
"10858",2017-01-18 14:56:16,2257.25,18616.1800000003
"10859",2017-01-18 16:27:46,5695.17,24311.3500000003
"10860",2017-01-18 17:39:26,9367.49,33678.8400000003
"10861",2017-01-18 20:43:45,16052.12,49730.9600000003
"10862",2017-01-18 23:30:58,7855.27,57586.2300000003
"10863",2017-01-19 00:03:56,17818.05,75404.2800000003
"10864",2017-01-19 00:09:42,8072.49,83476.7700000003
"10865",2017-01-19 00:50:29,17732.15,101208.92
"10866",2017-01-19 02:43:20,17100.01,118308.93
"10867",2017-01-19 06:46:38,-118308.93,2.7648638933897e-10
"10868",2017-01-19 08:31:39,17843.95,17843.9500000003
"10869",2017-01-19 08:59:45,16076.05,33920.0000000003
"10870",2017-01-19 09:05:35,-17843.95,16076.0500000003
"10871",2017-01-19 09:12:20,-16076.05,2.7648638933897e-10
"10872",2017-01-19 12:17:43,18368.69,18368.6900000003
"10873",2017-01-19 12:40:41,-18368.69,2.7648638933897e-10
"10874",2017-01-19 14:01:00,17337.34,17337.3400000003
"10875",2017-01-19 14:09:55,-17337.34,2.7648638933897e-10
"10876",2017-01-19 15:13:35,15913.14,15913.1400000003
"10877",2017-01-19 15:17:33,-15913.14,2.7648638933897e-10
"10878",2017-01-19 17:35:15,22518.2,22518.2000000003
"10879",2017-01-19 17:35:15,16128.83,38647.0300000003
"10880",2017-01-19 18:07:57,19798.04,58445.0700000003
"10881",2017-01-19 18:07:57,-38647.03,19798.0400000003
"10882",2017-01-19 18:41:02,-19798.04,2.7648638933897e-10
"10883",2017-01-19 19:01:06,15970.89,15970.8900000003
"10884",2017-01-19 19:43:10,-15970.89,2.7648638933897e-10
"10885",2017-01-19 21:45:26,16478.57,16478.5700000003
"10886",2017-01-19 21:45:26,19588.07,36066.6400000003
"10887",2017-01-19 22:17:59,21439.88,57506.5200000003
"10888",2017-01-19 22:17:59,17612.76,75119.2800000003
"10889",2017-01-19 22:17:59,-36066.64,39052.6400000003
"10890",2017-01-19 23:25:50,-39052.64,2.7648638933897e-10
"10891",2017-01-19 23:25:50,16532.22,16532.2200000003
"10892",2017-01-20 00:06:42,-16532.22,2.7648638933897e-10
"10893",2017-01-20 02:10:06,15630.2,15630.2000000003
"10894",2017-01-20 02:13:40,-15630.2,2.7648638933897e-10
"10895",2017-01-20 04:54:55,15911.58,15911.5800000003
"10896",2017-01-20 05:38:37,-15911.58,2.7648638933897e-10
"10897",2017-01-20 08:43:30,17362.79,17362.7900000003
"10898",2017-01-20 08:50:48,-17362.79,2.7648638933897e-10
"10899",2017-01-20 17:39:41,18180.26,18180.2600000003
"10900",2017-01-20 21:23:25,-18180.26,2.7648638933897e-10
"10901",2017-01-20 22:04:44,16167.65,16167.6500000003
"10902",2017-01-21 02:36:51,21838.38,38006.0300000003
"10903",2017-01-21 02:36:51,17319.66,55325.6900000003
"10904",2017-01-21 03:31:20,-55325.69,2.7648638933897e-10
"10905",2017-01-21 03:40:07,22050.04,22050.0400000003
"10906",2017-01-21 04:12:57,20572.79,42622.8300000003
"10907",2017-01-21 04:12:57,21799.02,64421.8500000003
"10908",2017-01-21 04:12:57,-22050.04,42371.8100000003
"10909",2017-01-21 04:12:57,27856.23,70228.0400000003
"10910",2017-01-21 04:12:57,38906.31,109134.35
"10911",2017-01-21 04:33:02,-109134.35,2.7648638933897e-10
"10912",2017-01-21 05:03:03,23852.71,23852.7100000003
"10913",2017-01-21 05:06:27,-23852.71,2.7648638933897e-10
"10914",2017-01-21 05:48:24,39764.59,39764.5900000003
"10915",2017-01-21 05:48:24,18136.57,57901.1600000003
"10916",2017-01-21 06:16:31,-57901.16,2.69210431724787e-10
"10917",2017-01-21 08:15:06,17469.63,17469.6300000003
"10918",2017-01-21 08:31:12,-17469.63,2.69210431724787e-10
"10919",2017-01-21 11:06:15,18867.97,18867.9700000003
"10920",2017-01-21 11:19:34,21714.35,40582.3200000003
"10921",2017-01-21 11:21:39,-18867.97,21714.3500000003
"10922",2017-01-21 11:27:15,-21714.35,2.69210431724787e-10
"10923",2017-01-21 13:30:43,24402.01,24402.0100000003
"10924",2017-01-21 13:34:50,-24402.01,2.69210431724787e-10
"10925",2017-01-21 14:03:12,17381.69,17381.6900000003
"10926",2017-01-21 14:12:30,-17381.69,2.69210431724787e-10
"10927",2017-01-21 14:51:00,17669.73,17669.7300000003
"10928",2017-01-21 14:51:00,20377.52,38047.2500000003
"10929",2017-01-21 15:03:22,-38047.25,2.69210431724787e-10
"10930",2017-01-21 15:53:39,18482.09,18482.0900000003
"10931",2017-01-21 16:01:51,-18482.09,2.69210431724787e-10
"10932",2017-01-21 16:38:01,17816.77,17816.7700000003
"10933",2017-01-21 16:43:56,-17816.77,2.69210431724787e-10
"10934",2017-01-22 09:57:24,18019.13,18019.1300000003
"10935",2017-01-22 10:10:20,-18019.13,2.69210431724787e-10
"10936",2017-01-23 15:14:17,25415.69,25415.6900000003
"10937",2017-01-23 15:14:17,21711.44,47127.1300000003
"10938",2017-01-23 15:28:03,33370.08,80497.2100000003
"10939",2017-01-23 15:35:11,-80497.21,2.61934474110603e-10
"10940",2017-01-23 15:50:59,23243.32,23243.3200000003
"10941",2017-01-23 15:50:59,28864.22,52107.5400000003
"10942",2017-01-23 15:50:59,18635.5,70743.0400000003
"10943",2017-01-23 15:50:59,37795.62,108538.66
"10944",2017-01-23 15:59:14,-108538.66,2.61934474110603e-10
"10945",2017-01-23 22:59:50,20900.98,20900.9800000003
"10946",2017-01-23 23:21:25,-20900.98,2.61934474110603e-10
"10947",2017-01-23 23:45:22,18797.24,18797.2400000003
"10948",2017-01-24 00:14:15,-18797.24,2.61934474110603e-10
"10949",2017-01-24 04:18:52,11288.09,11288.0900000003
"10950",2017-01-24 04:22:32,16016.48,27304.5700000003
"10951",2017-01-24 04:22:32,-11288.09,16016.4800000003
"10952",2017-01-24 04:45:25,-16016.48,2.61934474110603e-10
"10953",2017-01-24 05:50:02,15544.29,15544.2900000003
"10954",2017-01-24 05:54:09,-15544.29,2.61934474110603e-10
"10955",2017-01-24 09:16:32,12360.2,12360.2000000003
"10956",2017-01-24 09:31:26,-12360.2,2.61934474110603e-10
"10957",2017-01-24 09:34:03,9539.21,9539.21000000026
"10958",2017-01-24 09:34:03,22929.58,32468.7900000003
"10959",2017-01-24 09:34:03,14381.9,46850.6900000003
"10960",2017-01-24 09:34:03,1395.68,48246.3700000003
"10961",2017-01-24 09:51:01,-48246.37,2.61934474110603e-10
"10962",2017-01-24 10:13:41,14338.94,14338.9400000003
"10963",2017-01-24 10:29:31,-14338.94,2.61934474110603e-10
"10964",2017-01-24 15:48:52,1393.49,1393.49000000026
"10965",2017-01-24 15:53:50,-1393.49,2.61934474110603e-10
"10966",2017-01-24 17:18:07,10393.6,10393.6000000003
"10967",2017-01-24 17:22:25,-10393.6,2.61934474110603e-10
"10968",2017-01-24 17:46:10,11180.07,11180.0700000003
"10969",2017-01-24 17:51:51,-11180.07,2.61934474110603e-10
"10970",2017-01-24 21:23:49,30019,30019.0000000003
"10971",2017-01-24 21:31:37,-30019,2.61934474110603e-10
"10972",2017-01-24 21:38:39,718.3,718.300000000262
"10973",2017-01-24 21:51:20,-718.3,2.61934474110603e-10
"10974",2017-01-25 06:36:48,13862.49,13862.4900000003
"10975",2017-01-25 06:36:48,10244.01,24106.5000000003
"10976",2017-01-25 06:36:48,8404.93,32511.4300000003
"10977",2017-01-25 07:43:09,-32511.43,2.61934474110603e-10
"10978",2017-01-25 14:12:40,9499.06,9499.06000000026
"10979",2017-01-25 14:21:24,-9499.06,2.61934474110603e-10
"10980",2017-01-25 20:12:11,895.17,895.170000000262
"10981",2017-01-25 20:16:55,-895.17,2.61934474110603e-10
"10982",2017-01-26 02:47:53,22619.48,22619.4800000003
"10983",2017-01-26 02:54:23,-22619.48,2.61934474110603e-10
"10984",2017-01-28 02:01:03,81138.93,81138.9300000003
"10985",2017-01-28 02:09:53,-81138.93,2.61934474110603e-10
"10986",2017-01-28 08:00:14,22339.06,22339.0600000003
"10987",2017-01-28 08:32:03,-22339.06,2.61934474110603e-10
"10988",2017-01-31 08:12:23,25619.91,25619.9100000003
"10989",2017-01-31 08:18:22,-25619.91,2.61934474110603e-10
"10990",2017-01-31 09:02:12,22774.91,22774.9100000003
"10991",2017-01-31 09:07:00,-22774.91,2.61934474110603e-10
"10992",2017-01-31 11:23:40,22870.29,22870.2900000003
"10993",2017-01-31 11:47:29,-22870.29,2.61934474110603e-10
"10994",2017-01-31 12:18:56,23607.08,23607.0800000003
"10995",2017-01-31 12:38:52,-23607.08,2.61934474110603e-10
"10996",2017-01-31 12:45:21,24061.81,24061.8100000003
"10997",2017-01-31 12:51:50,-24061.81,2.61934474110603e-10
"10998",2017-01-31 12:56:11,32075.74,32075.7400000003
"10999",2017-01-31 13:26:07,-32075.74,2.61934474110603e-10
"11000",2017-01-31 15:12:13,26145.91,26145.9100000003
"11001",2017-01-31 15:17:27,-26145.91,2.61934474110603e-10
"11002",2017-01-31 23:38:32,56426.61,56426.6100000003
"11003",2017-02-01 10:51:37,26282.3,82708.9100000003
"11004",2017-02-01 10:51:37,27179.54,109888.45
"11005",2017-02-01 11:10:40,-56426.61,53461.8400000003
"11006",2017-02-01 13:26:36,22341.4,75803.2400000003
"11007",2017-02-01 14:59:30,26552.94,102356.18
"11008",2017-02-01 15:04:40,33121.42,135477.6
"11009",2017-02-01 15:31:43,23487.73,158965.33
"11010",2017-02-01 20:13:38,-158965.33,2.91038304567337e-10
"11011",2017-02-02 05:21:18,23386.38,23386.3800000003
"11012",2017-02-02 05:24:48,-23386.38,2.91038304567337e-10
"11013",2017-02-02 11:06:56,23081.75,23081.7500000003
"11014",2017-02-02 11:21:29,-23081.75,2.91038304567337e-10
"11015",2017-02-02 15:24:22,26766.97,26766.9700000003
"11016",2017-02-02 15:32:57,-26766.97,2.91038304567337e-10
"11017",2017-02-02 15:32:57,18158.18,18158.1800000003
"11018",2017-02-02 15:34:39,-18158.18,2.91038304567337e-10
"11019",2017-02-02 17:45:44,23356.71,23356.7100000003
"11020",2017-02-02 18:02:52,12008.9,35365.6100000003
"11021",2017-02-02 18:02:52,13843.89,49209.5000000003
"11022",2017-02-02 18:15:27,12666.78,61876.2800000003
"11023",2017-02-02 19:07:36,13815.73,75692.0100000003
"11024",2017-02-02 19:07:36,-61876.28,13815.7300000003
"11025",2017-02-02 19:11:43,11622.54,25438.2700000003
"11026",2017-02-02 19:37:06,13917.04,39355.3100000003
"11027",2017-02-02 19:58:59,-25438.27,13917.0400000003
"11028",2017-02-02 20:12:21,-13917.04,2.87400325760245e-10
"11029",2017-02-02 21:07:30,20086.92,20086.9200000003
"11030",2017-02-02 21:30:24,-20086.92,2.87400325760245e-10
"11031",2017-02-02 22:54:50,11544.51,11544.5100000003
"11032",2017-02-02 23:00:35,-11544.51,2.87400325760245e-10
"11033",2017-02-03 06:58:01,33153.66,33153.6600000003
"11034",2017-02-03 07:48:44,-33153.66,2.91038304567337e-10
"11035",2017-02-03 07:48:44,22995.12,22995.1200000003
"11036",2017-02-03 08:09:00,28159.87,51154.9900000003
"11037",2017-02-03 08:09:00,-22995.12,28159.8700000003
"11038",2017-02-03 08:14:47,-28159.87,2.91038304567337e-10
"11039",2017-02-03 15:03:20,24579.67,24579.6700000003
"11040",2017-02-03 15:03:20,23607.49,48187.1600000003
"11041",2017-02-03 15:17:00,-48187.16,2.91038304567337e-10
"11042",2017-02-03 15:19:02,24935.89,24935.8900000003
"11043",2017-02-03 15:32:31,-24935.89,2.91038304567337e-10
"11044",2017-02-03 16:34:00,26123.48,26123.4800000003
"11045",2017-02-03 17:04:09,-26123.48,2.91038304567337e-10
"11046",2017-02-03 18:01:49,27037.17,27037.1700000003
"11047",2017-02-03 18:04:59,-27037.17,2.91038304567337e-10
"11048",2017-02-03 21:34:16,23895.53,23895.5300000003
"11049",2017-02-03 21:47:48,-23895.53,2.91038304567337e-10
"11050",2017-02-04 00:20:32,22802.92,22802.9200000003
"11051",2017-02-04 00:25:55,-22802.92,2.91038304567337e-10
"11052",2017-02-04 01:15:04,23910.41,23910.4100000003
"11053",2017-02-04 01:23:06,-23910.41,2.91038304567337e-10
"11054",2017-02-04 02:52:03,23297.73,23297.7300000003
"11055",2017-02-04 03:05:57,-23297.73,2.91038304567337e-10
"11056",2017-02-04 04:13:36,23772.64,23772.6400000003
"11057",2017-02-04 04:19:10,-23772.64,2.91038304567337e-10
"11058",2017-02-04 12:29:40,23195.14,23195.1400000003
"11059",2017-02-04 12:33:36,-23195.14,2.91038304567337e-10
"11060",2017-02-04 17:03:10,31736.94,31736.9400000003
"11061",2017-02-04 17:17:32,-31736.94,2.91038304567337e-10
"11062",2017-02-04 17:55:08,48844.23,48844.2300000003
"11063",2017-02-04 18:19:28,24659.85,73504.0800000003
"11064",2017-02-04 18:19:28,-48844.23,24659.8500000003
"11065",2017-02-04 18:53:04,-24659.85,2.91038304567337e-10
"11066",2017-02-05 17:46:13,827.99,827.990000000291
"11067",2017-02-05 18:34:35,9391.72,10219.7100000003
"11068",2017-02-05 18:34:35,-827.99,9391.72000000029
"11069",2017-02-05 18:51:34,-9391.72,2.91038304567337e-10
"11070",2017-02-05 18:51:34,7816.52,7816.52000000029
"11071",2017-02-05 18:51:34,32567.8,40384.3200000003
"11072",2017-02-05 18:51:34,9251.81,49636.1300000003
"11073",2017-02-05 19:07:56,-49636.13,2.91038304567337e-10
"11074",2017-02-05 20:49:01,10411.88,10411.8800000003
"11075",2017-02-05 20:49:01,8791.69,19203.5700000003
"11076",2017-02-05 20:52:13,-19203.57,2.91038304567337e-10
"11077",2017-02-06 05:27:01,8192.7,8192.70000000029
"11078",2017-02-06 05:44:55,9080.75,17273.4500000003
"11079",2017-02-06 05:44:55,-8192.7,9080.75000000029
"11080",2017-02-06 06:06:31,7901.1,16981.8500000003
"11081",2017-02-06 06:06:31,-9080.75,7901.10000000029
"11082",2017-02-06 06:36:21,14927.64,22828.7400000003
"11083",2017-02-06 06:36:21,-7901.1,14927.6400000003
"11084",2017-02-06 06:51:29,-14927.64,2.89219315163791e-10
"11085",2017-02-06 07:08:04,8482.3,8482.30000000029
"11086",2017-02-06 07:13:55,-8482.3,2.89219315163791e-10
"11087",2017-02-06 11:27:20,8532.22,8532.22000000029
"11088",2017-02-06 11:37:06,-8532.22,2.89219315163791e-10
"11089",2017-02-06 12:31:14,8071.39,8071.39000000029
"11090",2017-02-06 13:32:49,-8071.39,2.89219315163791e-10
"11091",2017-02-06 14:42:52,12581.38,12581.3800000003
"11092",2017-02-06 15:26:53,7847.35,20428.7300000003
"11093",2017-02-06 16:27:02,12155.79,32584.5200000003
"11094",2017-02-06 16:27:02,-12581.38,20003.1400000003
"11095",2017-02-06 16:27:02,-12581.38,7421.76000000029
"11096",2017-02-06 16:39:37,-7421.76,2.91038304567337e-10
"11097",2017-02-06 17:07:54,12829.53,12829.5300000003
"11098",2017-02-06 17:11:46,-12829.53,2.91038304567337e-10
"11099",2017-02-07 04:59:23,16585.66,16585.6600000003
"11100",2017-02-07 05:08:55,7917.34,24503.0000000003
"11101",2017-02-07 05:17:03,8423.21,32926.2100000003
"11102",2017-02-07 05:17:03,8687.06,41613.2700000003
"11103",2017-02-07 05:17:03,-24503,17110.2700000003
"11104",2017-02-07 05:25:07,-17110.27,2.87400325760245e-10
"11105",2017-02-07 05:48:25,13169.33,13169.3300000003
"11106",2017-02-07 05:52:13,-13169.33,2.87400325760245e-10
"11107",2017-02-07 06:32:12,9031.81,9031.81000000029
"11108",2017-02-07 06:50:34,-9031.81,2.87400325760245e-10
"11109",2017-02-07 07:18:46,20923.49,20923.4900000003
"11110",2017-02-07 07:36:10,-20923.49,2.87400325760245e-10
"11111",2017-02-07 08:09:03,19362.8,19362.8000000003
"11112",2017-02-07 08:12:45,-19362.8,2.87400325760245e-10
"11113",2017-02-07 09:10:41,26858.3,26858.3000000003
"11114",2017-02-07 09:15:34,-26858.3,2.87400325760245e-10
"11115",2017-02-07 13:31:34,24007.44,24007.4400000003
"11116",2017-02-07 15:41:54,23475.02,47482.4600000003
"11117",2017-02-07 15:50:36,-24007.44,23475.0200000003
"11118",2017-02-07 16:08:19,-23475.02,2.83762346953154e-10
"11119",2017-02-07 21:37:41,6571.22,6571.22000000028
"11120",2017-02-07 21:44:13,-6571.22,2.83762346953154e-10
"11121",2017-02-07 22:21:32,21247.91,21247.9100000003
"11122",2017-02-07 22:23:42,-21247.91,2.83762346953154e-10
"11123",2017-02-07 23:01:21,26358.71,26358.7100000003
"11124",2017-02-07 23:15:40,-26358.71,2.83762346953154e-10
"11125",2017-02-08 00:20:50,23217.43,23217.4300000003
"11126",2017-02-08 00:26:13,-23217.43,2.83762346953154e-10
"11127",2017-02-08 01:25:29,28574.58,28574.5800000003
"11128",2017-02-08 01:28:14,-28574.58,2.83762346953154e-10
"11129",2017-02-08 07:25:38,8202.21,8202.21000000028
"11130",2017-02-08 08:16:28,-8202.21,2.83762346953154e-10
"11131",2017-02-08 09:48:50,22474.45,22474.4500000003
"11132",2017-02-08 09:55:58,-22474.45,2.83762346953154e-10
"11133",2017-02-08 16:28:25,7935.31,7935.31000000028
"11134",2017-02-08 16:28:25,9879.37,17814.6800000003
"11135",2017-02-08 16:35:52,-17814.68,2.83762346953154e-10
"11136",2017-02-08 18:40:21,30021.16,30021.1600000003
"11137",2017-02-08 18:40:21,8757.85,38779.0100000003
"11138",2017-02-08 18:42:50,12705.67,51484.6800000003
"11139",2017-02-08 18:42:50,-38779.01,12705.6700000003
"11140",2017-02-08 18:45:54,8184.04,20889.7100000003
"11141",2017-02-08 18:45:54,-12705.67,8184.04000000028
"11142",2017-02-08 19:05:10,11845.16,20029.2000000003
"11143",2017-02-08 19:19:39,10168.55,30197.7500000003
"11144",2017-02-08 19:19:39,-8184.04,22013.7100000003
"11145",2017-02-08 19:19:39,-20029.2,1984.51000000028
"11146",2017-02-08 19:27:48,-1984.51,2.78532752417959e-10
"11147",2017-02-08 19:57:20,11755.23,11755.2300000003
"11148",2017-02-08 20:38:06,10453.04,22208.2700000003
"11149",2017-02-08 20:38:06,13229.99,35438.2600000003
"11150",2017-02-08 20:38:06,-11755.23,23683.0300000003
"11151",2017-02-08 20:38:06,-11755.23,11927.8000000003
"11152",2017-02-08 20:38:06,-11755.23,172.57000000028
"11153",2017-02-08 20:44:59,-172.57,2.79840151051758e-10
"11154",2017-02-08 21:26:42,7937.3,7937.30000000028
"11155",2017-02-08 21:35:36,-7937.3,2.80124368146062e-10
"11156",2017-02-09 02:22:40,9893.55,9893.55000000028
"11157",2017-02-09 02:33:37,-9893.55,2.80124368146062e-10
"11158",2017-02-09 03:10:06,11177.2,11177.2000000003
"11159",2017-02-09 03:15:06,-11177.2,2.80124368146062e-10
"11160",2017-02-09 03:21:21,13628.24,13628.2400000003
"11161",2017-02-09 03:24:07,42196.58,55824.8200000003
"11162",2017-02-09 03:24:07,-13628.24,42196.5800000003
"11163",2017-02-09 03:29:13,-42196.58,2.83762346953154e-10
"11164",2017-02-09 03:30:01,26144.22,26144.2200000003
"11165",2017-02-09 03:35:54,23327,49471.2200000003
"11166",2017-02-09 03:35:54,-26144.22,23327.0000000003
"11167",2017-02-09 03:40:16,-23327,2.83762346953154e-10
"11168",2017-02-09 05:33:07,22719.78,22719.7800000003
"11169",2017-02-09 05:59:10,-22719.78,2.83762346953154e-10
"11170",2017-02-09 06:51:58,22768.26,22768.2600000003
"11171",2017-02-09 07:21:56,-22768.26,2.83762346953154e-10
"11172",2017-02-09 12:16:04,23323.69,23323.6900000003
"11173",2017-02-09 12:35:46,-23323.69,2.83762346953154e-10
"11174",2017-02-09 20:52:51,38596.3,38596.3000000003
"11175",2017-02-09 20:52:51,23551.38,62147.6800000003
"11176",2017-02-09 21:01:41,-62147.68,2.83762346953154e-10
"11177",2017-02-09 21:01:41,28365.12,28365.1200000003
"11178",2017-02-09 21:05:27,-28365.12,2.83762346953154e-10
"11179",2017-02-09 21:05:27,33549.95,33549.9500000003
"11180",2017-02-09 21:22:17,23683.75,57233.7000000003
"11181",2017-02-09 21:22:17,-33549.95,23683.7500000003
"11182",2017-02-09 21:39:22,22758.47,46442.2200000003
"11183",2017-02-09 21:39:22,-23683.75,22758.4700000003
"11184",2017-02-09 21:43:44,-22758.47,2.83762346953154e-10
"11185",2017-02-09 22:20:50,34071.54,34071.5400000003
"11186",2017-02-09 22:20:50,28789.11,62860.6500000003
"11187",2017-02-09 22:20:50,77798.57,140659.22
"11188",2017-02-09 22:43:32,-140659.22,2.91038304567337e-10
"11189",2017-02-10 10:44:28,27522.52,27522.5200000003
"11190",2017-02-10 10:44:28,23394.18,50916.7000000003
"11191",2017-02-10 10:44:28,28138.02,79054.7200000003
"11192",2017-02-10 11:35:57,-79054.72,2.91038304567337e-10
"11193",2017-02-12 02:14:54,26751.45,26751.4500000003
"11194",2017-02-12 02:46:02,-26751.45,2.91038304567337e-10
"11195",2017-02-12 03:00:31,25032.28,25032.2800000003
"11196",2017-02-12 03:10:35,-25032.28,2.91038304567337e-10
"11197",2017-02-14 07:33:25,27343.02,27343.0200000003
"11198",2017-02-14 07:36:28,-27343.02,2.91038304567337e-10
"11199",2017-02-14 08:34:16,27727.94,27727.9400000003
"11200",2017-02-14 08:38:55,28358.09,56086.0300000003
"11201",2017-02-14 08:38:55,-27727.94,28358.0900000003
"11202",2017-02-14 08:44:29,-28358.09,2.91038304567337e-10
"11203",2017-02-14 13:23:23,26326.33,26326.3300000003
"11204",2017-02-14 13:32:29,-26326.33,2.91038304567337e-10
"11205",2017-02-14 15:09:28,23442.25,23442.2500000003
"11206",2017-02-14 15:24:17,-23442.25,2.91038304567337e-10
"11207",2017-02-15 07:15:01,29385.86,29385.8600000003
"11208",2017-02-15 07:23:21,-29385.86,2.91038304567337e-10
"11209",2017-02-15 09:14:12,24294.83,24294.8300000003
"11210",2017-02-15 09:43:53,-24294.83,2.91038304567337e-10
"11211",2017-02-15 14:47:01,22374.39,22374.3900000003
"11212",2017-02-15 15:01:08,-22374.39,2.91038304567337e-10
"11213",2017-02-16 22:23:25,24137.97,24137.9700000003
"11214",2017-02-16 22:36:48,-24137.97,2.91038304567337e-10
"11215",2017-02-17 17:08:27,23181.24,23181.2400000003
"11216",2017-02-17 17:16:08,-23181.24,2.91038304567337e-10
"11217",2017-02-17 18:46:36,24923.01,24923.0100000003
"11218",2017-02-17 19:00:03,-24923.01,2.91038304567337e-10
"11219",2017-02-17 20:05:43,23536.73,23536.7300000003
"11220",2017-02-17 20:16:08,-23536.73,2.91038304567337e-10
"11221",2017-02-17 21:07:38,30780.02,30780.0200000003
"11222",2017-02-17 21:12:18,-30780.02,2.91038304567337e-10
"11223",2017-02-17 23:46:17,24138.89,24138.8900000003
"11224",2017-02-17 23:52:45,-24138.89,2.91038304567337e-10
"11225",2017-02-18 01:35:24,24418.27,24418.2700000003
"11226",2017-02-18 01:55:54,-24418.27,2.91038304567337e-10
"11227",2017-02-18 04:00:03,28810.71,28810.7100000003
"11228",2017-02-18 05:07:20,-28810.71,2.91038304567337e-10
"11229",2017-02-18 05:07:20,38873.67,38873.6700000003
"11230",2017-02-18 05:16:34,-38873.67,2.91038304567337e-10
"11231",2017-02-20 23:45:56,24080.1,24080.1000000003
"11232",2017-02-20 23:45:56,39788.93,63869.0300000003
"11233",2017-02-21 00:11:22,22960.18,86829.2100000003
"11234",2017-02-21 00:11:22,26159.22,112988.43
"11235",2017-02-21 00:11:22,-63869.03,49119.4000000003
"11236",2017-02-21 00:31:28,37921.71,87041.1100000003
"11237",2017-02-21 00:31:28,-49119.4,37921.7100000003
"11238",2017-02-21 00:36:03,-37921.71,2.7648638933897e-10
"11239",2017-02-21 04:39:27,83294.11,83294.1100000003
"11240",2017-02-21 04:45:22,83437.02,166731.13
"11241",2017-02-21 04:45:22,-83294.11,83437.0200000003
"11242",2017-02-21 05:36:04,-83437.02,2.91038304567337e-10
"11243",2017-02-21 06:17:14,38152.8,38152.8000000003
"11244",2017-02-21 06:17:14,43922.6,82075.4000000003
"11245",2017-02-21 06:24:51,-82075.4,2.91038304567337e-10
"11246",2017-02-21 09:06:56,29324.16,29324.1600000003
"11247",2017-02-21 09:14:22,-29324.16,2.91038304567337e-10
"11248",2017-02-21 12:44:41,60750.21,60750.2100000003
"11249",2017-02-21 12:51:54,-60750.21,2.91038304567337e-10
"11250",2017-02-21 16:25:42,30130.08,30130.0800000003
"11251",2017-02-21 16:47:15,25235.01,55365.0900000003
"11252",2017-02-21 16:49:32,-30130.08,25235.0100000003
"11253",2017-02-21 18:08:18,-25235.01,2.87400325760245e-10
"11254",2017-02-21 18:08:18,42072.29,42072.2900000003
"11255",2017-02-21 18:13:13,-42072.29,2.83762346953154e-10
"11256",2017-02-23 18:31:19,40235.05,40235.0500000003
"11257",2017-02-23 18:49:46,-40235.05,2.83762346953154e-10
"11258",2017-02-23 22:35:22,22430.25,22430.2500000003
"11259",2017-02-23 22:48:36,-22430.25,2.83762346953154e-10
"11260",2017-02-23 23:36:40,29597.01,29597.0100000003
"11261",2017-02-24 00:12:31,-29597.01,2.83762346953154e-10
"11262",2017-02-24 00:28:44,23260.81,23260.8100000003
"11263",2017-02-24 02:13:41,26871.17,50131.9800000003
"11264",2017-02-24 02:13:41,28564.38,78696.3600000003
"11265",2017-02-24 02:13:41,-23260.81,55435.5500000003
"11266",2017-02-24 02:13:41,-23260.81,32174.7400000003
"11267",2017-02-24 02:13:41,-23260.81,8913.93000000029
"11268",2017-02-24 02:18:44,-8913.93,2.91038304567337e-10
"11269",2017-02-24 02:39:17,24774.61,24774.6100000003
"11270",2017-02-24 02:55:10,-24774.61,2.91038304567337e-10
"11271",2017-02-24 03:20:37,29991.48,29991.4800000003
"11272",2017-02-24 03:24:52,-29991.48,2.91038304567337e-10
"11273",2017-02-24 04:10:08,22888.05,22888.0500000003
"11274",2017-02-24 04:11:35,49096.66,71984.7100000003
"11275",2017-02-24 04:18:15,-71984.71,2.91038304567337e-10
"11276",2017-02-24 04:27:35,23779.12,23779.1200000003
"11277",2017-02-24 04:39:42,-23779.12,2.91038304567337e-10
"11278",2017-02-24 06:28:02,23634.76,23634.7600000003
"11279",2017-02-24 06:38:04,-23634.76,2.91038304567337e-10
"11280",2017-02-24 07:58:15,22905.84,22905.8400000003
"11281",2017-02-24 08:00:58,-22905.84,2.91038304567337e-10
"11282",2017-02-24 20:30:54,23325.91,23325.9100000003
"11283",2017-02-24 21:18:04,-23325.91,2.91038304567337e-10
"11284",2017-02-24 23:48:18,26951.04,26951.0400000003
"11285",2017-02-24 23:48:18,41974.62,68925.6600000003
"11286",2017-02-24 23:48:18,77799.74,146725.4
"11287",2017-02-24 23:53:14,-146725.4,3.20142135024071e-10
"11288",2017-02-28 03:53:11,23882.79,23882.7900000003
"11289",2017-02-28 03:53:11,26803.75,50686.5400000003
"11290",2017-02-28 03:53:11,77799.81,128486.35
"11291",2017-02-28 03:53:11,88910.82,217397.17
"11292",2017-02-28 09:04:52,-217397.17,3.20142135024071e-10
"11293",2017-02-28 13:02:55,26069.75,26069.7500000003
"11294",2017-02-28 13:03:12,24011.19,50080.9400000003
"11295",2017-02-28 19:56:30,26786.89,76867.8300000003
"11296",2017-02-28 19:56:30,25508.51,102376.34
"11297",2017-02-28 19:56:30,33796.97,136173.31
"11298",2017-02-28 19:56:30,88910.88,225084.19
"11299",2017-02-28 22:03:40,26952.75,252036.94
"11300",2017-03-01 00:00:11,23545.15,275582.09
"11301",2017-03-01 00:54:34,-217397.17,58184.9200000003
"11302",2017-03-01 01:31:37,29963.07,88147.9900000003
"11303",2017-03-01 01:31:37,28991.39,117139.38
"11304",2017-03-01 02:54:45,-117139.38,3.05590219795704e-10
"11305",2017-03-01 03:14:26,33240.11,33240.1100000003
"11306",2017-03-01 03:24:08,-33240.11,3.05590219795704e-10
"11307",2017-03-01 04:30:57,23015.77,23015.7700000003
"11308",2017-03-01 06:25:54,-23015.77,3.05590219795704e-10
"11309",2017-03-01 12:37:27,22898.95,22898.9500000003
"11310",2017-03-01 12:37:27,41421.76,64320.7100000003
"11311",2017-03-01 13:03:25,-50080.94,14239.7700000003
"11312",2017-03-01 14:10:29,29722.87,43962.6400000003
"11313",2017-03-01 14:43:35,-14239.77,29722.8700000003
"11314",2017-03-01 14:43:35,-14239.77,15483.1000000003
"11315",2017-03-01 14:43:35,-14239.77,1243.3300000003
"11316",2017-03-01 14:59:21,29982.12,31225.4500000003
"11317",2017-03-01 14:59:21,-14239.77,16985.6800000003
"11318",2017-03-01 14:59:21,-14239.77,2745.9100000003
"11319",2017-03-01 15:42:15,28893.64,31639.5500000003
"11320",2017-03-01 16:24:34,-1243.33,30396.2200000003
"11321",2017-03-01 16:24:34,-2745.91,27650.3100000003
"11322",2017-03-01 16:24:34,-2745.91,24904.4000000003
"11323",2017-03-01 16:40:19,-2745.91,22158.4900000003
"11324",2017-03-01 16:40:19,-2745.91,19412.5800000003
"11325",2017-03-01 20:10:04,25801.1,45213.6800000003
"11326",2017-03-01 20:10:04,24254.35,69468.0300000003
"11327",2017-03-01 20:10:04,28544.87,98012.9000000003
"11328",2017-03-01 20:10:04,-31639.55,66373.3500000003
"11329",2017-03-01 20:10:04,-31639.55,34733.8000000003
"11330",2017-03-01 20:25:20,77800.05,112533.85
"11331",2017-03-01 20:25:20,-31639.55,80894.3000000003
"11332",2017-03-01 20:25:20,-31639.55,49254.7500000003
"11333",2017-03-01 21:05:58,-31639.55,17615.2000000003
"11334",2017-03-01 21:29:18,58226.13,75841.3300000003
"11335",2017-03-01 21:42:07,-24904.4,50936.9300000003
"11336",2017-03-01 22:11:37,43003.99,93940.9200000003
"11337",2017-03-01 22:18:00,-50080.94,43859.9800000003
"11338",2017-03-01 22:20:13,-24904.4,18955.5800000003
"11339",2017-03-02 01:32:09,21268.28,40223.8600000003
"11340",2017-03-02 03:21:43,-19412.58,20811.2800000003
"11341",2017-03-02 03:21:43,-19412.58,1398.70000000027
"11342",2017-03-02 04:53:43,-1398.7,2.66254573944025e-10
"11343",2017-03-02 09:51:16,11873.58,11873.5800000003
"11344",2017-03-02 09:51:16,14919.78,26793.3600000003
"11345",2017-03-02 10:19:04,-26793.36,2.65572452917695e-10
"11346",2017-03-02 12:33:33,8831.67,8831.67000000027
"11347",2017-03-02 12:43:26,-8831.67,2.65572452917695e-10
"11348",2017-03-02 13:28:34,13875.8,13875.8000000003
"11349",2017-03-02 13:30:49,-13875.8,2.65572452917695e-10
"11350",2017-03-02 13:34:57,10549.34,10549.3400000003
"11351",2017-03-02 13:41:07,-10549.34,2.65572452917695e-10
"11352",2017-03-02 13:54:21,8564.17,8564.17000000027
"11353",2017-03-02 14:02:34,-8564.17,2.65572452917695e-10
"11354",2017-03-02 14:09:35,30023.17,30023.1700000003
"11355",2017-03-02 14:29:36,-30023.17,2.65572452917695e-10
"11356",2017-03-02 15:06:38,30023.18,30023.1800000003
"11357",2017-03-02 15:53:05,-30023.18,2.65572452917695e-10
"11358",2017-03-02 16:31:50,8911.2,8911.20000000027
"11359",2017-03-02 16:38:20,-8911.2,2.65572452917695e-10
"11360",2017-03-02 16:38:20,18911.19,18911.1900000003
"11361",2017-03-02 16:38:20,30023.21,48934.4000000003
"11362",2017-03-02 16:45:39,-48934.4,2.61934474110603e-10
"11363",2017-03-02 16:54:23,30023.22,30023.2200000003
"11364",2017-03-02 17:35:06,30023.23,60046.4500000003
"11365",2017-03-02 17:40:22,-30023.22,30023.2300000003
"11366",2017-03-02 17:40:22,-30023.22,0.0100000002566958
"11367",2017-03-02 17:46:01,30023.24,30023.2500000003
"11368",2017-03-02 17:51:50,-30023.25,2.58296495303512e-10
"11369",2017-03-02 18:01:32,22143.95,22143.9500000003
"11370",2017-03-02 18:01:32,21351.81,43495.7600000003
"11371",2017-03-02 18:01:32,30023.27,73519.0300000003
"11372",2017-03-02 18:14:44,-73519.03,2.61934474110603e-10
"11373",2017-03-02 19:32:54,24315.02,24315.0200000003
"11374",2017-03-02 19:32:54,30341.03,54656.0500000003
"11375",2017-03-02 19:32:54,22618.04,77274.0900000003
"11376",2017-03-02 19:32:54,30023.32,107297.41
"11377",2017-03-02 20:02:19,22886.03,130183.44
"11378",2017-03-02 20:02:19,-107297.41,22886.0300000003
"11379",2017-03-02 20:10:54,-22886.03,2.61934474110603e-10
"11380",2017-03-02 20:53:06,23785.15,23785.1500000003
"11381",2017-03-02 20:53:06,77800.35,101585.5
"11382",2017-03-02 21:13:48,-101585.5,2.61934474110603e-10
"11383",2017-03-02 21:36:58,23157.98,23157.9800000003
"11384",2017-03-02 21:36:58,39672.2,62830.1800000003
"11385",2017-03-02 21:41:29,77800.38,140630.56
"11386",2017-03-02 21:41:29,-101585.5,39045.0600000003
"11387",2017-03-02 21:47:33,34994.42,74039.4800000003
"11388",2017-03-02 21:47:33,-39045.06,34994.4200000003
"11389",2017-03-02 22:05:03,-34994.42,2.61934474110603e-10
"11390",2017-03-02 22:05:03,49145.6,49145.6000000003
"11391",2017-03-02 22:05:03,23590.05,72735.6500000003
"11392",2017-03-02 22:09:52,-72735.65,2.61934474110603e-10
"11393",2017-03-02 22:34:24,31804.06,31804.0600000003
"11394",2017-03-02 22:34:24,77800.44,109604.5
"11395",2017-03-02 22:34:24,25678.42,135282.92
"11396",2017-03-02 22:40:41,-135282.92,2.61934474110603e-10
"11397",2017-03-03 01:41:32,24001.13,24001.1300000003
"11398",2017-03-03 01:41:32,26931.9,50933.0300000003
"11399",2017-03-03 01:56:38,-50933.03,2.61934474110603e-10
"11400",2017-03-03 02:30:18,31316.02,31316.0200000003
"11401",2017-03-03 02:30:18,27928.37,59244.3900000003
"11402",2017-03-03 02:44:36,48090.1,107334.49
"11403",2017-03-03 02:44:36,-59244.39,48090.1000000003
"11404",2017-03-03 02:51:26,-48090.1,2.5465851649642e-10
"11405",2017-03-03 03:50:55,28577.13,28577.1300000003
"11406",2017-03-03 04:04:31,-28577.13,2.5465851649642e-10
"11407",2017-03-03 06:32:21,43959.03,43959.0300000003
"11408",2017-03-03 06:55:05,-43959.03,2.5465851649642e-10
"11409",2017-03-03 08:22:57,27601.54,27601.5400000003
"11410",2017-03-03 08:22:57,23295.5,50897.0400000003
"11411",2017-03-03 08:42:59,-50897.04,2.5465851649642e-10
"11412",2017-03-03 09:18:32,32078.43,32078.4300000003
"11413",2017-03-03 09:26:19,26099.17,58177.6000000003
"11414",2017-03-03 09:26:19,-32078.43,26099.1700000003
"11415",2017-03-03 10:10:39,23604.91,49704.0800000002
"11416",2017-03-03 10:10:39,-26099.17,23604.9100000003
"11417",2017-03-03 10:20:14,-23604.91,2.51020537689328e-10
"11418",2017-03-03 10:32:08,28103.47,28103.4700000003
"11419",2017-03-03 10:35:34,-28103.47,2.51020537689328e-10
"11420",2017-03-03 14:58:52,37433.92,37433.9200000002
"11421",2017-03-03 14:58:52,47972.35,85406.2700000003
"11422",2017-03-03 15:29:13,59142.83,144549.1
"11423",2017-03-03 15:29:13,41512.66,186061.76
"11424",2017-03-03 15:29:13,-85406.27,100655.49
"11425",2017-03-03 15:29:13,-85406.27,15249.2200000003
"11426",2017-03-03 15:35:56,-15249.22,2.63753463514149e-10
"11427",2017-03-03 16:07:01,49520.72,49520.7200000003
"11428",2017-03-03 16:27:45,34027.36,83548.0800000003
"11429",2017-03-03 16:27:45,-49520.72,34027.3600000003
"11430",2017-03-03 16:31:44,-34027.36,2.61934474110603e-10
"11431",2017-03-03 16:45:59,59107.25,59107.2500000003
"11432",2017-03-03 16:53:53,-59107.25,2.61934474110603e-10
"11433",2017-03-03 18:08:31,36477.33,36477.3300000003
"11434",2017-03-03 18:08:31,63437.62,99914.9500000003
"11435",2017-03-03 18:10:52,-99914.95,2.7648638933897e-10
"11436",2017-03-03 20:05:28,13025.07,13025.0700000003
"11437",2017-03-03 20:07:54,-13025.07,2.7648638933897e-10
"11438",2017-03-03 20:23:17,49501.26,49501.2600000003
"11439",2017-03-03 20:23:17,77802.06,127303.32
"11440",2017-03-03 20:37:01,-127303.32,2.61934474110603e-10
"11441",2017-03-03 21:24:56,43051.2,43051.2000000003
"11442",2017-03-03 21:34:39,-43051.2,2.61934474110603e-10
"11443",2017-03-03 22:09:33,33976.85,33976.8500000003
"11444",2017-03-03 22:27:53,-33976.85,2.61934474110603e-10
"11445",2017-03-03 22:55:21,22519.7,22519.7000000003
"11446",2017-03-03 23:15:38,-22519.7,2.61934474110603e-10
"11447",2017-03-04 00:47:47,36082.24,36082.2400000003
"11448",2017-03-04 00:56:06,-36082.24,2.61934474110603e-10
"11449",2017-03-04 01:03:08,13259.2,13259.2000000003
"11450",2017-03-04 01:10:47,-13259.2,2.61934474110603e-10
"11451",2017-03-04 02:00:24,16230.5,16230.5000000003
"11452",2017-03-04 02:13:38,-16230.5,2.61934474110603e-10
"11453",2017-03-04 07:19:34,28614.4,28614.4000000003
"11454",2017-03-04 08:10:37,-28614.4,2.61934474110603e-10
"11455",2017-03-04 09:55:04,37397.08,37397.0800000003
"11456",2017-03-04 09:57:34,-37397.08,2.61934474110603e-10
"11457",2017-03-04 10:49:35,34122.14,34122.1400000003
"11458",2017-03-04 10:54:45,-34122.14,2.61934474110603e-10
"11459",2017-03-04 12:08:34,44839.04,44839.0400000003
"11460",2017-03-04 12:12:45,-44839.04,2.61934474110603e-10
"11461",2017-03-04 13:14:41,34397.49,34397.4900000003
"11462",2017-03-04 13:18:04,-34397.49,2.61934474110603e-10
"11463",2017-03-04 15:22:36,32049.05,32049.0500000003
"11464",2017-03-04 15:40:06,-32049.05,2.61934474110603e-10
"11465",2017-03-04 16:39:00,55598.14,55598.1400000003
"11466",2017-03-04 16:39:00,36270.47,91868.6100000003
"11467",2017-03-04 16:44:41,-91868.61,2.61934474110603e-10
"11468",2017-03-05 00:14:22,33917.57,33917.5700000003
"11469",2017-03-05 00:20:24,-33917.57,2.61934474110603e-10
"11470",2017-03-05 00:28:07,34334.77,34334.7700000003
"11471",2017-03-05 01:05:36,-34334.77,2.61934474110603e-10
"11472",2017-03-05 09:23:44,42963.38,42963.3800000003
"11473",2017-03-05 09:23:44,88219.08,131182.46
"11474",2017-03-05 09:27:44,-131182.46,2.61934474110603e-10
"11475",2017-03-05 10:34:35,36543.45,36543.4500000003
"11476",2017-03-05 10:40:21,-36543.45,2.61934474110603e-10
"11477",2017-03-05 19:20:12,37850.26,37850.2600000003
"11478",2017-03-05 19:20:12,35492.43,73342.6900000003
"11479",2017-03-05 19:22:48,-73342.69,2.61934474110603e-10
"11480",2017-03-05 20:05:14,48192.83,48192.8300000003
"11481",2017-03-05 20:10:20,-48192.83,2.61934474110603e-10
"11482",2017-03-06 01:29:11,32666.1,32666.1000000003
"11483",2017-03-06 01:54:07,-32666.1,2.61934474110603e-10
"11484",2017-03-06 03:50:08,29256.48,29256.4800000003
"11485",2017-03-06 04:09:17,-29256.48,2.61934474110603e-10
"11486",2017-03-06 08:10:48,31257.43,31257.4300000003
"11487",2017-03-06 08:17:16,-31257.43,2.61934474110603e-10
"11488",2017-03-06 21:39:26,32646.67,32646.6700000003
"11489",2017-03-06 21:49:54,-32646.67,2.61934474110603e-10
"11490",2017-03-06 23:26:19,31611.4,31611.4000000003
"11491",2017-03-06 23:30:49,-31611.4,2.61934474110603e-10
"11492",2017-03-07 01:58:31,30549.95,30549.9500000003
"11493",2017-03-07 02:15:42,-30549.95,2.61934474110603e-10
"11494",2017-03-07 07:11:16,29372.91,29372.9100000003
"11495",2017-03-07 07:11:16,30720.59,60093.5000000003
"11496",2017-03-07 07:37:55,-60093.5,2.61934474110603e-10
"11497",2017-03-07 08:13:13,30730.07,30730.0700000003
"11498",2017-03-07 08:36:07,-30730.07,2.61934474110603e-10
"11499",2017-03-07 08:55:02,32694.16,32694.1600000003
"11500",2017-03-07 09:04:43,-32694.16,2.61934474110603e-10
"11501",2017-03-07 09:36:38,59531.34,59531.3400000003
"11502",2017-03-07 09:46:25,35097.9,94629.2400000003
"11503",2017-03-07 09:46:25,29558.08,124187.32
"11504",2017-03-07 09:46:25,-59531.34,64655.9800000003
"11505",2017-03-07 10:04:53,-64655.98,2.5465851649642e-10
"11506",2017-03-07 13:09:33,123534.48,123534.48
"11507",2017-03-07 13:31:43,-123534.48,2.47382558882236e-10
"11508",2017-03-07 15:08:32,50027.66,50027.6600000003
"11509",2017-03-07 15:08:32,29182.04,79209.7000000002
"11510",2017-03-07 15:17:23,-79209.7,2.47382558882236e-10
"11511",2017-03-07 16:07:59,30569.17,30569.1700000002
"11512",2017-03-07 16:32:43,33563.04,64132.2100000002
"11513",2017-03-07 16:32:43,-30569.17,33563.0400000002
"11514",2017-03-07 16:32:43,44291.96,77855.0000000002
"11515",2017-03-07 16:32:43,-30569.17,47285.8300000002
"11516",2017-03-07 16:40:51,-47285.83,2.47382558882236e-10
"11517",2017-03-07 17:19:13,32750.26,32750.2600000002
"11518",2017-03-07 17:25:11,30912.99,63663.2500000002
"11519",2017-03-07 17:25:11,-32750.26,30912.9900000002
"11520",2017-03-07 17:29:53,-30912.99,2.47382558882236e-10
"11521",2017-03-07 17:36:37,53884.8,53884.8000000003
"11522",2017-03-07 17:41:06,-53884.8,2.47382558882236e-10
"11523",2017-03-07 19:13:56,30609.77,30609.7700000002
"11524",2017-03-07 19:35:10,-30609.77,2.47382558882236e-10
"11525",2017-03-07 19:42:39,31831.97,31831.9700000002
"11526",2017-03-07 19:53:05,31396.49,63228.4600000003
"11527",2017-03-07 19:53:05,-31831.97,31396.4900000003
"11528",2017-03-07 20:18:15,-31396.49,2.51020537689328e-10
"11529",2017-03-07 21:10:51,29442.08,29442.0800000003
"11530",2017-03-07 21:40:46,57076.93,86519.0100000003
"11531",2017-03-07 21:40:46,-29442.08,57076.9300000003
"11532",2017-03-07 21:48:09,52945.98,110022.91
"11533",2017-03-07 21:48:09,-57076.93,52945.9800000003
"11534",2017-03-07 21:55:54,-52945.98,2.61934474110603e-10
"11535",2017-03-07 22:33:34,31964.97,31964.9700000003
"11536",2017-03-07 22:36:47,-31964.97,2.61934474110603e-10
"11537",2017-03-07 23:26:11,32922.65,32922.6500000003
"11538",2017-03-07 23:33:59,-32922.65,2.61934474110603e-10
"11539",2017-03-07 23:47:19,29822.51,29822.5100000003
"11540",2017-03-07 23:59:30,-29822.51,2.61934474110603e-10
"11541",2017-03-08 07:55:05,29204.48,29204.4800000003
"11542",2017-03-08 08:01:20,30585.97,59790.4500000003
"11543",2017-03-08 08:21:31,30985.53,90775.9800000003
"11544",2017-03-08 08:21:31,52340.16,143116.14
"11545",2017-03-08 08:39:45,34160.91,177277.05
"11546",2017-03-08 08:39:45,33857.68,211134.73
"11547",2017-03-08 08:54:39,-59790.45,151344.28
"11548",2017-03-08 08:54:39,-29204.48,122139.8
"11549",2017-03-08 08:54:39,-59790.45,62349.3500000003
"11550",2017-03-08 09:01:35,-62349.35,2.69210431724787e-10
"11551",2017-03-08 10:19:33,88916.14,88916.1400000003
"11552",2017-03-08 10:38:03,15028.51,103944.65
"11553",2017-03-08 10:38:03,-88916.14,15028.5100000003
"11554",2017-03-08 11:30:22,100755.24,115783.75
"11555",2017-03-08 11:30:22,-15028.51,100755.24
"11556",2017-03-08 11:35:09,-100755.24,2.7648638933897e-10
"11557",2017-03-08 12:15:18,70028.55,70028.5500000003
"11558",2017-03-08 12:15:18,29816.97,99845.5200000003
"11559",2017-03-08 12:24:57,-99845.52,2.7648638933897e-10
"11560",2017-03-08 13:16:45,74276.16,74276.1600000003
"11561",2017-03-08 13:23:09,-74276.16,2.7648638933897e-10
"11562",2017-03-08 15:25:38,33333.04,33333.0400000003
"11563",2017-03-08 15:25:38,70028.58,103361.62
"11564",2017-03-08 15:44:28,-103361.62,2.91038304567337e-10
"11565",2017-03-08 19:10:52,88917.8,88917.8000000003
"11566",2017-03-08 19:10:52,72143.56,161061.36
"11567",2017-03-08 19:10:52,52340.16,213401.52
"11568",2017-03-08 19:10:52,33857.68,247259.2
"11569",2017-03-08 19:21:17,70029.81,317289.01
"11570",2017-03-08 19:21:17,-247259.2,70029.8100000002
"11571",2017-03-08 19:30:42,-70029.81,2.3283064365387e-10
"11572",2017-03-09 01:06:31,42473.48,42473.4800000002
"11573",2017-03-09 01:06:31,38128.72,80602.2000000002
"11574",2017-03-09 01:11:31,-80602.2,2.47382558882236e-10
"11575",2017-03-09 03:10:00,18029.89,18029.8900000002
"11576",2017-03-09 03:34:02,17029.88,35059.7700000003
"11577",2017-03-09 03:34:02,-18029.89,17029.8800000003
"11578",2017-03-09 03:44:49,-17029.88,2.51020537689328e-10
"11579",2017-03-09 08:51:24,8029.93,8029.93000000025
"11580",2017-03-09 08:51:24,7029.92,15059.8500000003
"11581",2017-03-09 08:51:24,70029.86,85089.7100000003
"11582",2017-03-09 08:51:24,75029.87,160119.58
"11583",2017-03-09 08:51:24,29204.48,189324.06
"11584",2017-03-09 08:51:24,32585.43,221909.49
"11585",2017-03-09 08:51:24,32585.43,254494.92
"11586",2017-03-09 08:51:24,13029.94,267524.86
"11587",2017-03-09 09:00:17,-267524.86,2.3283064365387e-10
"11588",2017-03-09 17:24:28,10029.91,10029.9100000002
"11589",2017-03-09 17:34:41,-10029.91,2.3283064365387e-10
"11590",2017-03-09 18:06:52,10029.9,10029.9000000002
"11591",2017-03-09 18:15:30,-10029.9,2.3283064365387e-10
"11592",2017-03-09 21:06:10,80029.95,80029.9500000002
"11593",2017-03-09 21:21:21,70029.96,150059.91
"11594",2017-03-09 21:21:21,-80029.95,70029.9600000002
"11595",2017-03-09 21:38:16,-70029.96,2.3283064365387e-10
"11596",2017-03-10 13:28:38,33071.45,33071.4500000002
"11597",2017-03-10 13:34:22,-33071.45,2.3283064365387e-10
"11598",2017-03-10 17:53:06,38064.3,38064.3000000002
"11599",2017-03-10 18:01:28,46854.67,84918.9700000002
"11600",2017-03-10 18:01:28,-38064.3,46854.6700000002
"11601",2017-03-10 18:05:15,-46854.67,2.3283064365387e-10
"11602",2017-03-10 18:35:29,41816.87,41816.8700000002
"11603",2017-03-10 19:10:13,32520.93,74337.8000000002
"11604",2017-03-10 19:11:24,-41816.87,32520.9300000002
"11605",2017-03-10 19:27:14,41458.85,73979.7800000002
"11606",2017-03-10 19:27:14,-32520.93,41458.8500000002
"11607",2017-03-10 19:27:14,-32520.93,8937.92000000023
"11608",2017-03-10 19:32:29,57011.74,65949.6600000002
"11609",2017-03-10 19:32:29,-8937.92,57011.7400000002
"11610",2017-03-10 19:35:50,-57011.74,2.40106601268053e-10
"11611",2017-03-10 19:58:17,30030.06,30030.0600000002
"11612",2017-03-10 19:58:17,12001.04,42031.1000000002
"11613",2017-03-10 19:58:17,2128.34,44159.4400000002
"11614",2017-03-10 20:09:00,-44159.44,2.3283064365387e-10
"11615",2017-03-10 20:09:00,38918.07,38918.0700000002
"11616",2017-03-10 20:09:00,30030.08,68948.1500000002
"11617",2017-03-10 20:17:11,-68948.15,2.3283064365387e-10
"11618",2017-03-10 21:14:51,22133.28,22133.2800000002
"11619",2017-03-10 21:14:51,32619.62,54752.9000000002
"11620",2017-03-10 21:30:22,-54752.9,2.25554686039686e-10
"11621",2017-03-10 22:22:57,6016.24,6016.24000000023
"11622",2017-03-10 22:37:36,-6016.24,2.25554686039686e-10
"11623",2017-03-11 03:03:21,26249.67,26249.6700000002
"11624",2017-03-11 03:03:21,30870.03,57119.7000000002
"11625",2017-03-11 03:36:03,-57119.7,2.25554686039686e-10
"11626",2017-03-11 09:58:07,8656.65,8656.65000000023
"11627",2017-03-11 10:45:47,-8656.65,2.25554686039686e-10
"11628",2017-03-11 14:05:24,31572.03,31572.0300000002
"11629",2017-03-11 14:05:24,24965.86,56537.8900000002
"11630",2017-03-11 14:09:08,-56537.89,2.25554686039686e-10
"11631",2017-03-11 15:13:27,25544.23,25544.2300000002
"11632",2017-03-11 15:30:42,41784.38,67328.6100000002
"11633",2017-03-11 15:30:42,-25544.23,41784.3800000002
"11634",2017-03-11 15:42:40,-41784.38,2.25554686039686e-10
"11635",2017-03-12 13:53:56,8708.45,8708.45000000023
"11636",2017-03-12 14:07:58,13835.48,22543.9300000002
"11637",2017-03-12 14:07:58,-8708.45,13835.4800000002
"11638",2017-03-12 14:10:37,-13835.48,2.25554686039686e-10
"11639",2017-03-12 16:19:16,11237.55,11237.5500000002
"11640",2017-03-12 16:31:23,23511.08,34748.6300000002
"11641",2017-03-12 16:31:23,-11237.55,23511.0800000002
"11642",2017-03-12 17:06:06,8600.79,32111.8700000002
"11643",2017-03-12 17:06:06,-23511.08,8600.79000000022
"11644",2017-03-12 17:57:40,-8600.79,2.21916707232594e-10
"11645",2017-03-12 18:11:10,30175.15,30175.1500000002
"11646",2017-03-12 18:54:44,51033.41,81208.5600000002
"11647",2017-03-12 19:30:21,28326.45,109535.01
"11648",2017-03-12 19:42:30,-109535.01,2.3283064365387e-10
"11649",2017-03-13 00:06:59,32825.67,32825.6700000002
"11650",2017-03-13 00:26:33,-32825.67,2.3283064365387e-10
"11651",2017-03-13 00:49:41,34371.16,34371.1600000002
"11652",2017-03-13 00:52:51,57952.24,92323.4000000002
"11653",2017-03-13 00:52:51,-34371.16,57952.2400000002
"11654",2017-03-13 01:09:49,22442.71,80394.9500000002
"11655",2017-03-13 01:09:49,-57952.24,22442.7100000002
"11656",2017-03-13 01:27:12,-22442.71,2.18278728425503e-10
"11657",2017-03-13 04:22:05,30505.04,30505.0400000002
"11658",2017-03-13 04:30:51,-30505.04,2.18278728425503e-10
"11659",2017-03-13 06:16:28,74268.14,74268.1400000002
"11660",2017-03-13 06:28:03,-74268.14,2.18278728425503e-10
"11661",2017-03-13 06:53:03,30030.52,30030.5200000002
"11662",2017-03-13 06:59:09,-30030.52,2.18278728425503e-10
"11663",2017-03-13 07:01:28,30030.54,30030.5400000002
"11664",2017-03-13 07:10:25,-30030.54,2.18278728425503e-10
"11665",2017-03-13 07:26:13,12709.3,12709.3000000002
"11666",2017-03-13 07:26:13,30030.56,42739.8600000002
"11667",2017-03-13 07:36:32,-42739.86,2.18278728425503e-10
"11668",2017-03-13 08:00:41,8038.03,8038.03000000022
"11669",2017-03-13 08:11:55,-8038.03,2.18278728425503e-10
"11670",2017-03-13 09:13:38,30030.6,30030.6000000002
"11671",2017-03-13 09:13:38,11512.84,41543.4400000002
"11672",2017-03-13 09:53:17,-41543.44,2.18278728425503e-10
"11673",2017-03-13 10:48:25,37807.62,37807.6200000002
"11674",2017-03-13 10:48:25,7807.59,45615.2100000002
"11675",2017-03-13 11:18:51,-45615.21,2.25554686039686e-10
"11676",2017-03-13 12:01:08,30030.61,30030.6100000002
"11677",2017-03-13 12:15:22,9883.2,39913.8100000002
"11678",2017-03-13 12:15:22,50030.64,89944.4500000002
"11679",2017-03-13 12:15:22,30030.61,119975.06
"11680",2017-03-13 12:15:22,15030.65,135005.71
"11681",2017-03-13 12:15:22,-30030.61,104975.1
"11682",2017-03-13 12:33:44,-104975.1,2.18278728425503e-10
"11683",2017-03-13 13:53:22,30030.61,30030.6100000002
"11684",2017-03-13 14:44:48,-30030.61,2.18278728425503e-10
"11685",2017-03-13 15:04:17,29439.91,29439.9100000002
"11686",2017-03-13 15:13:32,23135.16,52575.0700000002
"11687",2017-03-13 15:13:32,-29439.91,23135.1600000002
"11688",2017-03-13 16:00:16,-23135.16,2.18278728425503e-10
"11689",2017-03-13 18:19:55,22842.54,22842.5400000002
"11690",2017-03-13 18:30:33,-22842.54,2.18278728425503e-10
"11691",2017-03-13 18:52:31,70030.83,70030.8300000002
"11692",2017-03-13 18:52:31,46873.31,116904.14
"11693",2017-03-13 18:57:36,-116904.14,2.18278728425503e-10
"11694",2017-03-13 19:24:46,24422.6,24422.6000000002
"11695",2017-03-13 19:24:46,43971.6,68394.2000000002
"11696",2017-03-13 19:43:21,77807.86,146202.06
"11697",2017-03-13 19:43:21,-68394.2,77807.8600000002
"11698",2017-03-13 19:55:15,23297.32,101105.18
"11699",2017-03-13 19:55:15,-77807.86,23297.3200000002
"11700",2017-03-13 20:03:29,22410.41,45707.7300000002
"11701",2017-03-13 20:03:29,-23297.32,22410.4100000002
"11702",2017-03-13 20:09:50,25625.1,48035.5100000002
"11703",2017-03-13 20:09:50,-22410.41,25625.1000000002
"11704",2017-03-13 20:27:20,-25625.1,2.29192664846778e-10
"11705",2017-03-13 21:01:23,25810.2,25810.2000000002
"11706",2017-03-13 21:01:23,23976.53,49786.7300000002
"11707",2017-03-13 21:08:50,-49786.73,2.25554686039686e-10
"11708",2017-03-13 21:14:00,30864.24,30864.2400000002
"11709",2017-03-13 21:15:34,-30864.24,2.25554686039686e-10
"11710",2017-03-14 00:46:25,27076.97,27076.9700000002
"11711",2017-03-14 00:56:56,-27076.97,2.25554686039686e-10
"11712",2017-03-14 01:15:24,26945.41,26945.4100000002
"11713",2017-03-14 01:15:24,30031.57,56976.9800000002
"11714",2017-03-14 01:19:14,-56976.98,2.25554686039686e-10
"11715",2017-03-14 01:53:24,33457.84,33457.8400000002
"11716",2017-03-14 01:59:52,-33457.84,2.25554686039686e-10
"11717",2017-03-14 02:22:49,23360.04,23360.0400000002
"11718",2017-03-14 02:31:06,-23360.04,2.25554686039686e-10
"11719",2017-03-14 05:43:19,7809.31,7809.31000000023
"11720",2017-03-14 05:43:19,7809.3,15618.6100000002
"11721",2017-03-14 05:43:19,7809.27,23427.8800000002
"11722",2017-03-14 06:02:38,-23427.88,2.25554686039686e-10
"11723",2017-03-14 06:02:38,7809.23,7809.23000000023
"11724",2017-03-14 06:02:38,13809.24,21618.4700000002
"11725",2017-03-14 06:16:38,-21618.47,2.25554686039686e-10
"11726",2017-03-14 10:38:13,25336.98,25336.9800000002
"11727",2017-03-14 10:42:53,29970.44,55307.4200000002
"11728",2017-03-14 10:42:53,-25336.98,29970.4400000002
"11729",2017-03-14 11:32:42,35008.77,64979.2100000002
"11730",2017-03-14 11:32:42,-29970.44,35008.7700000002
"11731",2017-03-14 11:32:42,-29970.44,5038.33000000022
"11732",2017-03-14 11:32:42,59662.91,64701.2400000002
"11733",2017-03-14 11:54:58,-64701.24,2.25554686039686e-10
"11734",2017-03-14 12:24:26,35593.82,35593.8200000002
"11735",2017-03-14 12:43:56,-35593.82,2.25554686039686e-10
"11736",2017-03-14 12:48:49,23873.98,23873.9800000002
"11737",2017-03-14 12:57:26,-23873.98,2.25554686039686e-10
"11738",2017-03-14 21:55:36,23814.71,23814.7100000002
"11739",2017-03-14 21:55:36,23737.97,47552.6800000002
"11740",2017-03-14 22:04:46,-47552.68,2.25554686039686e-10
"11741",2017-03-15 11:40:46,25404.51,25404.5100000002
"11742",2017-03-15 11:46:37,-25404.51,2.25554686039686e-10
"11743",2017-03-15 12:09:11,30452.49,30452.4900000002
"11744",2017-03-15 12:48:27,31226.86,61679.3500000002
"11745",2017-03-15 12:48:27,-30452.49,31226.8600000002
"11746",2017-03-15 12:48:27,-30452.49,774.370000000221
"11747",2017-03-15 13:10:10,-774.37,2.208935256931e-10
"11748",2017-03-15 13:10:10,36399.96,36399.9600000002
"11749",2017-03-15 13:10:10,45049.15,81449.1100000002
"11750",2017-03-15 13:40:48,27445.72,108894.83
"11751",2017-03-15 13:40:48,44647.44,153542.27
"11752",2017-03-15 13:40:48,-774.37,152767.9
"11753",2017-03-15 13:40:48,-81449.11,71318.7900000002
"11754",2017-03-15 13:45:41,-71318.79,2.3283064365387e-10
"11755",2017-03-15 13:52:05,38441.92,38441.9200000002
"11756",2017-03-15 13:52:05,16882.95,55324.8700000002
"11757",2017-03-15 13:52:05,25119.35,80444.2200000002
"11758",2017-03-15 13:56:41,-80444.22,2.3283064365387e-10
"11759",2017-03-15 14:08:35,30033.36,30033.3600000002
"11760",2017-03-15 14:31:36,20783.2,50816.5600000002
"11761",2017-03-15 14:31:36,8788.38,59604.9400000002
"11762",2017-03-15 14:31:36,-30033.36,29571.5800000002
"11763",2017-03-15 14:38:52,-29571.58,2.25554686039686e-10
"11764",2017-03-15 14:38:52,12215.8,12215.8000000002
"11765",2017-03-15 15:03:26,15113.76,27329.5600000002
"11766",2017-03-15 15:03:26,-12215.8,15113.7600000002
"11767",2017-03-15 15:18:32,30033.41,45147.1700000002
"11768",2017-03-15 15:18:32,-15113.76,30033.4100000002
"11769",2017-03-15 15:41:02,8376.23,38409.6400000002
"11770",2017-03-15 15:41:02,-30033.41,8376.23000000022
"11771",2017-03-15 15:55:20,9096.55,17472.7800000002
"11772",2017-03-15 15:55:20,22082.01,39554.7900000002
"11773",2017-03-15 15:55:20,-8376.23,31178.5600000002
"11774",2017-03-15 15:59:50,30033.45,61212.0100000002
"11775",2017-03-15 15:59:50,-31178.56,30033.4500000002
"11776",2017-03-15 16:05:07,-30033.45,2.11002770811319e-10
"11777",2017-03-15 16:29:08,9033.57,9033.57000000021
"11778",2017-03-15 16:29:08,30033.47,39067.0400000002
"11779",2017-03-15 16:33:02,-39067.04,2.11002770811319e-10
"11780",2017-03-15 17:10:15,9562.36,9562.36000000021
"11781",2017-03-15 17:10:15,9733.31,19295.6700000002
"11782",2017-03-15 17:10:15,9649.73,28945.4000000002
"11783",2017-03-15 17:10:15,12459.48,41404.8800000002
"11784",2017-03-15 17:54:55,11985.57,53390.4500000002
"11785",2017-03-15 17:54:55,12760.47,66150.9200000002
"11786",2017-03-15 18:26:10,8236.06,74386.9800000002
"11787",2017-03-15 18:26:48,13269.1,87656.0800000002
"11788",2017-03-15 18:55:41,10555.14,98211.2200000002
"11789",2017-03-15 18:55:41,13426.41,111637.63
"11790",2017-03-15 18:55:41,24518.1,136155.73
"11791",2017-03-15 18:59:14,-136155.73,2.03726813197136e-10
"11792",2017-03-15 22:42:19,33411.1,33411.1000000002
"11793",2017-03-15 22:42:19,44131.76,77542.8600000002
"11794",2017-03-15 23:44:12,-77542.86,2.03726813197136e-10
"11795",2017-03-16 02:40:52,39018.78,39018.7800000002
"11796",2017-03-16 02:40:52,32841.94,71860.7200000002
"11797",2017-03-16 02:40:52,44483.47,116344.19
"11798",2017-03-16 02:45:36,-116344.19,2.03726813197136e-10
"11799",2017-03-16 05:41:33,7810.87,7810.8700000002
"11800",2017-03-16 05:44:01,-7810.87,2.03726813197136e-10
"11801",2017-03-16 05:44:01,8921.86,8921.8600000002
"11802",2017-03-16 05:58:26,-8921.86,2.03726813197136e-10
"11803",2017-03-16 05:58:26,7810.88,7810.8800000002
"11804",2017-03-16 06:08:04,-7810.88,2.03726813197136e-10
"11805",2017-03-16 06:30:23,31114.29,31114.2900000002
"11806",2017-03-16 06:35:20,-31114.29,2.03726813197136e-10
"11807",2017-03-16 07:12:51,42529.05,42529.0500000002
"11808",2017-03-16 07:27:41,18921.91,61450.9600000002
"11809",2017-03-16 07:27:41,44534.63,105985.59
"11810",2017-03-16 07:27:41,42529.05,148514.64
"11811",2017-03-16 07:27:41,30033.9,178548.54
"11812",2017-03-16 07:27:41,31114.29,209662.83
"11813",2017-03-16 08:37:43,40962.76,250625.59
"11814",2017-03-16 08:37:43,80033.93,330659.52
"11815",2017-03-16 13:25:06,97775.8,428435.32
"11816",2017-03-16 13:45:48,21797.83,450233.15
"11817",2017-03-16 13:45:48,42691.08,492924.23
"11818",2017-03-16 13:51:33,32307.45,525231.68
"11819",2017-03-16 14:05:57,13842.81,539074.49
"11820",2017-03-16 14:05:57,54388.63,593463.12
"11821",2017-03-16 14:05:57,38673.68,632136.8
"11822",2017-03-16 14:32:06,46950.28,679087.08
"11823",2017-03-16 14:32:06,11959.92,691047
"11824",2017-03-16 14:46:40,31955.48,723002.48
"11825",2017-03-16 14:46:40,30249,753251.48
"11826",2017-03-16 14:46:40,8647.07,761898.55
"11827",2017-03-16 14:46:40,10647.57,772546.12
"11828",2017-03-16 14:58:14,50341.58,822887.7
"11829",2017-03-16 14:58:14,18999.54,841887.24
"11830",2017-03-16 15:13:27,41201.33,883088.57
"11831",2017-03-16 15:13:27,29830.56,912919.13
"11832",2017-03-16 15:31:39,26899.23,939818.36
"11833",2017-03-16 15:31:39,9403.53,949221.89
"11834",2017-03-16 15:31:39,9468.37,958690.26
"11835",2017-03-16 15:31:39,26324.96,985015.22
"11836",2017-03-16 16:01:35,8018.07,993033.29
"11837",2017-03-16 16:01:35,13336.88,1006370.17
"11838",2017-03-16 16:01:35,19250.43,1025620.6
"11839",2017-03-16 16:01:35,35973.02,1061593.62
"11840",2017-03-16 16:01:35,8253.51,1069847.13
"11841",2017-03-16 17:05:04,31107.52,1100954.65
"11842",2017-03-16 17:05:04,39561.76,1140516.41
"11843",2017-03-16 17:05:04,21974.1,1162490.51
"11844",2017-03-16 17:12:18,17671.65,1180162.16
"11845",2017-03-16 17:12:18,18700.65,1198862.81
"11846",2017-03-16 17:12:18,26877.51,1225740.32
"11847",2017-03-16 17:15:49,10478.26,1236218.58
"11848",2017-03-16 17:25:38,15734.24,1251952.82
"11849",2017-03-16 17:38:07,23038.81,1274991.63
"11850",2017-03-16 18:31:25,24172.6,1299164.23
"11851",2017-03-16 18:31:25,17646.26,1316810.49
"11852",2017-03-16 18:46:34,30176.55,1346987.04
"11853",2017-03-16 18:46:34,41668.58,1388655.62
"11854",2017-03-16 18:57:09,35251.07,1423906.69
"11855",2017-03-16 18:57:09,12619.23,1436525.92
"11856",2017-03-16 18:57:09,26707.14,1463233.06
"11857",2017-03-16 19:08:34,40034.54,1503267.6
"11858",2017-03-16 19:08:34,-1388655.62,114611.98
"11859",2017-03-16 19:55:04,31815.11,146427.09
"11860",2017-03-16 19:55:04,52046.32,198473.41
"11861",2017-03-16 20:20:17,7812.01,206285.42
"11862",2017-03-16 20:20:17,88923.02,295208.44
"11863",2017-03-16 20:57:19,-114611.98,180596.46
"11864",2017-03-16 21:02:39,-114611.98,65984.4800000003
"11865",2017-03-16 21:13:10,52396.49,118380.97
"11866",2017-03-16 21:23:23,90035.05,208416.02
"11867",2017-03-16 21:23:23,99035.06,307451.08
"11868",2017-03-16 21:23:23,33955.04,341406.12
"11869",2017-03-16 21:23:23,-114611.98,226794.14
"11870",2017-03-16 21:23:23,-114611.98,112182.16
"11871",2017-03-16 21:48:11,78927.56,191109.72
"11872",2017-03-16 21:48:11,49715.76,240825.48
"11873",2017-03-16 21:56:19,44808.76,285634.24
"11874",2017-03-16 21:56:19,5107.83,290742.07
"11875",2017-03-16 22:28:33,98035.11,388777.18
"11876",2017-03-16 22:31:38,-388777.18,2.91038304567337e-10
"11877",2017-03-16 23:23:02,40284.74,40284.7400000003
"11878",2017-03-16 23:23:02,98035.13,138319.87
"11879",2017-03-16 23:25:57,-138319.87,2.91038304567337e-10
"11880",2017-03-16 23:51:35,45573.29,45573.2900000003
"11881",2017-03-17 00:22:10,58984.7,104557.99
"11882",2017-03-17 00:22:10,56208.45,160766.44
"11883",2017-03-17 00:22:10,77812.17,238578.61
"11884",2017-03-17 00:24:16,-45573.29,193005.32
"11885",2017-03-17 00:26:19,-193005.32,2.61934474110603e-10
"11886",2017-03-17 00:45:09,49782.93,49782.9300000003
"11887",2017-03-17 00:53:54,-49782.93,2.61934474110603e-10
"11888",2017-03-17 01:01:44,67488.59,67488.5900000003
"11889",2017-03-17 01:01:44,55221.93,122710.52
"11890",2017-03-17 01:10:57,38505.94,161216.46
"11891",2017-03-17 01:10:57,-122710.52,38505.9400000002
"11892",2017-03-17 01:29:28,20285.35,58791.2900000002
"11893",2017-03-17 01:29:28,37901.21,96692.5000000002
"11894",2017-03-17 01:29:28,79189.1,175881.6
"11895",2017-03-17 01:29:28,-38505.94,137375.66
"11896",2017-03-17 01:42:06,25701.53,163077.19
"11897",2017-03-17 01:42:06,-137375.66,25701.5300000003
"11898",2017-03-17 01:47:39,-25701.53,2.61934474110603e-10
"11899",2017-03-17 07:35:27,95665.49,95665.4900000003
"11900",2017-03-17 07:35:27,52069.85,147735.34
"11901",2017-03-17 07:38:38,-147735.34,2.61934474110603e-10
"11902",2017-03-17 07:41:50,38906.92,38906.9200000003
"11903",2017-03-17 07:54:10,-38906.92,2.61934474110603e-10
"11904",2017-03-17 08:20:13,36570.85,36570.8500000003
"11905",2017-03-17 08:20:13,99405.3,135976.15
"11906",2017-03-17 08:27:29,54775.96,190752.11
"11907",2017-03-17 08:27:29,-135976.15,54775.9600000003
"11908",2017-03-17 08:31:52,-54775.96,2.5465851649642e-10
"11909",2017-03-17 08:49:57,93965.71,93965.7100000003
"11910",2017-03-17 08:49:57,35090.86,129056.57
"11911",2017-03-17 09:02:44,-129056.57,2.47382558882236e-10
"11912",2017-03-17 09:33:02,50346.07,50346.0700000002
"11913",2017-03-17 09:35:36,39843.06,90189.1300000002
"11914",2017-03-17 09:35:36,-50346.07,39843.0600000002
"11915",2017-03-17 09:36:52,-39843.06,2.40106601268053e-10
"11916",2017-03-17 10:14:20,31545.03,31545.0300000002
"11917",2017-03-17 10:14:20,39957.25,71502.2800000002
"11918",2017-03-17 10:14:20,16062.62,87564.9000000002
"11919",2017-03-17 10:49:43,-87564.9,2.3283064365387e-10
"11920",2017-03-17 12:15:01,27492.61,27492.6100000002
"11921",2017-03-17 12:15:01,63899.78,91392.3900000002
"11922",2017-03-17 12:15:01,16741.18,108133.57
"11923",2017-03-17 12:15:01,22440.47,130574.04
"11924",2017-03-17 12:26:03,-130574.04,2.47382558882236e-10
"11925",2017-03-17 13:09:34,99815.98,99815.9800000002
"11926",2017-03-17 13:09:34,48777.99,148593.97
"11927",2017-03-17 13:11:16,-148593.97,2.3283064365387e-10
"11928",2017-03-17 13:21:10,31218.01,31218.0100000002
"11929",2017-03-17 13:21:10,99816,131034.01
"11930",2017-03-17 13:24:26,-131034.01,2.3283064365387e-10
"11931",2017-03-17 13:39:56,99816.02,99816.0200000002
"11932",2017-03-17 13:39:56,5328.03,105144.05
"11933",2017-03-17 13:45:14,99816.04,204960.09
"11934",2017-03-17 13:45:14,-105144.05,99816.0400000002
"11935",2017-03-17 14:18:41,35463.22,135279.26
"11936",2017-03-17 14:18:41,8391.05,143670.31
"11937",2017-03-17 14:18:41,35128.78,178799.09
"11938",2017-03-17 14:18:41,16915.39,195714.48
"11939",2017-03-17 14:18:41,31552.07,227266.55
"11940",2017-03-17 14:32:25,19739.7,247006.25
"11941",2017-03-17 14:32:25,41764.93,288771.18
"11942",2017-03-17 14:32:25,22599.38,311370.56
"11943",2017-03-17 14:42:59,21061.36,332431.92
"11944",2017-03-17 14:42:59,-99816.04,232615.88
"11945",2017-03-17 15:07:35,31785.39,264401.27
"11946",2017-03-17 15:07:35,29306.01,293707.28
"11947",2017-03-17 15:14:25,32037.59,325744.87
"11948",2017-03-17 15:14:25,-232615.88,93128.9900000003
"11949",2017-03-17 15:23:09,-93128.99,2.7648638933897e-10
"11950",2017-03-17 15:43:39,47212.57,47212.5700000003
"11951",2017-03-17 15:45:48,-47212.57,2.7648638933897e-10
"11952",2017-03-17 15:49:13,32495.61,32495.6100000003
"11953",2017-03-17 15:50:48,42049.13,74544.7400000003
"11954",2017-03-17 15:50:48,-32495.61,42049.1300000003
"11955",2017-03-17 16:16:47,61556.37,103605.5
"11956",2017-03-17 16:16:47,21936.6,125542.1
"11957",2017-03-17 16:16:47,23258.37,148800.47
"11958",2017-03-17 16:16:47,17843.5,166643.97
"11959",2017-03-17 16:16:47,-42049.13,124594.84
"11960",2017-03-17 16:25:31,-124594.84,2.91038304567337e-10
"11961",2017-03-17 16:40:11,56443.41,56443.4100000003
"11962",2017-03-17 16:40:11,22728.78,79172.1900000003
"11963",2017-03-17 17:14:22,18955.82,98128.0100000003
"11964",2017-03-17 17:14:22,-79172.19,18955.8200000003
"11965",2017-03-17 17:18:57,58535.22,77491.0400000003
"11966",2017-03-17 17:18:57,34461.46,111952.5
"11967",2017-03-17 17:18:57,-18955.82,92996.6800000003
"11968",2017-03-17 17:27:28,42007.24,135003.92
"11969",2017-03-17 17:27:28,54825.29,189829.21
"11970",2017-03-17 17:27:28,-92996.68,96832.5300000003
"11971",2017-03-17 17:41:03,36962.34,133794.87
"11972",2017-03-17 17:41:03,-96832.53,36962.3400000003
"11973",2017-03-17 17:52:33,-36962.34,2.91038304567337e-10
"11974",2017-03-17 17:59:14,38639.74,38639.7400000003
"11975",2017-03-17 17:59:14,33792.62,72432.3600000003
"11976",2017-03-17 18:04:22,-72432.36,2.91038304567337e-10
"11977",2017-03-17 18:06:18,13167.46,13167.4600000003
"11978",2017-03-17 18:38:13,31177.46,44344.9200000003
"11979",2017-03-17 18:38:13,29580.05,73924.9700000003
"11980",2017-03-17 18:38:13,40422.47,114347.44
"11981",2017-03-17 19:05:21,-114347.44,2.91038304567337e-10
"11982",2017-03-17 19:18:53,12252.55,12252.5500000003
"11983",2017-03-17 19:18:53,99816.54,112069.09
"11984",2017-03-17 19:18:53,18690.08,130759.17
"11985",2017-03-17 19:25:03,18041.57,148800.74
"11986",2017-03-17 19:25:03,-130759.17,18041.5700000003
"11987",2017-03-17 19:28:05,-18041.57,2.83762346953154e-10
"11988",2017-03-17 19:42:39,34393.15,34393.1500000003
"11989",2017-03-17 20:13:16,36903.45,71296.6000000003
"11990",2017-03-17 20:13:16,99039.59,170336.19
"11991",2017-03-17 20:13:16,-34393.15,135943.04
"11992",2017-03-17 20:33:34,50039.6,185982.64
"11993",2017-03-17 20:33:34,-135943.04,50039.6000000003
"11994",2017-03-17 20:39:57,-50039.6,2.9831426218152e-10
"11995",2017-03-17 20:56:16,39283.75,39283.7500000003
"11996",2017-03-17 21:09:32,-39283.75,2.9831426218152e-10
"11997",2017-03-17 21:09:32,78116.75,78116.7500000003
"11998",2017-03-17 21:09:32,38098.96,116215.71
"11999",2017-03-17 21:11:17,-116215.71,2.7648638933897e-10
"12000",2017-03-17 21:30:03,67527.91,67527.9100000003
"12001",2017-03-17 21:32:39,-67527.91,2.7648638933897e-10
"12002",2017-03-17 21:57:28,99039.68,99039.6800000003
"12003",2017-03-17 21:57:28,18374.41,117414.09
"12004",2017-03-17 22:37:31,35405.07,152819.16
"12005",2017-03-17 22:37:31,34486.33,187305.49
"12006",2017-03-17 22:39:42,-117414.09,69891.4000000003
"12007",2017-03-17 22:55:17,-69891.4,2.91038304567337e-10
"12008",2017-03-17 22:59:58,41550.13,41550.1300000003
"12009",2017-03-17 22:59:58,5756.82,47306.9500000003
"12010",2017-03-17 23:24:21,44977.59,92284.5400000003
"12011",2017-03-17 23:24:21,-47306.95,44977.5900000003
"12012",2017-03-17 23:28:03,-44977.59,2.91038304567337e-10
"12013",2017-03-18 00:08:16,30077.12,30077.1200000003
"12014",2017-03-18 00:08:16,59139.68,89216.8000000003
"12015",2017-03-18 00:10:52,-89216.8,2.91038304567337e-10
"12016",2017-03-18 00:21:41,54334.02,54334.0200000003
"12017",2017-03-18 00:21:41,50193.23,104527.25
"12018",2017-03-18 00:36:38,37435.74,141962.99
"12019",2017-03-18 00:36:38,48501.34,190464.33
"12020",2017-03-18 00:36:38,42055.25,232519.58
"12021",2017-03-18 00:36:38,-104527.25,127992.33
"12022",2017-03-18 00:50:30,99039.82,227032.15
"12023",2017-03-18 00:50:30,-127992.33,99039.8200000003
"12024",2017-03-18 01:00:13,-99039.82,2.7648638933897e-10
"12025",2017-03-18 01:15:28,33471.93,33471.9300000003
"12026",2017-03-18 01:22:56,-33471.93,2.7648638933897e-10
"12027",2017-03-18 03:11:16,41450.98,41450.9800000003
"12028",2017-03-18 03:17:13,-41450.98,2.7648638933897e-10
"12029",2017-03-18 04:04:33,38536.68,38536.6800000003
"12030",2017-03-18 04:22:36,-38536.68,2.7648638933897e-10
"12031",2017-03-18 04:42:30,46139.22,46139.2200000003
"12032",2017-03-18 04:45:50,-46139.22,2.7648638933897e-10
"12033",2017-03-18 05:04:44,47430.25,47430.2500000003
"12034",2017-03-18 05:07:17,-47430.25,2.7648638933897e-10
"12035",2017-03-18 05:37:57,39699.85,39699.8500000003
"12036",2017-03-18 05:37:57,72629.1,112328.95
"12037",2017-03-18 05:37:57,38403.46,150732.41
"12038",2017-03-18 05:41:48,41475.93,192208.34
"12039",2017-03-18 05:41:48,99816.92,292025.26
"12040",2017-03-18 05:41:48,-47430.25,244595.01
"12041",2017-03-18 05:41:48,-150732.41,93862.6000000002
"12042",2017-03-18 05:45:59,-93862.6,2.3283064365387e-10
"12043",2017-03-18 06:27:06,50921.05,50921.0500000002
"12044",2017-03-18 06:34:25,-50921.05,2.3283064365387e-10
"12045",2017-03-18 06:42:50,39427.89,39427.8900000002
"12046",2017-03-18 07:07:58,-39427.89,2.3283064365387e-10
"12047",2017-03-18 08:09:09,51745.41,51745.4100000002
"12048",2017-03-18 08:09:09,99040,150785.41
"12049",2017-03-18 08:09:09,45838.82,196624.23
"12050",2017-03-18 08:17:06,-196624.23,2.3283064365387e-10
"12051",2017-03-18 08:35:23,23507.97,23507.9700000002
"12052",2017-03-18 08:35:23,37884.21,61392.1800000002
"12053",2017-03-18 08:35:23,60260.62,121652.8
"12054",2017-03-18 08:35:23,99040.05,220692.85
"12055",2017-03-18 08:46:49,-220692.85,2.3283064365387e-10
"12056",2017-03-18 09:12:13,40423.73,40423.7300000002
"12057",2017-03-18 09:23:10,47103.83,87527.5600000002
"12058",2017-03-18 09:23:10,-40423.73,47103.8300000002
"12059",2017-03-18 09:29:32,-47103.83,2.25554686039686e-10
"12060",2017-03-18 10:11:09,99040.1,99040.1000000002
"12061",2017-03-18 10:15:22,-99040.1,2.3283064365387e-10
"12062",2017-03-18 13:53:17,99818.24,99818.2400000002
"12063",2017-03-18 13:53:17,25900.25,125718.49
"12064",2017-03-18 13:54:02,99041.26,224759.75
"12065",2017-03-18 14:00:16,-224759.75,2.3283064365387e-10
"12066",2017-03-18 15:22:53,40508.13,40508.1300000002
"12067",2017-03-18 15:22:53,99041.32,139549.45
"12068",2017-03-18 15:22:53,66777.67,206327.12
"12069",2017-03-18 15:22:53,42622.74,248949.86
"12070",2017-03-18 15:24:32,-248949.86,2.3283064365387e-10
"12071",2017-03-18 16:00:36,56261.56,56261.5600000002
"12072",2017-03-18 16:20:47,54976.71,111238.27
"12073",2017-03-18 16:20:47,44147.86,155386.13
"12074",2017-03-18 16:20:47,64039.33,219425.46
"12075",2017-03-18 16:20:47,-56261.56,163163.9
"12076",2017-03-18 16:49:16,61272.73,224436.63
"12077",2017-03-18 16:49:16,48046.51,272483.14
"12078",2017-03-18 16:49:16,49941.73,322424.87
"12079",2017-03-18 16:49:16,-163163.9,159260.97
"12080",2017-03-18 16:59:40,99041.42,258302.39
"12081",2017-03-18 16:59:40,-159260.97,99041.4200000002
"12082",2017-03-18 17:05:26,-99041.42,2.47382558882236e-10
"12083",2017-03-18 20:28:10,70041.45,70041.4500000002
"12084",2017-03-18 20:29:11,-70041.45,2.47382558882236e-10
"12085",2017-03-18 20:30:33,46191.32,46191.3200000002
"12086",2017-03-18 20:33:31,-46191.32,2.47382558882236e-10
"12087",2017-03-18 21:02:50,38605.52,38605.5200000002
"12088",2017-03-18 21:07:23,-38605.52,2.47382558882236e-10
"12089",2017-03-18 21:21:51,99041.47,99041.4700000002
"12090",2017-03-18 21:36:35,-99041.47,2.47382558882236e-10
"12091",2017-03-18 23:44:47,99041.49,99041.4900000003
"12092",2017-03-18 23:54:06,99041.51,198083
"12093",2017-03-18 23:54:06,-99041.49,99041.5100000002
"12094",2017-03-18 23:54:06,99041.5,198083.01
"12095",2017-03-19 00:05:09,-198083.01,2.3283064365387e-10
"12096",2017-03-19 02:57:30,99818.55,99818.5500000002
"12097",2017-03-19 02:57:30,40290.85,140109.4
"12098",2017-03-19 02:57:30,15971.56,156080.96
"12099",2017-03-19 03:01:58,-156080.96,2.3283064365387e-10
"12100",2017-03-19 03:05:07,55041.59,55041.5900000002
"12101",2017-03-19 03:05:07,99818.58,154860.17
"12102",2017-03-19 03:19:11,-154860.17,2.03726813197136e-10
"12103",2017-03-19 03:48:01,71639.56,71639.5600000002
"12104",2017-03-19 03:54:48,44911.15,116550.71
"12105",2017-03-19 03:54:48,58726,175276.71
"12106",2017-03-19 03:54:48,-71639.56,103637.15
"12107",2017-03-19 04:17:50,-103637.15,2.03726813197136e-10
"12108",2017-03-19 04:53:46,39013.41,39013.4100000002
"12109",2017-03-19 04:53:46,39859.71,78873.1200000002
"12110",2017-03-19 04:53:46,42703.57,121576.69
"12111",2017-03-19 05:00:04,-121576.69,2.03726813197136e-10
"12112",2017-03-19 05:46:49,99041.67,99041.6700000002
"12113",2017-03-19 05:46:49,59873.41,158915.08
"12114",2017-03-19 05:50:35,-158915.08,2.03726813197136e-10
"12115",2017-03-19 06:30:02,19852.57,19852.5700000002
"12116",2017-03-19 06:33:07,-19852.57,2.03726813197136e-10
"12117",2017-03-19 07:39:50,42988.08,42988.0800000002
"12118",2017-03-19 07:43:47,-42988.08,2.03726813197136e-10
"12119",2017-03-19 10:56:48,99041.7,99041.7000000002
"12120",2017-03-19 11:13:25,-99041.7,2.03726813197136e-10
"12121",2017-03-19 12:45:18,38563.85,38563.8500000002
"12122",2017-03-19 12:53:41,-38563.85,2.03726813197136e-10
"12123",2017-03-19 20:53:52,38029.75,38029.7500000002
"12124",2017-03-19 21:08:20,-38029.75,2.03726813197136e-10
"12125",2017-03-19 21:08:20,43024.92,43024.9200000002
"12126",2017-03-19 21:26:10,60766.22,103791.14
"12127",2017-03-19 21:26:10,-43024.92,60766.2200000002
"12128",2017-03-19 21:32:29,-60766.22,2.03726813197136e-10
"12129",2017-03-19 22:08:12,54957.9,54957.9000000002
"12130",2017-03-19 22:08:12,52571.93,107529.83
"12131",2017-03-19 22:08:12,42436.11,149965.94
"12132",2017-03-19 22:15:14,-149965.94,2.03726813197136e-10
"12133",2017-03-20 14:05:54,62735.33,62735.3300000002
"12134",2017-03-20 14:05:54,62981.47,125716.8
"12135",2017-03-20 19:01:27,-125716.8,2.03726813197136e-10
"12136",2017-03-21 01:35:49,48409.75,48409.7500000002
"12137",2017-03-21 01:54:39,56253.16,104662.91
"12138",2017-03-21 02:02:16,-104662.91,2.03726813197136e-10
"12139",2017-03-21 11:53:54,43901.84,43901.8400000002
"12140",2017-03-21 11:57:19,-43901.84,2.03726813197136e-10
"12141",2017-03-21 12:11:25,38112.2,38112.2000000002
"12142",2017-03-21 12:14:07,-38112.2,2.03726813197136e-10
"12143",2017-03-21 12:25:04,47390.39,47390.3900000002
"12144",2017-03-21 12:25:04,34286.33,81676.7200000002
"12145",2017-03-21 12:25:04,59440.32,141117.04
"12146",2017-03-21 12:48:41,92285.49,233402.53
"12147",2017-03-21 13:01:50,-141117.04,92285.4900000002
"12148",2017-03-21 13:02:42,-92285.49,1.89174897968769e-10
"12149",2017-03-21 15:12:05,44988.03,44988.0300000002
"12150",2017-03-21 15:25:35,-44988.03,1.89174897968769e-10
"12151",2017-03-21 19:00:18,39198.81,39198.8100000002
"12152",2017-03-21 19:16:13,-39198.81,1.89174897968769e-10
"12153",2017-03-21 21:33:27,39501.71,39501.7100000002
"12154",2017-03-21 21:33:27,40618.63,80120.3400000002
"12155",2017-03-21 21:41:58,57548.09,137668.43
"12156",2017-03-21 21:41:58,-80120.34,57548.0900000002
"12157",2017-03-21 21:46:05,-57548.09,1.74622982740402e-10
"12158",2017-03-21 22:41:14,60462.49,60462.4900000002
"12159",2017-03-21 22:43:38,-60462.49,1.74622982740402e-10
"12160",2017-03-22 04:57:55,54348.93,54348.9300000002
"12161",2017-03-22 05:05:40,-54348.93,1.74622982740402e-10
"12162",2017-03-22 06:38:12,50976.11,50976.1100000002
"12163",2017-03-22 06:44:25,-50976.11,1.74622982740402e-10
"12164",2017-03-22 07:07:57,67169.73,67169.7300000002
"12165",2017-03-22 07:09:59,-67169.73,1.74622982740402e-10
"12166",2017-03-22 07:31:03,45271.46,45271.4600000002
"12167",2017-03-22 07:41:27,-45271.46,1.74622982740402e-10
"12168",2017-03-22 09:31:34,46385.84,46385.8400000002
"12169",2017-03-22 09:54:07,-46385.84,1.74622982740402e-10
"12170",2017-03-22 12:11:31,50121.5,50121.5000000002
"12171",2017-03-22 12:34:45,47690.06,97811.5600000002
"12172",2017-03-22 12:34:45,51360.18,149171.74
"12173",2017-03-22 12:34:45,-50121.5,99050.2400000002
"12174",2017-03-22 12:37:10,-99050.24,1.60071067512035e-10
"12175",2017-03-22 12:55:01,66995.5,66995.5000000002
"12176",2017-03-22 12:58:26,-66995.5,1.60071067512035e-10
"12177",2017-03-22 23:09:53,66791.41,66791.4100000002
"12178",2017-03-22 23:16:04,-66791.41,1.60071067512035e-10
"12179",2017-03-22 23:33:50,52187.88,52187.8800000002
"12180",2017-03-22 23:38:49,-52187.88,1.60071067512035e-10
"12181",2017-03-23 16:51:06,46609.12,46609.1200000002
"12182",2017-03-23 17:02:46,-46609.12,1.60071067512035e-10
"12183",2017-03-23 21:44:55,50560.42,50560.4200000002
"12184",2017-03-23 21:49:50,-50560.42,1.60071067512035e-10
"12185",2017-03-23 21:56:46,60152.53,60152.5300000002
"12186",2017-03-23 22:05:08,-60152.53,1.60071067512035e-10
"12187",2017-03-23 22:12:37,61369.73,61369.7300000002
"12188",2017-03-23 22:19:24,64349.62,125719.35
"12189",2017-03-23 22:19:24,-61369.73,64349.6200000002
"12190",2017-03-23 22:43:32,-64349.62,1.60071067512035e-10
"12191",2017-03-23 22:48:21,44660.08,44660.0800000002
"12192",2017-03-23 23:05:54,-44660.08,1.60071067512035e-10
"12193",2017-03-24 13:34:17,113099.08,113099.08
"12194",2017-03-24 13:37:22,-113099.08,1.60071067512035e-10
"12195",2017-03-24 14:23:29,56343.12,56343.1200000002
"12196",2017-03-24 14:25:58,-56343.12,1.60071067512035e-10
"12197",2017-03-24 14:29:08,76425.03,76425.0300000002
"12198",2017-03-24 14:35:00,-76425.03,1.60071067512035e-10
"12199",2017-03-24 15:23:33,48253.75,48253.7500000002
"12200",2017-03-24 15:26:10,-48253.75,1.60071067512035e-10
"12201",2017-03-24 16:02:03,73216.28,73216.2800000002
"12202",2017-03-24 16:08:27,80433.61,153649.89
"12203",2017-03-24 16:08:27,-73216.28,80433.6100000002
"12204",2017-03-24 16:13:16,-80433.61,1.60071067512035e-10
"12205",2017-03-24 16:46:53,52184,52184.0000000002
"12206",2017-03-24 16:56:04,51918.84,104102.84
"12207",2017-03-24 16:56:04,-52184,51918.8400000002
"12208",2017-03-24 16:59:47,-51918.84,1.60071067512035e-10
"12209",2017-03-24 17:24:56,46006.77,46006.7700000002
"12210",2017-03-24 17:41:46,-46006.77,1.60071067512035e-10
"12211",2017-03-24 21:31:32,58008.83,58008.8300000002
"12212",2017-03-24 21:42:20,45948.92,103957.75
"12213",2017-03-24 21:42:20,-58008.83,45948.9200000002
"12214",2017-03-24 21:46:28,-45948.92,1.60071067512035e-10
"12215",2017-03-24 21:59:12,50368.47,50368.4700000002
"12216",2017-03-24 21:59:12,44954.81,95323.2800000002
"12217",2017-03-24 22:07:37,65308.7,160631.98
"12218",2017-03-24 22:07:37,-95323.28,65308.7000000002
"12219",2017-03-24 22:11:44,-65308.7,1.60071067512035e-10
"12220",2017-03-24 22:43:09,87617.7,87617.7000000002
"12221",2017-03-24 22:43:09,75728.74,163346.44
"12222",2017-03-24 22:43:09,100042.76,263389.2
"12223",2017-03-24 22:50:53,-263389.2,1.74622982740402e-10
"12224",2017-03-24 23:26:03,62513.9,62513.9000000002
"12225",2017-03-24 23:26:03,70546.34,133060.24
"12226",2017-03-24 23:55:13,100042.81,233103.05
"12227",2017-03-24 23:55:13,100042.8,333145.85
"12228",2017-03-24 23:55:13,48377.33,381523.18
"12229",2017-03-24 23:55:13,-133060.24,248462.94
"12230",2017-03-25 00:00:13,-248462.94,1.74622982740402e-10
"12231",2017-03-25 17:50:14,58391.01,58391.0100000002
"12232",2017-03-25 17:54:56,-58391.01,1.74622982740402e-10
"12233",2017-03-25 18:00:16,80659.27,80659.2700000002
"12234",2017-03-25 18:08:59,-80659.27,1.74622982740402e-10
"12235",2017-03-25 19:25:12,55219.1,55219.1000000002
"12236",2017-03-25 19:56:51,-55219.1,1.74622982740402e-10
"12237",2017-03-25 20:19:59,53998.53,53998.5300000002
"12238",2017-03-25 20:27:37,-53998.53,1.74622982740402e-10
"12239",2017-03-25 20:40:18,50373.16,50373.1600000002
"12240",2017-03-25 21:09:39,45003.27,95376.4300000002
"12241",2017-03-25 21:09:39,-50373.16,45003.2700000002
"12242",2017-03-25 21:11:47,-45003.27,1.67347025126219e-10
"12243",2017-03-25 21:25:45,55473.12,55473.1200000002
"12244",2017-03-25 21:33:55,-55473.12,1.67347025126219e-10
"12245",2017-03-25 22:08:49,60356.07,60356.0700000002
"12246",2017-03-25 22:12:57,-60356.07,1.67347025126219e-10
"12247",2017-03-27 01:44:24,92429.64,92429.6400000002
"12248",2017-03-27 02:26:10,-92429.64,1.60071067512035e-10
"1",2017-03-27 08:09:55,72976.36229315,72976.3622931502
"2",2017-03-27 08:11:22,-72976.36229315,1.60071067512035e-10
"12249",2017-03-27 12:54:30,74327.67,74327.6700000002
"12250",2017-03-27 13:05:22,-74327.67,1.60071067512035e-10
"12251",2017-03-27 13:15:05,67705.55,67705.5500000002
"12252",2017-03-27 13:46:31,86036.84,153742.39
"12253",2017-03-27 13:46:31,80253.11,233995.5
"12254",2017-03-27 13:46:31,-67705.55,166289.95
"12255",2017-03-27 13:54:15,-166289.95,1.74622982740402e-10
"12256",2017-03-27 14:37:48,74522.28,74522.2800000002
"12257",2017-03-27 14:47:42,70565.1,145087.38
"12258",2017-03-27 14:47:42,-74522.28,70565.1000000002
"12259",2017-03-27 15:09:01,-70565.1,1.74622982740402e-10
"12260",2017-03-27 18:00:17,89897.08,89897.0800000002
"12261",2017-03-27 18:00:17,92576.65,182473.73
"12262",2017-03-27 18:21:27,-182473.73,1.45519152283669e-10
"3",2017-03-28 09:54:23,4910.5,4910.50000000015
"4",2017-03-28 10:03:41,-4910.5,1.45519152283669e-10
"5",2017-03-28 12:35:02,4766.07,4766.07000000015
"6",2017-03-28 12:46:54,-4766.07,1.45519152283669e-10
"12263",2017-03-28 20:03:17,68478.44,68478.4400000001
"12264",2017-03-28 20:03:17,105713.63,174192.07
"12265",2017-03-28 20:20:03,-174192.07,1.45519152283669e-10
"12266",2017-03-29 01:18:06,67698.67,67698.6700000001
"12267",2017-03-29 01:26:35,-67698.67,1.45519152283669e-10
"12268",2017-03-29 03:05:34,91107.49,91107.4900000002
"12269",2017-03-29 03:07:37,-91107.49,1.45519152283669e-10
"12270",2017-03-29 07:36:46,70330.65,70330.6500000001
"12271",2017-03-29 07:59:38,-70330.65,1.45519152283669e-10
"7",2017-03-29 18:29:53,4700.7,4700.70000000015
"8",2017-03-29 18:38:13,-4700.7,1.45519152283669e-10
"12272",2017-03-29 20:01:19,77514.91,77514.9100000001
"12273",2017-03-29 20:07:11,-77514.91,1.45519152283669e-10
"12274",2017-03-29 20:07:11,67296.39,67296.3900000001
"12275",2017-03-29 20:10:08,-67296.39,1.45519152283669e-10
"12276",2017-03-29 21:19:16,57189.53,57189.5300000001
"12277",2017-03-29 21:45:08,63314.8,120504.33
"12278",2017-03-29 21:45:08,82824.57,203328.9
"12279",2017-03-29 21:45:08,73759.07,277087.97
"12280",2017-03-29 21:45:08,-57189.53,219898.44
"12281",2017-03-29 22:03:02,4874.51,224772.95
"12282",2017-03-29 22:03:02,-219898.44,4874.51000000015
"12283",2017-03-29 22:14:13,56377.65,61252.1600000002
"12284",2017-03-29 22:14:13,-4874.51,56377.6500000002
"12285",2017-03-29 22:18:03,-56377.65,1.52795109897852e-10
"12286",2017-03-29 23:05:37,27405.79,27405.7900000002
"12287",2017-03-29 23:05:37,19996.12,47401.9100000001
"12288",2017-03-29 23:10:01,23093.71,70495.6200000001
"12289",2017-03-29 23:10:01,-47401.91,23093.7100000001
"12290",2017-03-29 23:13:56,27774.72,50868.4300000001
"12291",2017-03-29 23:13:56,-23093.71,27774.7200000001
"12292",2017-03-29 23:36:34,-27774.72,1.38243194669485e-10
"12293",2017-03-30 00:57:08,27259.68,27259.6800000001
"12294",2017-03-30 00:57:08,23426.37,50686.0500000001
"12295",2017-03-30 01:06:08,-50686.05,1.30967237055302e-10
"12296",2017-03-30 01:49:53,22407.02,22407.0200000001
"12297",2017-03-30 01:54:36,-22407.02,1.30967237055302e-10
"12298",2017-03-30 02:14:30,20782.84,20782.8400000001
"12299",2017-03-30 02:29:03,-20782.84,1.30967237055302e-10
"12300",2017-03-30 03:50:54,42348.74,42348.7400000001
"12301",2017-03-30 03:55:38,-42348.74,1.30967237055302e-10
"12302",2017-03-30 12:36:11,58311.01,58311.0100000001
"12303",2017-03-30 12:57:00,-58311.01,1.30967237055302e-10
"9",2017-03-31 12:06:20,7478.96,7478.96000000013
"10",2017-03-31 12:17:36,-7478.96,1.30967237055302e-10
"11",2017-03-31 15:52:50,5395.48,5395.48000000013
"12",2017-03-31 16:04:26,-5395.48,1.30967237055302e-10
"13",2017-03-31 16:59:27,4927.56,4927.56000000013
"14",2017-03-31 17:19:04,-4927.56,1.30967237055302e-10
"12304",2017-04-01 02:00:57,56292.24,56292.2400000001
"12305",2017-04-01 02:03:29,-56292.24,1.30967237055302e-10
"12306",2017-04-01 05:41:25,69966.04,69966.0400000001
"12307",2017-04-01 05:58:06,-69966.04,1.30967237055302e-10
"12308",2017-04-01 09:21:44,56028.06,56028.0600000001
"12309",2017-04-01 09:27:08,-56028.06,1.30967237055302e-10
"12310",2017-04-01 09:55:54,66032.4,66032.4000000001
"12311",2017-04-01 10:09:01,-66032.4,1.30967237055302e-10
"12312",2017-04-01 10:36:34,56188.24,56188.2400000001
"12313",2017-04-01 11:08:49,-56188.24,1.30967237055302e-10
"15",2017-04-02 06:47:47,4442.88,4442.88000000013
"16",2017-04-02 07:13:00,-4442.88,1.30967237055302e-10
"12314",2017-04-02 12:29:10,67472.9,67472.9000000001
"12315",2017-04-02 12:39:13,-67472.9,1.30967237055302e-10
"12316",2017-04-02 13:27:34,67082.4,67082.4000000001
"12317",2017-04-02 13:36:43,-67082.4,1.30967237055302e-10
"12318",2017-04-02 14:10:20,68492.2,68492.2000000001
"12319",2017-04-02 14:26:39,69454.94,137947.14
"12320",2017-04-02 14:26:39,79079.18,217026.32
"12321",2017-04-02 14:26:39,-68492.2,148534.12
"12322",2017-04-02 14:26:39,68687.14,217221.26
"12323",2017-04-02 14:42:37,70160.58,287381.84
"12324",2017-04-02 14:42:37,-217221.26,70160.5800000001
"12325",2017-04-02 15:14:38,69634.11,139794.69
"12326",2017-04-02 15:14:38,-70160.58,69634.1100000001
"12327",2017-04-02 15:26:55,-69634.11,1.16415321826935e-10
"12328",2017-04-02 15:26:55,70772.08,70772.0800000001
"12329",2017-04-02 15:40:11,-70772.08,1.16415321826935e-10
"12330",2017-04-02 17:16:08,74016.07,74016.0700000001
"12331",2017-04-02 17:32:08,78514.18,152530.25
"12332",2017-04-02 17:46:44,67867.92,220398.17
"12333",2017-04-02 17:46:44,-152530.25,67867.9200000001
"12334",2017-04-02 18:11:09,-67867.92,1.01863406598568e-10
"12335",2017-04-02 18:34:11,108241.97,108241.97
"12336",2017-04-02 19:01:14,68793.22,177035.19
"12337",2017-04-02 19:18:05,87078.21,264113.4
"12338",2017-04-02 19:18:05,-177035.19,87078.2100000001
"12339",2017-04-02 19:21:12,-87078.21,1.30967237055302e-10
"12340",2017-04-02 19:31:58,67714.66,67714.6600000001
"12341",2017-04-02 19:36:40,-67714.66,1.30967237055302e-10
"12342",2017-04-02 21:14:51,157161.09,157161.09
"12343",2017-04-02 21:25:45,-157161.09,1.45519152283669e-10
"12344",2017-04-02 22:00:16,74754.85,74754.8500000002
"12345",2017-04-02 22:13:56,127390.39,202145.24
"12346",2017-04-02 22:13:56,-74754.85,127390.39
"12347",2017-04-02 22:18:40,-127390.39,1.60071067512035e-10
"12348",2017-04-03 00:41:16,70571.08,70571.0800000002
"12349",2017-04-03 00:50:24,-70571.08,1.60071067512035e-10
"17",2017-04-03 01:03:41,4493.54,4493.54000000016
"18",2017-04-03 01:08:34,-4493.54,1.60071067512035e-10
"12350",2017-04-03 01:23:12,67675.11,67675.1100000002
"12351",2017-04-03 01:27:45,-67675.11,1.60071067512035e-10
"12352",2017-04-03 03:12:40,89717.57,89717.5700000002
"12353",2017-04-03 03:28:08,-89717.57,1.60071067512035e-10
"12354",2017-04-03 04:19:34,69580.82,69580.8200000002
"12355",2017-04-03 04:22:39,-69580.82,1.60071067512035e-10
"12356",2017-04-03 04:41:35,75132.45,75132.4500000002
"12357",2017-04-03 04:44:45,-75132.45,1.60071067512035e-10
"12358",2017-04-03 04:58:44,71201.21,71201.2100000002
"12359",2017-04-03 05:02:44,-71201.21,1.60071067512035e-10
"12360",2017-04-03 06:16:12,69394.86,69394.8600000002
"12361",2017-04-03 06:42:45,-69394.86,1.60071067512035e-10
"12362",2017-04-03 08:09:42,68785.56,68785.5600000002
"12363",2017-04-03 08:19:41,-68785.56,1.60071067512035e-10
"12364",2017-04-03 08:34:25,72351.43,72351.4300000002
"12365",2017-04-03 08:36:38,-72351.43,1.60071067512035e-10
"12366",2017-04-03 15:36:37,264075.82,264075.82
"12367",2017-04-03 15:53:10,-264075.82,1.74622982740402e-10
"19",2017-04-03 19:53:53,4466.39,4466.39000000017
"20",2017-04-03 19:59:23,-4466.39,1.74622982740402e-10
"12368",2017-04-03 22:41:17,67366.27,67366.2700000002
"12369",2017-04-03 22:41:17,67649.68,135015.95
"12370",2017-04-03 23:06:14,-135015.95,1.74622982740402e-10
"12371",2017-04-04 00:03:13,77697.66,77697.6600000002
"12372",2017-04-04 00:13:49,-77697.66,1.74622982740402e-10
"12373",2017-04-04 01:53:21,82647.32,82647.3200000002
"12374",2017-04-04 02:03:29,-82647.32,1.74622982740402e-10
"12375",2017-04-04 02:28:44,93614.14,93614.1400000002
"12376",2017-04-04 02:53:36,-93614.14,1.74622982740402e-10
"21",2017-04-04 03:20:08,4697.2,4697.20000000017
"12377",2017-04-04 03:20:08,68626.35,73323.5500000002
"22",2017-04-04 03:22:32,-4697.2,68626.3500000002
"12378",2017-04-04 03:22:32,-68626.35,1.74622982740402e-10
"12379",2017-04-04 03:26:47,81872.27,81872.2700000002
"12380",2017-04-04 03:45:52,-81872.27,1.74622982740402e-10
"12381",2017-04-04 12:52:53,103025.17,103025.17
"12382",2017-04-04 13:02:07,-103025.17,1.74622982740402e-10
"12383",2017-04-04 13:19:46,69821.83,69821.8300000002
"12384",2017-04-04 13:24:24,-69821.83,1.74622982740402e-10
"23",2017-04-04 21:20:18,4105.79,4105.79000000017
"24",2017-04-04 21:34:35,-4105.79,1.74622982740402e-10
"12385",2017-04-06 03:48:21,71035.79,71035.7900000002
"12386",2017-04-06 04:10:06,-71035.79,1.74622982740402e-10
"12387",2017-04-06 06:53:03,92224.46,92224.4600000002
"12388",2017-04-06 06:58:20,-92224.46,1.74622982740402e-10
"12389",2017-04-06 08:20:16,84654.88,84654.8800000002
"12390",2017-04-06 08:22:54,-84654.88,1.74622982740402e-10
"12391",2017-04-06 10:53:36,70419.03,70419.0300000002
"12392",2017-04-06 10:55:56,-70419.03,1.74622982740402e-10
"12393",2017-04-06 11:59:42,72159.17,72159.1700000002
"12394",2017-04-06 12:09:10,-72159.17,1.74622982740402e-10
"12395",2017-04-06 12:34:16,74803.25,74803.2500000002
"12396",2017-04-06 12:48:55,-74803.25,1.74622982740402e-10
"25",2017-04-06 21:30:24,4789.18,4789.18000000017
"26",2017-04-06 21:30:24,8290.75,13079.9300000002
"27",2017-04-06 21:33:50,-8290.75,4789.18000000017
"28",2017-04-06 21:33:50,-4789.18,1.74622982740402e-10
"29",2017-04-07 01:28:35,4194.27,4194.27000000018
"30",2017-04-07 01:40:13,-4194.27,1.74622982740402e-10
"31",2017-04-07 06:02:59,4992.97,4992.97000000017
"32",2017-04-07 06:10:59,-4992.97,1.74622982740402e-10
"33",2017-04-07 16:17:50,5060.26,5060.26000000017
"34",2017-04-07 16:24:32,-5060.26,1.74622982740402e-10
"12397",2017-04-07 19:30:16,54690.32,54690.3200000002
"12398",2017-04-07 19:30:16,50613.86,105304.18
"12399",2017-04-07 19:34:34,-105304.18,1.74622982740402e-10
"12400",2017-04-07 19:34:34,84153.39,84153.3900000002
"12401",2017-04-07 19:43:50,69013.71,153167.1
"12402",2017-04-07 19:43:50,-84153.39,69013.7100000002
"12403",2017-04-07 19:43:50,1045.7,70059.4100000002
"12404",2017-04-07 19:47:50,-70059.41,1.74622982740402e-10
"12405",2017-04-07 21:54:26,66030.1,66030.1000000002
"12406",2017-04-07 22:09:33,-66030.1,1.74622982740402e-10
"12407",2017-04-08 01:01:04,68359.57,68359.5700000002
"12408",2017-04-08 01:19:45,-68359.57,1.74622982740402e-10
"12409",2017-04-08 01:36:01,77643.93,77643.9300000002
"12410",2017-04-08 01:47:29,-77643.93,1.74622982740402e-10
"12411",2017-04-08 03:44:03,79307.03,79307.0300000002
"12412",2017-04-08 03:50:19,-79307.03,1.74622982740402e-10
"35",2017-04-08 04:03:49,4067.02,4067.02000000017
"36",2017-04-08 04:31:24,-4067.02,1.74622982740402e-10
"12413",2017-04-08 18:31:58,67418.7,67418.7000000002
"12414",2017-04-08 19:17:58,-67418.7,1.74622982740402e-10
"12415",2017-04-09 07:18:07,83498.1,83498.1000000002
"12416",2017-04-09 07:27:40,-83498.1,1.74622982740402e-10
"12417",2017-04-09 07:53:08,68491.82,68491.8200000002
"12418",2017-04-09 07:59:47,-68491.82,1.74622982740402e-10
"12419",2017-04-09 22:45:45,71688.46,71688.4600000002
"12420",2017-04-09 22:50:00,-71688.46,1.74622982740402e-10
"12421",2017-04-09 23:01:12,83033.87,83033.8700000002
"12422",2017-04-09 23:05:45,-83033.87,1.74622982740402e-10
"12423",2017-04-09 23:25:59,69789.97,69789.9700000002
"12424",2017-04-09 23:56:59,-69789.97,1.74622982740402e-10
"12425",2017-04-10 00:48:18,70160.39,70160.3900000002
"12426",2017-04-10 01:03:44,-70160.39,1.74622982740402e-10
"12427",2017-04-10 02:01:47,73935.95,73935.9500000002
"12428",2017-04-10 02:09:01,-73935.95,1.74622982740402e-10
"12429",2017-04-10 08:34:43,67299.61,67299.6100000002
"12430",2017-04-10 08:42:54,-67299.61,1.74622982740402e-10
"12431",2017-04-10 09:44:31,69171.18,69171.1800000002
"12432",2017-04-10 09:50:14,-69171.18,1.74622982740402e-10
"12433",2017-04-10 16:54:50,35096.19,35096.1900000002
"12434",2017-04-10 17:01:35,-35096.19,1.74622982740402e-10
"12435",2017-04-10 19:32:04,41024.4,41024.4000000002
"12436",2017-04-10 19:41:46,-41024.4,1.74622982740402e-10
"12437",2017-04-10 19:41:46,25951.91,25951.9100000002
"12438",2017-04-10 19:53:14,-25951.91,1.74622982740402e-10
"12439",2017-04-10 22:04:13,23808.12,23808.1200000002
"12440",2017-04-10 22:11:38,39931.31,63739.4300000002
"12441",2017-04-10 22:11:38,-23808.12,39931.3100000002
"12442",2017-04-10 22:17:20,-39931.31,1.74622982740402e-10
"12443",2017-04-10 22:49:03,24669.82,24669.8200000002
"12444",2017-04-10 22:58:05,25462.76,50132.5800000002
"12445",2017-04-10 22:58:05,-24669.82,25462.7600000002
"12446",2017-04-10 22:58:05,-24669.82,792.940000000177
"12447",2017-04-10 23:04:12,-792.94,1.76896719494835e-10
"12448",2017-04-11 00:44:04,25593.62,25593.6200000002
"12449",2017-04-11 00:44:04,23655.23,49248.8500000002
"12450",2017-04-11 00:44:04,26246.08,75494.9300000002
"12451",2017-04-11 00:49:31,-75494.93,1.89174897968769e-10
"12452",2017-04-11 01:31:05,24114.86,24114.8600000002
"12453",2017-04-11 01:37:16,-24114.86,1.89174897968769e-10
"12454",2017-04-11 04:11:38,25508.8,25508.8000000002
"12455",2017-04-11 04:15:54,-25508.8,1.89174897968769e-10
"12456",2017-04-11 04:19:55,26586.69,26586.6900000002
"12457",2017-04-11 04:36:44,-26586.69,1.89174897968769e-10
"12458",2017-04-11 04:48:24,27233.93,27233.9300000002
"12459",2017-04-11 04:55:36,-27233.93,1.89174897968769e-10
"12460",2017-04-11 05:46:22,24389.27,24389.2700000002
"12461",2017-04-11 06:22:12,24775.55,49164.8200000002
"12462",2017-04-11 06:51:24,-49164.82,1.89174897968769e-10
"12463",2017-04-11 07:04:21,29203.23,29203.2300000002
"12464",2017-04-11 07:27:24,25474.83,54678.0600000002
"12465",2017-04-11 07:27:24,29771.86,84449.9200000002
"12466",2017-04-11 07:27:24,-29203.23,55246.6900000002
"12467",2017-04-11 07:27:24,-29203.23,26043.4600000002
"12468",2017-04-11 07:32:53,23576.55,49620.0100000002
"12469",2017-04-11 07:32:53,-26043.46,23576.5500000002
"12470",2017-04-11 07:42:53,-23576.55,1.92812876775861e-10
"12471",2017-04-11 08:11:36,24375.55,24375.5500000002
"12472",2017-04-11 08:11:36,24023.65,48399.2000000002
"12473",2017-04-11 08:19:07,31529.68,79928.8800000002
"12474",2017-04-11 08:19:07,-48399.2,31529.6800000002
"12475",2017-04-11 08:23:56,-31529.68,1.96450855582952e-10
"12476",2017-04-11 08:43:30,27747.71,27747.7100000002
"12477",2017-04-11 08:54:33,-27747.71,1.96450855582952e-10
"12478",2017-04-11 09:04:29,27136.78,27136.7800000002
"12479",2017-04-11 09:04:29,39306.63,66443.4100000002
"12480",2017-04-11 09:39:19,44939.88,111383.29
"12481",2017-04-11 09:39:19,27131.54,138514.83
"12482",2017-04-11 09:39:19,33862.45,172377.28
"12483",2017-04-11 09:39:19,50047.28,222424.56
"12484",2017-04-11 09:39:19,41999.92,264424.48
"12485",2017-04-11 09:39:19,-66443.41,197981.07
"12486",2017-04-11 09:43:16,-197981.07,2.03726813197136e-10
"12487",2017-04-11 10:24:07,74050.87,74050.8700000002
"12488",2017-04-11 10:24:07,77824.3,151875.17
"12489",2017-04-11 10:27:49,-151875.17,2.03726813197136e-10
"12490",2017-04-11 12:42:13,23687.14,23687.1400000002
"12491",2017-04-11 12:50:45,-23687.14,2.03726813197136e-10
"12492",2017-04-11 13:48:57,27395.91,27395.9100000002
"12493",2017-04-11 14:23:23,24591.85,51987.7600000002
"12494",2017-04-11 14:23:23,-27395.91,24591.8500000002
"12495",2017-04-11 14:31:40,-24591.85,2.00088834390044e-10
"12496",2017-04-11 15:44:36,33111.97,33111.9700000002
"12497",2017-04-11 15:44:36,71144.13,104256.1
"12498",2017-04-11 15:58:03,-104256.1,2.03726813197136e-10
"37",2017-04-11 16:33:02,5644.53,5644.5300000002
"38",2017-04-11 16:35:17,-5644.53,2.03726813197136e-10
"39",2017-04-11 19:33:23,7848.39,7848.3900000002
"12499",2017-04-11 19:33:23,44868.21,52716.6000000002
"40",2017-04-11 19:45:52,-7848.39,44868.2100000002
"12500",2017-04-11 19:45:52,-44868.21,2.03726813197136e-10
"12501",2017-04-11 22:37:01,47338.8,47338.8000000002
"12502",2017-04-11 22:56:21,-47338.8,2.03726813197136e-10
"12503",2017-04-12 00:55:25,55057.4,55057.4000000002
"12504",2017-04-12 01:02:34,-55057.4,2.03726813197136e-10
"12505",2017-04-12 01:45:02,62802.47,62802.4700000002
"12506",2017-04-12 01:48:51,-62802.47,2.03726813197136e-10
"12507",2017-04-12 03:21:50,72454,72454.0000000002
"12508",2017-04-12 03:25:26,-72454,2.03726813197136e-10
"12509",2017-04-12 04:42:13,66768.17,66768.1700000002
"12510",2017-04-12 04:55:05,-66768.17,2.03726813197136e-10
"12511",2017-04-12 05:25:05,67730.21,67730.2100000002
"12512",2017-04-12 05:29:10,-67730.21,2.03726813197136e-10
"12513",2017-04-12 07:28:54,53368.41,53368.4100000002
"12514",2017-04-12 07:28:54,66006.78,119375.19
"12515",2017-04-12 07:38:04,-119375.19,2.03726813197136e-10
"12516",2017-04-12 08:01:31,55868.74,55868.7400000002
"12517",2017-04-12 08:06:03,-55868.74,2.03726813197136e-10
"12518",2017-04-12 10:44:18,83360.97,83360.9700000002
"12519",2017-04-12 11:00:32,-83360.97,2.03726813197136e-10
"12520",2017-04-12 11:10:28,54298.75,54298.7500000002
"12521",2017-04-12 11:16:28,-54298.75,2.03726813197136e-10
"12522",2017-04-12 11:51:00,25179.6,25179.6000000002
"12523",2017-04-12 11:58:49,-25179.6,2.03726813197136e-10
"12524",2017-04-12 14:26:36,40362.74,40362.7400000002
"12525",2017-04-12 14:26:36,3832.28,44195.0200000002
"12526",2017-04-12 14:26:36,74865.31,119060.33
"12527",2017-04-12 14:30:23,-119060.33,1.89174897968769e-10
"12528",2017-04-12 15:30:51,29914.89,29914.8900000002
"12529",2017-04-12 15:59:09,-29914.89,1.89174897968769e-10
"12530",2017-04-12 16:17:37,74879.67,74879.6700000002
"12531",2017-04-12 16:21:53,-74879.67,1.89174897968769e-10
"12532",2017-04-12 19:49:33,38948.67,38948.6700000002
"12533",2017-04-12 19:49:33,39363.53,78312.2000000002
"12534",2017-04-12 19:49:33,25673.57,103985.77
"12535",2017-04-12 19:56:25,56907.62,160893.39
"12536",2017-04-12 19:56:25,-103985.77,56907.6200000002
"12537",2017-04-12 19:59:54,41459.2,98366.8200000002
"12538",2017-04-12 19:59:54,-56907.62,41459.2000000002
"12539",2017-04-12 20:19:24,42771.32,84230.5200000002
"12540",2017-04-12 20:19:24,-41459.2,42771.3200000002
"12541",2017-04-12 20:19:24,-41459.2,1312.12000000018
"12542",2017-04-12 20:28:36,-1312.12,1.84627424459904e-10
"12543",2017-04-12 20:31:33,62444.39,62444.3900000002
"12544",2017-04-12 20:45:57,-62444.39,1.81898940354586e-10
"12545",2017-04-12 22:19:54,53947.16,53947.1600000002
"12546",2017-04-12 22:22:43,-53947.16,1.81898940354586e-10
"12547",2017-04-12 22:39:18,28027.35,28027.3500000002
"12548",2017-04-12 23:07:25,-28027.35,1.81898940354586e-10
"12549",2017-04-13 00:05:18,42140.67,42140.6700000002
"12550",2017-04-13 00:32:06,-42140.67,1.81898940354586e-10
"12551",2017-04-13 02:59:50,56954.14,56954.1400000002
"12552",2017-04-13 03:07:27,-56954.14,1.81898940354586e-10
"12553",2017-04-13 03:53:07,54611.93,54611.9300000002
"12554",2017-04-13 04:02:13,-54611.93,1.81898940354586e-10
"12555",2017-04-13 07:09:11,94390.9,94390.9000000002
"12556",2017-04-13 07:14:18,-94390.9,1.74622982740402e-10
"12557",2017-04-13 07:36:00,67482.87,67482.8700000002
"12558",2017-04-13 07:42:10,24905.87,92388.7400000002
"12559",2017-04-13 07:42:10,-67482.87,24905.8700000002
"12560",2017-04-13 08:08:39,-24905.87,1.70985003933311e-10
"12561",2017-04-13 08:34:35,67467.33,67467.3300000002
"12562",2017-04-13 08:39:44,-67467.33,1.74622982740402e-10
"12563",2017-04-13 11:24:41,71823.11,71823.1100000002
"12564",2017-04-13 11:29:53,-71823.11,1.74622982740402e-10
"12565",2017-04-13 11:59:30,63726.16,63726.1600000002
"12566",2017-04-13 12:08:58,-63726.16,1.74622982740402e-10
"12567",2017-04-13 13:34:55,52582.72,52582.7200000002
"12568",2017-04-13 13:41:43,-52582.72,1.74622982740402e-10
"12569",2017-04-13 17:13:13,5408.84,5408.84000000017
"12570",2017-04-13 17:25:17,-5408.84,1.74622982740402e-10
"12571",2017-04-13 18:12:44,43443.95,43443.9500000002
"12572",2017-04-13 18:18:13,-43443.95,1.74622982740402e-10
"41",2017-04-13 19:33:42,4877.81,4877.81000000018
"12573",2017-04-13 19:33:42,35132.26,40010.0700000002
"12574",2017-04-13 20:16:18,-35132.26,4877.81000000017
"12575",2017-04-13 20:31:44,43906.32,48784.1300000002
"42",2017-04-13 22:17:26,4294.76,53078.8900000002
"12576",2017-04-13 22:17:26,28830.69,81909.5800000002
"12577",2017-04-13 22:17:26,39197.93,121107.51
"43",2017-04-13 22:33:17,-4294.76,116812.75
"12578",2017-04-13 22:33:17,67754.6,184567.35
"12579",2017-04-13 22:33:17,-43906.32,140661.03
"12580",2017-04-13 22:44:35,-43906.32,96754.7100000002
"44",2017-04-13 23:05:54,-4877.81,91876.9000000002
"12581",2017-04-13 23:05:54,-91876.9,2.03726813197136e-10
"12582",2017-04-13 23:05:54,45336.34,45336.3400000002
"12583",2017-04-13 23:13:46,-45336.34,2.03726813197136e-10
"12584",2017-04-14 01:33:58,28497.78,28497.7800000002
"12585",2017-04-14 01:33:58,75142.93,103640.71
"12586",2017-04-14 01:40:57,-103640.71,1.89174897968769e-10
"12587",2017-04-14 02:13:33,23826.23,23826.2300000002
"12588",2017-04-14 02:13:33,2218.9,26045.1300000002
"12589",2017-04-14 02:23:54,2038.96,28084.0900000002
"12590",2017-04-14 02:23:54,-26045.13,2038.96000000019
"12591",2017-04-14 02:40:37,-2038.96,1.88265403266996e-10
"12592",2017-04-14 02:51:04,55804.42,55804.4200000002
"12593",2017-04-14 02:56:50,-55804.42,1.89174897968769e-10
"45",2017-04-14 04:01:01,14175.5,14175.5000000002
"46",2017-04-14 04:33:21,-14175.5,1.89174897968769e-10
"12594",2017-04-14 04:33:21,25902.2,25902.2000000002
"12595",2017-04-14 04:36:21,-25902.2,1.89174897968769e-10
"47",2017-04-14 14:22:19,16948.11,16948.1100000002
"48",2017-04-14 14:42:14,-16948.11,1.89174897968769e-10
"49",2017-04-14 15:21:42,6389.17,6389.17000000019
"50",2017-04-14 15:27:48,-6389.17,1.89174897968769e-10
"12596",2017-04-14 15:44:47,71132.47,71132.4700000002
"51",2017-04-14 16:00:40,4435.42,75567.8900000002
"12597",2017-04-14 16:00:40,-71132.47,4435.42000000019
"52",2017-04-14 16:10:12,-4435.42,1.87355908565223e-10
"12598",2017-04-14 19:02:30,79469.17,79469.1700000002
"12599",2017-04-14 19:16:41,-79469.17,1.89174897968769e-10
"12600",2017-04-14 19:52:04,67814.95,67814.9500000002
"12601",2017-04-14 20:04:40,-67814.95,1.89174897968769e-10
"12602",2017-04-14 21:04:09,68726.63,68726.6300000002
"12603",2017-04-14 21:07:40,-68726.63,1.89174897968769e-10
"12604",2017-04-15 00:12:12,74302.78,74302.7800000002
"12605",2017-04-15 00:16:12,-74302.78,1.89174897968769e-10
"12606",2017-04-15 00:25:16,2165.88,2165.88000000019
"12607",2017-04-15 00:30:19,-2165.88,1.89174897968769e-10
"12608",2017-04-15 01:02:44,70928.53,70928.5300000002
"12609",2017-04-15 01:14:53,54934.64,125863.17
"12610",2017-04-15 01:14:53,-70928.53,54934.6400000002
"12611",2017-04-15 01:16:55,-54934.64,1.89174897968769e-10
"53",2017-04-15 02:30:03,4773.34,4773.34000000019
"54",2017-04-15 02:47:42,-4773.34,1.89174897968769e-10
"12612",2017-04-15 17:24:11,66855.12,66855.1200000002
"12613",2017-04-15 17:34:16,73478.83,140333.95
"12614",2017-04-15 17:34:16,-66855.12,73478.8300000002
"12615",2017-04-15 17:41:54,-73478.83,1.89174897968769e-10
"12616",2017-04-15 18:42:36,70578.87,70578.8700000002
"12617",2017-04-15 18:48:27,-70578.87,1.89174897968769e-10
"12618",2017-04-15 22:28:58,76858.69,76858.6900000002
"12619",2017-04-15 22:39:43,-76858.69,1.89174897968769e-10
"12620",2017-04-17 15:39:38,46093.88,46093.8800000002
"12621",2017-04-17 15:39:38,43922.51,90016.3900000002
"12622",2017-04-17 15:54:27,76509.33,166525.72
"12623",2017-04-17 15:54:27,54118.08,220643.8
"12624",2017-04-17 16:29:09,74663.14,295306.94
"12625",2017-04-17 16:29:09,83521.06,378828
"55",2017-04-17 16:35:18,4308.66,383136.66
"56",2017-04-17 16:38:24,-4308.66,378828
"12626",2017-04-17 16:38:24,-378828,2.3283064365387e-10
"12627",2017-04-17 17:16:17,93922.12,93922.1200000002
"12628",2017-04-17 17:16:17,83173.95,177096.07
"12629",2017-04-17 17:22:24,-177096.07,2.3283064365387e-10
"12630",2017-04-17 17:54:32,69471.01,69471.0100000002
"12631",2017-04-17 17:59:56,-69471.01,2.3283064365387e-10
"12632",2017-04-17 18:42:52,85252.85,85252.8500000002
"12633",2017-04-17 18:42:52,111382.44,196635.29
"12634",2017-04-17 18:42:52,83109.47,279744.76
"12635",2017-04-17 19:03:03,68270.9,348015.66
"12636",2017-04-17 19:23:10,75429.79,423445.45
"12637",2017-04-17 19:23:10,126688.98,550134.43
"12638",2017-04-17 19:23:10,-348015.66,202118.77
"57",2017-04-17 20:30:56,5530.23,207649
"12639",2017-04-17 20:30:56,88890.46,296539.46
"12640",2017-04-17 20:30:56,-202118.77,94420.6900000003
"58",2017-04-17 20:43:59,-5530.23,88890.4600000003
"59",2017-04-17 20:43:59,6662.79,95553.2500000003
"12641",2017-04-17 20:43:59,68638.06,164191.31
"60",2017-04-17 20:54:50,-6662.79,157528.52
"12642",2017-04-17 21:03:57,-157528.52,3.20142135024071e-10
"12643",2017-04-17 21:21:08,49999,49999.0000000003
"12644",2017-04-17 21:27:29,-49999,3.20142135024071e-10
"12645",2017-04-17 21:48:45,72143.84,72143.8400000003
"12646",2017-04-17 21:51:34,-72143.84,3.20142135024071e-10
"12647",2017-04-17 22:07:35,70160.56,70160.5600000003
"12648",2017-04-17 22:26:06,-70160.56,3.20142135024071e-10
"12649",2017-04-17 23:46:43,74896.12,74896.1200000003
"12650",2017-04-18 00:09:07,66977.07,141873.19
"12651",2017-04-18 00:09:07,-74896.12,66977.0700000003
"12652",2017-04-18 00:20:17,-66977.07,3.20142135024071e-10
"61",2017-04-18 04:08:27,4377.93,4377.93000000032
"62",2017-04-18 04:18:11,-4377.93,3.20142135024071e-10
"63",2017-04-18 04:55:11,4162.51,4162.51000000032
"64",2017-04-18 04:58:32,-4162.51,3.20142135024071e-10
"65",2017-04-18 09:43:25,4547.48,4547.48000000032
"66",2017-04-18 10:04:18,-4547.48,3.20142135024071e-10
"67",2017-04-18 13:32:01,5052.54,5052.54000000032
"12653",2017-04-18 18:34:38,77842.39,82894.9300000003
"68",2017-04-18 19:01:17,-5052.54,77842.3900000003
"12654",2017-04-18 19:01:17,-77842.39,3.20142135024071e-10
"69",2017-04-18 20:25:24,4214.27,4214.27000000032
"70",2017-04-18 20:26:50,-4214.27,3.20142135024071e-10
"71",2017-04-18 22:08:42,10253.74,10253.7400000003
"72",2017-04-18 22:21:32,-10253.74,3.20142135024071e-10
"12655",2017-04-18 22:23:23,78308.61,78308.6100000003
"12656",2017-04-18 22:32:36,-78308.61,3.20142135024071e-10
"73",2017-04-19 01:01:44,10405.33,10405.3300000003
"74",2017-04-19 01:03:18,-10405.33,3.20142135024071e-10
"75",2017-04-19 07:01:17,6954.23,6954.23000000032
"76",2017-04-19 07:05:10,-6954.23,3.20142135024071e-10
"77",2017-04-19 15:44:29,6918.09,6918.09000000032
"78",2017-04-19 15:47:44,-6918.09,3.20142135024071e-10
"12657",2017-04-19 18:06:56,88937.28,88937.2800000003
"12658",2017-04-19 18:06:56,159343.38,248280.66
"12659",2017-04-19 18:06:56,89767.94,338048.6
"12660",2017-04-19 18:06:56,79036.59,417085.19
"12661",2017-04-19 18:11:54,26798.161,443883.351
"12662",2017-04-19 18:52:17,88937.32,532820.671
"12663",2017-04-19 18:52:17,92094.11,624914.781
"12664",2017-04-19 18:52:17,124268.04,749182.821
"12665",2017-04-19 18:52:17,114656.09,863838.911
"12666",2017-04-19 19:57:41,-863838.911,3.49245965480804e-10
"79",2017-04-19 20:45:45,7911.92,7911.92000000035
"80",2017-04-19 20:51:41,-7911.92,3.49245965480804e-10
"81",2017-04-19 22:53:15,9619.91,9619.91000000035
"82",2017-04-19 23:02:34,-9619.91,3.49245965480804e-10
"12667",2017-04-20 15:28:59,93810.02,93810.0200000004
"12668",2017-04-20 15:42:13,-93810.02,3.49245965480804e-10
"12669",2017-04-20 15:51:14,95651.78,95651.7800000003
"12670",2017-04-20 16:05:20,-95651.78,3.49245965480804e-10
"83",2017-04-20 17:33:36,9083.03,9083.03000000035
"84",2017-04-20 17:46:59,-9083.03,3.49245965480804e-10
"12671",2017-04-20 18:32:30,100439.15,100439.15
"12672",2017-04-20 18:35:15,-100439.15,3.49245965480804e-10
"12673",2017-04-20 18:45:01,103505.51,103505.51
"12674",2017-04-20 18:48:21,-103505.51,3.49245965480804e-10
"85",2017-04-20 19:17:30,7938.98,7938.98000000035
"86",2017-04-20 19:20:47,-7938.98,3.49245965480804e-10
"12675",2017-04-21 02:39:04,86479.41,86479.4100000004
"12676",2017-04-21 02:44:09,-86479.41,3.49245965480804e-10
"12677",2017-04-21 03:28:36,111230.84,111230.84
"12678",2017-04-21 03:33:30,-111230.84,3.49245965480804e-10
"12679",2017-04-21 04:01:20,94557.79,94557.7900000003
"12680",2017-04-21 04:25:44,-94557.79,3.49245965480804e-10
"12681",2017-04-21 04:58:21,96723.93,96723.9300000003
"12682",2017-04-21 05:20:22,-96723.93,3.49245965480804e-10
"12683",2017-04-21 07:24:27,78789.9,78789.9000000003
"12684",2017-04-21 07:30:56,-78789.9,3.49245965480804e-10
"87",2017-04-21 09:33:16,30049.66,30049.6600000003
"88",2017-04-21 09:33:16,28230.23,58279.8900000003
"89",2017-04-21 10:01:53,47049.67,105329.56
"90",2017-04-21 10:27:01,-47049.67,58279.8900000003
"91",2017-04-21 10:43:56,-30049.66,28230.2300000003
"92",2017-04-21 10:43:56,-28230.23,3.49245965480804e-10
"12685",2017-04-21 14:45:18,81575.62,81575.6200000003
"12686",2017-04-21 14:49:22,-81575.62,3.49245965480804e-10
"12687",2017-04-21 15:06:31,99494.51,99494.5100000003
"12688",2017-04-21 15:14:35,-99494.51,3.49245965480804e-10
"12689",2017-04-21 16:37:01,78295.45,78295.4500000003
"12690",2017-04-21 16:41:53,-78295.45,3.49245965480804e-10
"12691",2017-04-21 16:48:23,84762.93,84762.9300000003
"12692",2017-04-21 17:08:31,-84762.93,3.49245965480804e-10
"12693",2017-04-21 17:36:43,87480.82,87480.8200000004
"12694",2017-04-21 17:44:13,-87480.82,3.49245965480804e-10
"12695",2017-04-21 18:47:50,78584.56,78584.5600000003
"12696",2017-04-21 19:00:51,-78584.56,3.49245965480804e-10
"12697",2017-04-21 22:09:38,86359.96,86359.9600000004
"12698",2017-04-21 22:23:35,-86359.96,3.49245965480804e-10
"12699",2017-04-22 05:30:15,88827.7,88827.7000000003
"12700",2017-04-22 05:46:53,-88827.7,3.49245965480804e-10
"93",2017-04-22 16:59:20,17649.26,17649.2600000003
"94",2017-04-22 17:04:11,-17649.26,3.49245965480804e-10
"12701",2017-04-22 17:37:54,93868.69,93868.6900000004
"12702",2017-04-22 17:42:33,-93868.69,3.49245965480804e-10
"12703",2017-04-22 19:08:09,84187.44,84187.4400000004
"12704",2017-04-22 19:14:25,-84187.44,3.49245965480804e-10
"12705",2017-04-22 19:32:53,139252.98,139252.98
"12706",2017-04-22 19:36:50,-139252.98,3.49245965480804e-10
"12707",2017-04-22 21:19:22,93104.18,93104.1800000003
"12708",2017-04-22 21:53:05,84950.96,178055.14
"12709",2017-04-22 21:53:05,87381.64,265436.78
"12710",2017-04-22 21:53:05,85500.67,350937.45
"12711",2017-04-22 21:53:05,-93104.18,257833.27
"12712",2017-04-22 22:00:08,-257833.27,3.78349795937538e-10
"12713",2017-04-22 22:10:33,102855.63,102855.63
"12714",2017-04-22 22:18:25,-102855.63,3.78349795937538e-10
"95",2017-04-22 22:19:28,40557.15,40557.1500000004
"12715",2017-04-22 22:19:28,85823.06,126380.21
"96",2017-04-22 22:24:25,-40557.15,85823.0600000004
"12716",2017-04-22 22:24:25,134305.49,220128.55
"12717",2017-04-22 22:24:25,-85823.06,134305.49
"12718",2017-04-22 22:36:00,-134305.49,3.78349795937538e-10
"12719",2017-04-24 00:01:09,90388.83,90388.8300000004
"12720",2017-04-24 00:06:45,-90388.83,3.78349795937538e-10
"12721",2017-04-24 00:11:13,81126.68,81126.6800000004
"12722",2017-04-24 00:22:44,-81126.68,3.78349795937538e-10
"12723",2017-04-24 02:02:34,85090.57,85090.5700000004
"12724",2017-04-24 02:05:10,-85090.57,3.78349795937538e-10
"12725",2017-04-24 03:21:40,78528.52,78528.5200000004
"12726",2017-04-24 03:25:48,-78528.52,3.78349795937538e-10
"12727",2017-04-24 04:18:51,79148.88,79148.8800000004
"12728",2017-04-24 04:42:12,79538.05,158686.93
"12729",2017-04-24 04:42:12,-79148.88,79538.0500000004
"12730",2017-04-24 04:57:05,-79538.05,3.92901711165905e-10
"12731",2017-04-24 05:25:17,86343.54,86343.5400000004
"12732",2017-04-24 05:38:59,-86343.54,3.92901711165905e-10
"12733",2017-04-24 08:17:18,117446.86,117446.86
"12734",2017-04-24 08:24:30,-117446.86,3.92901711165905e-10
"12735",2017-04-26 04:49:42,80241.39,80241.3900000004
"12736",2017-04-26 04:57:36,-80241.39,3.92901711165905e-10
"12737",2017-04-26 05:39:25,80120.98,80120.9800000004
"12738",2017-04-26 05:56:07,-80120.98,3.92901711165905e-10
"12739",2017-04-26 06:22:29,84364.9,84364.9000000004
"12740",2017-04-26 06:37:28,-84364.9,3.92901711165905e-10
"12741",2017-04-26 07:17:02,83017.45,83017.4500000004
"12742",2017-04-26 08:01:04,-83017.45,3.92901711165905e-10
"12743",2017-04-26 08:42:03,94826.24,94826.2400000004
"12744",2017-04-26 09:02:13,-94826.24,3.92901711165905e-10
"12745",2017-04-26 09:02:13,93191.74,93191.7400000004
"12746",2017-04-26 09:07:14,-93191.74,3.92901711165905e-10
"12747",2017-04-27 12:07:55,78924.54,78924.5400000004
"12748",2017-04-27 12:30:02,79170.16,158094.7
"12749",2017-04-27 12:30:02,-78924.54,79170.1600000004
"12750",2017-04-27 12:43:25,-79170.16,3.92901711165905e-10
"12751",2017-04-27 13:33:15,79906.48,79906.4800000004
"12752",2017-04-27 13:59:20,83365.08,163271.56
"12753",2017-04-27 14:01:26,105684.01,268955.57
"12754",2017-04-27 14:16:34,83012.06,351967.63
"12755",2017-04-27 14:16:34,-163271.56,188696.07
"12756",2017-04-27 14:19:00,-188696.07,4.07453626394272e-10
"12757",2017-04-27 15:03:14,80510.82,80510.8200000004
"12758",2017-04-27 15:28:18,-80510.82,4.07453626394272e-10
"12759",2017-04-27 17:23:27,92112.24,92112.2400000004
"12760",2017-04-27 17:26:32,-92112.24,4.07453626394272e-10
"12761",2017-04-27 20:56:43,84168.22,84168.2200000004
"12762",2017-04-27 20:56:43,30050.86,114219.08
"12763",2017-04-27 20:57:35,30050.88,144269.96
"12764",2017-04-27 21:00:47,-144269.96,4.07453626394272e-10
"12765",2017-04-28 01:09:20,82875.84,82875.8400000004
"12766",2017-04-28 01:11:51,-82875.84,4.07453626394272e-10
"12767",2017-04-28 04:34:45,93994.57,93994.5700000004
"12768",2017-04-28 04:45:44,-93994.57,4.07453626394272e-10
"12769",2017-04-28 11:43:16,84870.18,84870.1800000004
"12770",2017-04-28 12:06:11,108470.5,193340.68
"12771",2017-04-28 12:06:11,-84870.18,108470.5
"12772",2017-04-28 12:06:11,123987.5,232458
"12773",2017-04-28 12:17:08,-232458,4.07453626394272e-10
"12774",2017-04-28 13:56:54,81859.99,81859.9900000004
"12775",2017-04-28 14:02:07,-81859.99,4.07453626394272e-10
"12776",2017-04-28 18:01:32,90883.62,90883.6200000004
"12777",2017-04-28 18:11:14,-90883.62,4.07453626394272e-10
"12778",2017-04-28 20:13:44,103777.81,103777.81
"12779",2017-04-28 20:16:48,-103777.81,4.07453626394272e-10
"12780",2017-04-28 21:24:07,83029.22,83029.2200000004
"12781",2017-04-28 21:28:01,-83029.22,4.07453626394272e-10
"12782",2017-04-28 22:16:12,82213.49,82213.4900000004
"12783",2017-04-28 22:20:41,-82213.49,4.07453626394272e-10
"12784",2017-04-28 23:30:11,95311.11,95311.1100000004
"12785",2017-04-28 23:34:06,-95311.11,4.07453626394272e-10
"12786",2017-04-28 23:36:32,99933.03,99933.0300000004
"12787",2017-04-28 23:43:02,81928.23,181861.26
"12788",2017-04-28 23:43:02,-99933.03,81928.2300000004
"12789",2017-04-28 23:49:03,-81928.23,4.22005541622639e-10
"12790",2017-04-29 01:04:06,81253.18,81253.1800000004
"12791",2017-04-29 01:09:26,-81253.18,4.22005541622639e-10
"12792",2017-04-29 03:30:33,85682.17,85682.1700000004
"12793",2017-04-29 04:10:15,-85682.17,4.22005541622639e-10
"12794",2017-04-29 06:08:04,80091.14,80091.1400000004
"12795",2017-04-29 06:19:12,-80091.14,4.22005541622639e-10
"12796",2017-04-29 06:43:13,78529.41,78529.4100000004
"12797",2017-04-29 06:58:22,-78529.41,4.22005541622639e-10
"12798",2017-04-29 07:05:25,102333.13,102333.13
"12799",2017-04-29 07:12:25,79675.64,182008.77
"12800",2017-04-29 07:12:25,-102333.13,79675.6400000004
"12801",2017-04-29 07:24:25,-79675.64,4.22005541622639e-10
"12802",2017-04-29 09:55:21,112542.22,112542.22
"12803",2017-04-29 10:06:54,-112542.22,4.22005541622639e-10
"12804",2017-04-29 12:44:16,83953.92,83953.9200000004
"12805",2017-04-29 12:51:57,-83953.92,4.22005541622639e-10
"12806",2017-04-29 13:49:20,79989.73,79989.7300000004
"12807",2017-04-29 13:52:34,-79989.73,4.22005541622639e-10
"12808",2017-04-29 19:49:45,88204.39,88204.3900000004
"12809",2017-04-29 19:56:00,-88204.39,4.22005541622639e-10
"12810",2017-04-29 20:36:14,89130.08,89130.0800000004
"12811",2017-04-29 20:48:30,-89130.08,4.22005541622639e-10
"12812",2017-04-30 03:06:21,100978.23,100978.23
"12813",2017-04-30 03:10:10,-100978.23,4.22005541622639e-10
"12814",2017-04-30 05:03:26,80903.5,80903.5000000004
"12815",2017-04-30 05:18:12,-80903.5,4.22005541622639e-10
"12816",2017-04-30 23:16:19,92988.57,92988.5700000004
"12817",2017-04-30 23:30:49,-92988.57,4.22005541622639e-10
"12818",2017-05-01 00:40:53,83753.27,83753.2700000004
"12819",2017-05-01 01:05:11,92901.12,176654.39
"12820",2017-05-01 01:05:11,-83753.27,92901.1200000004
"12821",2017-05-01 01:05:11,-83753.27,9147.85000000041
"12822",2017-05-01 01:14:16,79381.68,88529.5300000004
"12823",2017-05-01 01:14:16,-9147.85,79381.6800000004
"12824",2017-05-01 01:19:44,-79381.68,4.07453626394272e-10
"12825",2017-05-01 03:39:15,78436.59,78436.5900000004
"12826",2017-05-01 03:55:06,-78436.59,4.07453626394272e-10
"12827",2017-05-01 06:19:32,79475.29,79475.2900000004
"12828",2017-05-01 06:23:43,-79475.29,4.07453626394272e-10
"12829",2017-05-01 06:37:01,96060.75,96060.7500000004
"12830",2017-05-01 06:54:32,-96060.75,4.07453626394272e-10
"12831",2017-05-01 09:49:31,83771.59,83771.5900000004
"12832",2017-05-01 09:49:31,113634.93,197406.52
"12833",2017-05-01 09:56:21,-197406.52,4.07453626394272e-10
"12834",2017-05-01 10:22:37,81834.97,81834.9700000004
"12835",2017-05-01 10:31:51,100680.27,182515.24
"12836",2017-05-01 10:31:51,-81834.97,100680.27
"12837",2017-05-01 10:36:54,-100680.27,3.92901711165905e-10
"97",2017-05-01 13:27:46,18126.33,18126.3300000004
"98",2017-05-01 13:36:45,-18126.33,3.92901711165905e-10
"12838",2017-05-01 13:36:45,99955.99,99955.9900000004
"12839",2017-05-01 13:53:26,-99955.99,3.92901711165905e-10
"12840",2017-05-01 13:59:24,88429.51,88429.5100000004
"12841",2017-05-01 14:03:12,-88429.51,3.92901711165905e-10
"12842",2017-05-01 14:22:23,121976.69,121976.69
"12843",2017-05-01 14:36:49,-121976.69,3.92901711165905e-10
"12844",2017-05-01 14:36:49,87779.31,87779.3100000004
"12845",2017-05-01 14:36:49,111127.56,198906.87
"12846",2017-05-01 14:42:04,-198906.87,4.07453626394272e-10
"12847",2017-05-01 15:02:41,116016.67,116016.67
"12848",2017-05-01 15:07:34,-116016.67,4.07453626394272e-10
"99",2017-05-01 16:20:25,20317.01,20317.0100000004
"12849",2017-05-01 16:20:25,12922.82,33239.8300000004
"100",2017-05-01 16:27:59,-20317.01,12922.8200000004
"12850",2017-05-01 16:27:59,87581.94,100504.76
"12851",2017-05-01 16:27:59,98724.87,199229.63
"12852",2017-05-01 16:45:44,89857.21,289086.84
"12853",2017-05-01 20:42:51,-289086.84,4.07453626394272e-10
"101",2017-05-01 21:52:30,17726.77,17726.7700000004
"102",2017-05-01 22:00:12,-17726.77,4.07453626394272e-10
"103",2017-05-01 22:22:12,21836.8,21836.8000000004
"104",2017-05-01 22:30:03,-21836.8,4.07453626394272e-10
"12854",2017-05-02 00:49:45,89006.36,89006.3600000004
"12855",2017-05-02 00:53:59,-89006.36,4.07453626394272e-10
"12856",2017-05-02 01:45:18,79123.85,79123.8500000004
"12857",2017-05-02 02:00:51,-79123.85,4.07453626394272e-10
"12858",2017-05-02 05:23:23,78507.9,78507.9000000004
"12859",2017-05-02 05:28:00,-78507.9,4.07453626394272e-10
"12860",2017-05-03 05:29:45,71722.04,71722.0400000004
"12861",2017-05-03 05:41:51,42459.88,114181.92
"12862",2017-05-03 05:41:51,-71722.04,42459.8800000004
"12863",2017-05-03 05:44:19,-42459.88,4.00177668780088e-10
"12864",2017-05-03 12:24:35,27106.79,27106.7900000004
"12865",2017-05-03 12:25:28,27625.52,54732.3100000004
"12866",2017-05-03 12:31:15,-54732.31,4.07453626394272e-10
"12867",2017-05-03 12:46:29,33597.05,33597.0500000004
"12868",2017-05-03 12:55:21,-33597.05,4.07453626394272e-10
"12869",2017-05-03 15:06:13,30404.3,30404.3000000004
"12870",2017-05-03 15:10:56,-30404.3,4.07453626394272e-10
"12871",2017-05-03 15:33:03,31415.12,31415.1200000004
"12872",2017-05-03 15:33:03,58963.89,90379.0100000004
"12873",2017-05-03 15:48:43,-90379.01,4.07453626394272e-10
"12874",2017-05-03 17:19:25,43193.77,43193.7700000004
"12875",2017-05-03 17:33:02,-43193.77,4.07453626394272e-10
"12876",2017-05-03 18:06:41,158632.41,158632.41
"12877",2017-05-03 18:11:47,78667.1,237299.51
"12878",2017-05-03 18:11:47,-158632.41,78667.1000000004
"12879",2017-05-03 18:16:29,-78667.1,4.07453626394272e-10
"12880",2017-05-03 18:44:39,77604.49,77604.4900000004
"12881",2017-05-03 18:44:39,109510.82,187115.31
"12882",2017-05-03 18:55:39,62695.33,249810.64
"12883",2017-05-03 18:55:39,-187115.31,62695.3300000004
"12884",2017-05-03 19:07:17,-62695.33,4.22005541622639e-10
"12885",2017-05-03 19:07:17,33452.9,33452.9000000004
"12886",2017-05-03 19:22:17,-33452.9,4.22005541622639e-10
"12887",2017-05-03 19:22:17,45527.25,45527.2500000004
"12888",2017-05-03 19:34:19,58828.97,104356.22
"12889",2017-05-03 19:34:19,-45527.25,58828.9700000004
"12890",2017-05-03 19:50:14,62847.94,121676.91
"12891",2017-05-03 19:50:14,-58828.97,62847.9400000004
"12892",2017-05-03 19:57:38,-62847.94,4.22005541622639e-10
"12893",2017-05-03 20:00:46,45076.53,45076.5300000004
"12894",2017-05-03 20:57:41,31546.9,76623.4300000004
"12895",2017-05-03 20:59:08,-45076.53,31546.9000000004
"12896",2017-05-03 21:04:58,-31546.9,4.29281499236822e-10
"12897",2017-05-03 22:18:02,27900.65,27900.6500000004
"105",2017-05-03 22:28:03,23503.91,51404.5600000004
"12898",2017-05-03 22:28:03,-27900.65,23503.9100000004
"106",2017-05-03 22:32:59,-23503.91,4.32919478043914e-10
"12899",2017-05-03 23:17:31,25986.53,25986.5300000004
"12900",2017-05-03 23:54:56,-25986.53,4.32919478043914e-10
"12901",2017-05-04 01:23:47,31958.8,31958.8000000004
"12902",2017-05-04 01:28:42,-31958.8,4.32919478043914e-10
"12903",2017-05-04 01:49:42,11692.62,11692.6200000004
"12904",2017-05-04 01:55:03,-11692.62,4.32919478043914e-10
"12905",2017-05-04 03:38:51,49221.63,49221.6300000004
"12906",2017-05-04 03:49:50,-49221.63,4.29281499236822e-10
"107",2017-05-04 06:23:09,11807.13,11807.1300000004
"108",2017-05-04 06:42:49,-11807.13,4.29281499236822e-10
"12907",2017-05-04 10:38:07,79016.02,79016.0200000004
"12908",2017-05-04 11:01:58,-79016.02,4.22005541622639e-10
"12909",2017-05-04 11:36:32,44422.46,44422.4600000004
"12910",2017-05-04 11:38:29,-44422.46,4.22005541622639e-10
"12911",2017-05-04 12:15:30,28264.01,28264.0100000004
"12912",2017-05-04 12:29:39,-28264.01,4.22005541622639e-10
"109",2017-05-04 14:18:57,12450.69,12450.6900000004
"110",2017-05-04 14:20:39,-12450.69,4.22005541622639e-10
"12913",2017-05-04 14:58:55,55433.45,55433.4500000004
"12914",2017-05-04 15:02:58,-55433.45,4.22005541622639e-10
"12915",2017-05-04 15:15:52,50214.32,50214.3200000004
"12916",2017-05-04 15:15:52,87332.59,137546.91
"12917",2017-05-04 15:15:52,33418.74,170965.65
"12918",2017-05-04 15:20:13,-170965.65,4.07453626394272e-10
"12919",2017-05-04 15:26:59,4544.46,4544.46000000041
"12920",2017-05-04 15:51:28,93983.86,98528.3200000004
"12921",2017-05-04 15:51:28,52349.85,150878.17
"12922",2017-05-04 15:51:28,-4544.46,146333.71
"12923",2017-05-04 16:07:53,59565.63,205899.34
"12924",2017-05-04 16:07:53,54690.62,260589.96
"12925",2017-05-04 16:07:53,45750.31,306340.27
"12926",2017-05-04 16:07:53,76326.41,382666.68
"12927",2017-05-04 16:07:53,-146333.71,236332.97
"12928",2017-05-04 16:07:53,45280.93,281613.9
"12929",2017-05-04 16:11:04,-281613.9,4.07453626394272e-10
"12930",2017-05-04 16:59:43,41916.65,41916.6500000004
"12931",2017-05-04 16:59:43,32834.76,74751.4100000004
"12932",2017-05-04 17:01:42,77175.17,151926.58
"12933",2017-05-04 17:07:37,-151926.58,4.36557456851006e-10
"12934",2017-05-04 17:14:15,53885.29,53885.2900000004
"111",2017-05-04 17:40:15,19345.68,73230.9700000004
"12935",2017-05-04 17:40:15,52338.9,125569.87
"12936",2017-05-04 18:05:27,55044.42,180614.29
"12937",2017-05-04 18:05:27,82783.53,263397.82
"12938",2017-05-04 18:05:27,98774.88,362172.7
"12939",2017-05-04 18:05:27,42928.64,405101.34
"12940",2017-05-04 18:09:27,-385755.66,19345.6800000005
"12941",2017-05-04 18:16:55,68231.94,87577.6200000005
"12942",2017-05-04 18:23:40,46169.99,133747.61
"12943",2017-05-04 18:44:48,65074.22,198821.83
"12944",2017-05-04 18:44:48,43297.86,242119.69
"12945",2017-05-04 18:44:48,158172.29,400291.98
"12946",2017-05-04 18:44:48,-114401.93,285890.05
"12947",2017-05-04 18:50:23,44855.35,330745.4
"12948",2017-05-04 18:50:23,-266544.37,64201.0300000004
"12949",2017-05-04 18:54:08,-44855.35,19345.6800000004
"112",2017-05-04 18:58:12,17459.42,36805.1000000004
"12950",2017-05-04 18:58:12,64520.43,101325.53
"12951",2017-05-04 19:06:08,50047.14,151372.67
"12952",2017-05-04 19:06:08,-64520.43,86852.2400000005
"12953",2017-05-04 19:13:25,60773.31,147625.55
"12954",2017-05-04 19:13:25,-50047.14,97578.4100000005
"12955",2017-05-04 19:24:13,31815.5,129393.91
"12956",2017-05-04 19:28:04,56019.5,185413.41
"12957",2017-05-04 19:28:04,32937.75,218351.16
"12958",2017-05-04 19:28:04,-92588.81,125762.35
"12959",2017-05-04 19:28:04,-60773.31,64989.0400000004
"113",2017-05-04 19:32:05,-19345.68,45643.3600000004
"114",2017-05-04 19:32:05,-17459.42,28183.9400000004
"12960",2017-05-04 19:32:05,-28183.94,4.47471393272281e-10
"12961",2017-05-04 19:38:13,34147.33,34147.3300000005
"12962",2017-05-04 19:53:21,32815.83,66963.1600000005
"12963",2017-05-04 19:53:21,-34147.33,32815.8300000005
"12964",2017-05-04 20:00:08,-32815.83,4.51109372079372e-10
"12965",2017-05-04 20:06:11,40978.47,40978.4700000005
"12966",2017-05-04 20:23:23,33117.91,74096.3800000005
"12967",2017-05-04 20:23:23,-40978.47,33117.9100000005
"12968",2017-05-04 20:31:09,-33117.91,4.51109372079372e-10
"115",2017-05-04 21:18:56,13146.42,13146.4200000005
"12969",2017-05-04 21:18:56,88225.74,101372.16
"12970",2017-05-04 21:18:56,97805.35,199177.51
"12971",2017-05-04 21:18:56,100143,299320.51
"116",2017-05-04 21:22:22,21900.87,321221.38
"12972",2017-05-04 21:22:22,-286174.09,35047.2900000004
"12973",2017-05-04 21:44:02,81094.11,116141.4
"12974",2017-05-04 21:44:02,83632.43,199773.83
"12975",2017-05-04 22:03:09,27546.91,227320.74
"12976",2017-05-04 22:03:09,27107.93,254428.67
"12977",2017-05-04 22:03:09,-164726.54,89702.1300000004
"117",2017-05-04 22:04:09,-13146.42,76555.7100000004
"118",2017-05-04 22:04:09,-21900.87,54654.8400000004
"12978",2017-05-04 22:06:13,43465.08,98119.9200000004
"12979",2017-05-04 22:06:13,-54654.84,43465.0800000004
"12980",2017-05-04 22:27:47,66938.4,110403.48
"12981",2017-05-04 22:27:47,62680.7,173084.18
"12982",2017-05-04 23:43:36,68623.11,241707.29
"12983",2017-05-04 23:43:36,34526.46,276233.75
"12984",2017-05-04 23:43:36,85451.66,361685.41
"12985",2017-05-04 23:55:52,30280.94,391966.35
"12986",2017-05-05 00:14:38,59001.19,450967.54
"12987",2017-05-05 00:14:38,125024.82,575992.36
"12988",2017-05-05 00:22:11,30336.66,606329.02
"12989",2017-05-05 00:24:01,4105.87,610434.89
"12990",2017-05-05 01:25:12,-610434.89,3.49245965480804e-10
"12991",2017-05-05 02:09:14,74512.5,74512.5000000003
"12992",2017-05-05 02:55:21,-74512.5,3.49245965480804e-10
"12993",2017-05-05 03:28:41,81903.91,81903.9100000004
"12994",2017-05-05 05:00:49,-81903.91,3.49245965480804e-10
"119",2017-05-05 07:00:08,11866.49,11866.4900000003
"120",2017-05-05 07:04:07,-11866.49,3.49245965480804e-10
"12995",2017-05-05 07:38:29,88724.39,88724.3900000003
"12996",2017-05-05 07:38:29,98940.27,187664.66
"12997",2017-05-05 07:42:14,-187664.66,3.49245965480804e-10
"12998",2017-05-05 07:51:42,68878.93,68878.9300000003
"12999",2017-05-05 07:57:21,-68878.93,3.49245965480804e-10
"121",2017-05-05 08:30:53,11800.36,11800.3600000003
"13000",2017-05-05 08:30:53,117563.27,129363.63
"13001",2017-05-05 08:30:53,65689.82,195053.45
"122",2017-05-05 08:31:45,-11800.36,183253.09
"13002",2017-05-05 08:31:45,69436.4,252689.49
"13003",2017-05-05 08:39:19,-252689.49,3.78349795937538e-10
"13004",2017-05-05 08:53:45,74064.12,74064.1200000004
"13005",2017-05-05 09:10:15,92552.29,166616.41
"13006",2017-05-05 09:10:15,75522.26,242138.67
"13007",2017-05-05 09:10:15,-74064.12,168074.55
"13008",2017-05-05 09:13:47,-168074.55,4.07453626394272e-10
"13009",2017-05-05 09:28:18,75374.74,75374.7400000004
"13010",2017-05-05 09:36:38,-75374.74,4.07453626394272e-10
"13011",2017-05-05 10:43:45,79403.51,79403.5100000004
"13012",2017-05-05 11:04:30,-79403.51,4.07453626394272e-10
"13013",2017-05-05 12:53:19,109047.29,109047.29
"13014",2017-05-05 13:07:31,73698.31,182745.6
"13015",2017-05-05 13:07:31,81948.94,264694.54
"13016",2017-05-05 13:07:31,-109047.29,155647.25
"13017",2017-05-05 13:07:31,-109047.29,46599.9600000004
"123",2017-05-05 13:21:27,13138.43,59738.3900000004
"13018",2017-05-05 13:21:27,-46599.96,13138.4300000004
"13019",2017-05-05 13:21:27,93116.54,106254.97
"124",2017-05-05 13:56:45,-13138.43,93116.5400000004
"13020",2017-05-05 13:56:45,78743.62,171860.16
"13021",2017-05-05 13:56:45,74149.11,246009.27
"13022",2017-05-05 13:56:45,91238.78,337248.05
"13023",2017-05-05 14:41:49,86463.68,423711.73
"13024",2017-05-05 14:41:49,81381.25,505092.98
"13025",2017-05-05 14:41:49,-337248.05,167844.93
"13026",2017-05-05 14:41:49,-93116.54,74728.3900000004
"13027",2017-05-05 14:53:04,-74728.39,4.07453626394272e-10
"13028",2017-05-05 15:10:23,93336.46,93336.4600000004
"13029",2017-05-05 15:24:47,74684.93,168021.39
"13030",2017-05-05 15:24:47,84995.75,253017.14
"13031",2017-05-05 15:24:47,78941.65,331958.79
"13032",2017-05-05 15:24:47,-93336.46,238622.33
"13033",2017-05-05 15:40:47,85290.51,323912.84
"13034",2017-05-05 15:40:47,79576.38,403489.22
"13035",2017-05-05 15:40:47,30660.95,434150.17
"13036",2017-05-05 15:40:47,-238622.33,195527.84
"13037",2017-05-05 15:50:44,-195527.84,4.07453626394272e-10
"13038",2017-05-05 15:54:34,124216.87,124216.87
"13039",2017-05-05 16:11:15,78193.77,202410.64
"13040",2017-05-05 16:11:15,-124216.87,78193.7700000004
"13041",2017-05-05 16:18:52,-78193.77,4.22005541622639e-10
"13042",2017-05-05 16:26:32,72285.93,72285.9300000004
"125",2017-05-05 16:49:15,12916.78,85202.7100000004
"13043",2017-05-05 16:49:15,32365.51,117568.22
"13044",2017-05-05 16:49:15,80914.35,198482.57
"126",2017-05-05 16:57:37,-12916.78,185565.79
"13045",2017-05-05 16:57:37,76475.11,262040.9
"13046",2017-05-05 16:57:37,-72285.93,189754.97
"13047",2017-05-05 16:57:37,-185565.79,4189.18000000043
"127",2017-05-05 17:28:42,30053.49,34242.6700000004
"128",2017-05-05 17:28:42,14017.38,48260.0500000004
"129",2017-05-05 17:28:42,16340.81,64600.8600000004
"13048",2017-05-05 17:28:42,77830.44,142431.3
"13049",2017-05-05 17:28:42,67410.36,209841.66
"13050",2017-05-05 17:28:42,177830.5,387672.16
"130",2017-05-05 18:03:38,-16340.81,371331.35
"131",2017-05-05 18:03:38,-30053.49,341277.86
"132",2017-05-05 18:03:38,-14017.38,327260.48
"13051",2017-05-05 18:03:38,29668.97,356929.45
"133",2017-05-05 19:55:12,24066.9,380996.35
"13052",2017-05-05 19:55:12,81267.48,462263.83
"13053",2017-05-05 20:01:58,45914.55,508178.38
"13054",2017-05-05 20:04:26,29791.01,537969.39
"13055",2017-05-05 20:16:41,44274.83,582244.22
"13056",2017-05-05 20:16:41,47029.03,629273.25
"13057",2017-05-05 20:16:41,-4189.18,625084.07
"13058",2017-05-05 20:16:41,-327260.48,297823.59
"134",2017-05-05 20:19:33,15110.09,312933.68
"135",2017-05-05 20:19:33,-24066.9,288866.78
"13059",2017-05-05 20:19:33,-273756.69,15110.0900000003
"136",2017-05-05 20:24:46,-15110.09,3.16504156216979e-10
"13060",2017-05-05 20:24:46,46290.73,46290.7300000003
"13061",2017-05-05 20:41:49,-46290.73,3.12866177409887e-10
"13062",2017-05-05 21:04:40,46166.89,46166.8900000003
"137",2017-05-05 21:08:56,19332.71,65499.6000000003
"13063",2017-05-05 21:08:56,-46166.89,19332.7100000003
"13064",2017-05-05 21:08:56,43289.6,62622.3100000003
"13065",2017-05-05 21:20:21,-43289.6,19332.7100000003
"13066",2017-05-05 21:56:23,28653.65,47986.3600000003
"13067",2017-05-05 22:33:32,-28653.65,19332.7100000003
"138",2017-05-05 22:44:50,-19332.71,3.12866177409887e-10
"139",2017-05-06 08:54:18,25968.02,25968.0200000003
"140",2017-05-06 09:17:31,-25968.02,3.12866177409887e-10
"13068",2017-05-07 07:28:52,67172.44,67172.4400000003
"13069",2017-05-07 07:36:55,-67172.44,3.20142135024071e-10
"13071",2017-05-07 07:45:14,-77830.48,-77830.4799999997
"13070",2017-05-07 07:46:11,77830.48,3.20142135024071e-10
"141",2017-05-07 07:56:28,18338,18338.0000000003
"142",2017-05-07 08:07:55,-18338,3.20142135024071e-10
"13072",2017-05-07 09:25:07,38609.62,38609.6200000003
"13073",2017-05-07 09:34:46,-38609.62,3.20142135024071e-10
"13074",2017-05-07 09:34:46,60017.24,60017.2400000003
"13075",2017-05-07 09:41:21,-60017.24,3.20142135024071e-10
"13076",2017-05-07 09:45:10,26317.98,26317.9800000003
"13077",2017-05-07 09:48:35,43645.09,69963.0700000003
"13078",2017-05-07 09:48:35,-26317.98,43645.0900000003
"13079",2017-05-07 09:48:35,-26317.98,17327.1100000003
"13080",2017-05-07 09:58:14,-17327.11,3.16504156216979e-10
"13081",2017-05-07 10:16:39,54059.11,54059.1100000003
"13082",2017-05-07 10:22:55,-54059.11,3.20142135024071e-10
"13083",2017-05-07 10:26:16,32220.63,32220.6300000003
"13084",2017-05-07 10:41:02,82864.82,115085.45
"13085",2017-05-07 10:41:02,28787.45,143872.9
"13086",2017-05-07 10:51:37,36877.54,180750.44
"13087",2017-05-07 11:02:14,-180750.44,3.49245965480804e-10
"13088",2017-05-07 15:42:57,68543.85,68543.8500000004
"13089",2017-05-07 16:04:47,86153.44,154697.29
"13090",2017-05-07 16:04:47,-68543.85,86153.4400000004
"13091",2017-05-07 16:04:47,-68543.85,17609.5900000003
"13092",2017-05-07 16:21:12,-17609.59,3.45607986673713e-10
"13093",2017-05-07 16:37:48,89582.75,89582.7500000003
"13094",2017-05-07 17:09:24,65337.48,154920.23
"13095",2017-05-07 17:16:33,-154920.23,3.49245965480804e-10
"13096",2017-05-07 20:27:06,87252.2,87252.2000000003
"143",2017-05-07 20:41:17,13169.35,100421.55
"13097",2017-05-07 20:41:17,-87252.2,13169.3500000004
"144",2017-05-07 20:46:10,-13169.35,3.54702933691442e-10
"13098",2017-05-07 21:48:47,88661.55,88661.5500000004
"13099",2017-05-07 21:48:47,135132.02,223793.57
"13100",2017-05-07 22:05:28,-223793.57,3.49245965480804e-10
"145",2017-05-07 23:46:45,26053.16,26053.1600000003
"146",2017-05-07 23:52:34,-26053.16,3.49245965480804e-10
"13101",2017-05-08 02:08:20,84622.41,84622.4100000004
"13102",2017-05-08 02:21:52,-84622.41,3.49245965480804e-10
"13103",2017-05-08 02:35:19,84410.59,84410.5900000003
"13104",2017-05-08 02:38:45,-84410.59,3.49245965480804e-10
"13105",2017-05-08 02:42:47,89253.33,89253.3300000004
"13106",2017-05-08 02:53:52,89416.05,178669.38
"13107",2017-05-08 02:53:52,-89253.33,89416.0500000004
"13108",2017-05-08 02:53:52,-89253.33,162.72000000035
"13109",2017-05-08 03:01:22,-162.72,3.50411255567451e-10
"13110",2017-05-08 03:57:32,52837.11,52837.1100000003
"13111",2017-05-08 04:19:11,86437.41,139274.52
"13112",2017-05-08 04:19:11,-52837.11,86437.4100000004
"13113",2017-05-08 04:25:50,46842.8,133280.21
"13114",2017-05-08 04:25:50,40246.13,173526.34
"13115",2017-05-08 04:25:50,-86437.41,87088.9300000004
"13116",2017-05-08 04:31:22,30241.54,117330.47
"13117",2017-05-08 04:31:22,-87088.93,30241.5400000004
"147",2017-05-08 04:40:29,12178.35,42419.8900000004
"13118",2017-05-08 04:40:29,-30241.54,12178.3500000004
"148",2017-05-08 04:50:21,-12178.35,3.83806764148176e-10
"13119",2017-05-08 05:35:35,77640.94,77640.9400000004
"13120",2017-05-08 05:46:45,95784.7,173425.64
"13121",2017-05-08 05:51:20,-173425.64,3.49245965480804e-10
"149",2017-05-08 06:26:18,11299.62,11299.6200000004
"150",2017-05-08 06:38:50,-11299.62,3.49245965480804e-10
"13122",2017-05-09 10:46:44,300055.3,300055.3
"13123",2017-05-09 10:53:08,-300055.3,3.49245965480804e-10
"13124",2017-05-09 15:35:43,82862.56,82862.5600000003
"13125",2017-05-09 15:47:03,-82862.56,3.49245965480804e-10
"13126",2017-05-09 16:20:15,106422.91,106422.91
"13127",2017-05-09 16:53:51,-106422.91,3.49245965480804e-10
"13128",2017-05-09 18:01:58,80187.86,80187.8600000003
"13129",2017-05-09 18:43:44,78844.26,159032.12
"13130",2017-05-09 18:43:44,159191.21,318223.33
"13131",2017-05-09 18:44:17,-80187.86,238035.47
"13132",2017-05-09 18:44:17,-80187.86,157847.61
"151",2017-05-09 18:54:36,27918.58,185766.19
"13133",2017-05-09 18:54:36,83042.68,268808.87
"152",2017-05-09 19:09:01,-27918.58,240890.29
"13134",2017-05-09 19:09:01,77777.09,318667.38
"13135",2017-05-09 19:09:01,-240890.29,77777.0900000003
"13136",2017-05-09 19:14:21,-77777.09,3.49245965480804e-10
"153",2017-05-09 20:48:12,12160.26,12160.2600000003
"13137",2017-05-09 20:48:12,85917.13,98077.3900000003
"154",2017-05-09 21:04:50,-12160.26,85917.1300000004
"155",2017-05-09 21:04:50,30095.1,116012.23
"13138",2017-05-09 21:04:50,82532.66,198544.89
"13139",2017-05-09 21:04:50,177777.14,376322.03
"156",2017-05-09 21:34:37,-30095.1,346226.93
"13140",2017-05-09 21:41:44,47095.28,393322.21
"13141",2017-05-09 21:42:11,105648.05,498970.26
"13142",2017-05-09 22:00:59,113924.55,612894.81
"13143",2017-05-09 23:14:32,-612894.81,3.49245965480804e-10
"13144",2017-05-10 02:12:53,52761.4,52761.4000000004
"13145",2017-05-10 03:21:17,-52761.4,3.49245965480804e-10
"13146",2017-05-10 04:46:23,8001,8001.00000000035
"13147",2017-05-10 04:48:21,51330.79,59331.7900000004
"13148",2017-05-10 04:48:21,78821.11,138152.9
"13149",2017-05-10 04:53:18,-138152.9,3.49245965480804e-10
"13150",2017-05-10 05:23:03,49784.94,49784.9400000004
"13151",2017-05-10 05:23:03,77780.81,127565.75
"13152",2017-05-10 05:23:03,40978.13,168543.88
"13153",2017-05-10 05:39:49,-168543.88,3.49245965480804e-10
"157",2017-05-10 16:05:00,18889.68,18889.6800000003
"13154",2017-05-10 16:05:00,55602.48,74492.1600000004
"13155",2017-05-10 16:20:52,-55602.48,18889.6800000003
"158",2017-05-10 16:27:15,-18889.68,3.49245965480804e-10
"13156",2017-05-10 16:30:05,103151.87,103151.87
"13157",2017-05-10 16:44:14,-103151.87,3.49245965480804e-10
"13158",2017-05-10 18:18:35,87459.44,87459.4400000004
"13159",2017-05-10 18:36:42,-87459.44,3.49245965480804e-10
"159",2017-05-10 19:05:01,11368.18,11368.1800000003
"160",2017-05-10 19:08:48,-11368.18,3.49245965480804e-10
"161",2017-05-10 23:06:30,11709.48,11709.4800000003
"162",2017-05-10 23:17:57,-11709.48,3.49245965480804e-10
"13160",2017-05-11 00:20:53,86761.95,86761.9500000003
"13161",2017-05-11 00:24:58,-86761.95,3.49245965480804e-10
"13162",2017-05-11 02:16:49,60075.34,60075.3400000003
"13163",2017-05-11 02:28:18,-60075.34,3.49245965480804e-10
"13164",2017-05-11 02:28:18,88385.65,88385.6500000003
"13165",2017-05-11 02:36:47,-88385.65,3.49245965480804e-10
"13166",2017-05-11 02:51:49,112439.17,112439.17
"13167",2017-05-11 03:00:07,-112439.17,3.49245965480804e-10
"13168",2017-05-11 03:05:39,93097.1,93097.1000000004
"13169",2017-05-11 03:35:57,42678.88,135775.98
"13170",2017-05-11 03:35:57,-93097.1,42678.8800000004
"13171",2017-05-11 03:42:10,-42678.88,3.56521923094988e-10
"163",2017-05-11 03:57:45,11447.96,11447.9600000004
"13172",2017-05-11 03:59:41,78744.51,90192.4700000004
"164",2017-05-11 04:20:09,-11447.96,78744.5100000004
"13173",2017-05-11 04:33:03,-78744.51,3.63797880709171e-10
"13174",2017-05-11 05:05:29,88888.7,88888.7000000004
"13175",2017-05-11 05:14:20,-88888.7,3.63797880709171e-10
"165",2017-05-11 05:45:22,31980.04,31980.0400000004
"166",2017-05-11 05:45:22,16552.09,48532.1300000004
"167",2017-05-11 05:55:37,-31980.04,16552.0900000004
"13176",2017-05-11 05:55:37,59558.89,76110.9800000004
"168",2017-05-11 06:00:18,-16552.09,59558.8900000004
"13177",2017-05-11 06:07:09,-59558.89,3.63797880709171e-10
"169",2017-05-11 07:50:50,24242.43,24242.4300000004
"170",2017-05-11 07:50:50,30000.8,54243.2300000004
"13178",2017-05-11 07:50:50,54550.46,108793.69
"13179",2017-05-11 07:50:50,77777.79,186571.48
"13180",2017-05-11 07:50:50,77777.77,264349.25
"171",2017-05-11 08:13:18,-24242.43,240106.82
"172",2017-05-11 08:15:54,-30000.8,210106.02
"13181",2017-05-11 08:15:54,-210106.02,3.78349795937538e-10
"13182",2017-05-11 08:21:34,63771.74,63771.7400000004
"13183",2017-05-11 08:21:34,77777.78,141549.52
"173",2017-05-11 08:44:46,37777.83,179327.35
"13184",2017-05-11 08:44:46,77777.81,257105.16
"13185",2017-05-11 08:44:46,88888.82,345993.98
"13186",2017-05-11 08:44:46,-141549.52,204444.46
"13187",2017-05-11 09:04:49,-166666.63,37777.8300000004
"174",2017-05-11 09:31:46,-37777.83,3.92901711165905e-10
"13188",2017-05-11 09:47:42,88888.84,88888.8400000004
"13189",2017-05-11 09:51:17,-88888.84,3.92901711165905e-10
"13190",2017-05-11 10:16:52,88888.85,88888.8500000004
"13191",2017-05-11 10:16:52,-88888.84,0.0100000004022149
"175",2017-05-11 16:30:58,38888.91,38888.9200000004
"176",2017-05-11 16:41:07,-38888.91,0.0100000004022149
"13192",2017-05-11 19:53:46,77777.92,77777.9300000004
"13193",2017-05-11 20:11:49,88851.78,166629.71
"13194",2017-05-11 20:46:42,89055.25,255684.96
"13195",2017-05-11 21:06:34,75534.76,331219.72
"13196",2017-05-11 22:03:59,177777.96,508997.68
"13197",2017-05-11 22:12:39,-331219.72,177777.96
"13198",2017-05-11 23:38:48,-77777.93,100000.03
"13199",2017-05-12 00:22:13,-100000.03,4.36557456851006e-10
"13200",2017-05-12 01:02:59,77777.98,77777.9800000004
"13201",2017-05-12 01:19:55,-77777.98,4.36557456851006e-10
"13202",2017-05-12 05:20:24,82628.89,82628.8900000004
"13203",2017-05-12 05:43:01,42071.36,124700.25
"13204",2017-05-12 05:43:01,48526.53,173226.78
"13205",2017-05-12 05:54:27,-82628.89,90597.8900000004
"13206",2017-05-12 06:01:57,-90597.89,4.36557456851006e-10
"13207",2017-05-12 08:55:29,31700.38,31700.3800000004
"13208",2017-05-12 09:04:32,-31700.38,4.36557456851006e-10
"13209",2017-05-12 09:09:04,34196.27,34196.2700000004
"13210",2017-05-12 09:25:45,40403.54,74599.8100000004
"13211",2017-05-12 09:27:45,-34196.27,40403.5400000004
"13212",2017-05-12 09:40:23,63293.44,103696.98
"13213",2017-05-12 09:40:23,-40403.54,63293.4400000004
"13214",2017-05-12 10:11:57,35157.01,98450.4500000004
"13215",2017-05-12 10:15:49,5338.97,103789.42
"13216",2017-05-12 10:15:49,-40403.54,63385.8800000004
"13217",2017-05-12 10:15:49,4847.51,68233.3900000005
"13218",2017-05-12 10:19:07,6553.21,74786.6000000005
"13219",2017-05-12 10:19:07,-68233.39,6553.21000000046
"13220",2017-05-12 10:19:07,33507.71,40060.9200000005
"13221",2017-05-12 10:28:50,39826.44,79887.3600000005
"13222",2017-05-12 10:28:50,-40060.92,39826.4400000005
"13223",2017-05-12 10:41:19,30879.16,70705.6000000005
"13224",2017-05-12 10:41:19,-39826.44,30879.1600000005
"13225",2017-05-12 10:45:24,-30879.16,4.54747350886464e-10
"13226",2017-05-12 10:49:59,39718.06,39718.0600000004
"13227",2017-05-12 10:55:22,-39718.06,4.51109372079372e-10
"13228",2017-05-12 11:08:21,47804.43,47804.4300000005
"13229",2017-05-12 11:23:12,-47804.43,4.51109372079372e-10
"13230",2017-05-12 11:34:03,37916.89,37916.8900000005
"13231",2017-05-12 11:42:49,-37916.89,4.51109372079372e-10
"13232",2017-05-12 12:23:41,37549.56,37549.5600000004
"13233",2017-05-12 12:39:51,-37549.56,4.51109372079372e-10
"13234",2017-05-12 12:43:33,29943.86,29943.8600000005
"13235",2017-05-12 13:13:37,-29943.86,4.51109372079372e-10
"13236",2017-05-12 13:42:04,41664.24,41664.2400000004
"13237",2017-05-12 13:42:04,39676.81,81341.0500000005
"13238",2017-05-12 13:46:51,-81341.05,4.51109372079372e-10
"177",2017-05-12 20:24:34,30001.3,30001.3000000005
"13239",2017-05-12 20:52:12,33261.93,63263.2300000004
"13240",2017-05-12 20:52:12,62975.24,126238.47
"178",2017-05-12 21:11:40,-30001.3,96237.1700000004
"13241",2017-05-12 21:11:40,-96237.17,4.36557456851006e-10
"179",2017-05-12 22:02:11,30001.33,30001.3300000004
"13242",2017-05-12 23:21:10,36694.19,66695.5200000004
"13243",2017-05-12 23:40:09,33568.49,100264.01
"13244",2017-05-13 00:13:48,30368.64,130632.65
"13245",2017-05-13 00:13:48,33246.48,163879.13
"13246",2017-05-13 00:13:48,-70262.68,93616.4500000004
"13247",2017-05-13 00:13:48,-36694.19,56922.2600000004
"180",2017-05-13 00:22:27,-30001.33,26920.9300000004
"13248",2017-05-13 00:22:27,-26920.93,4.43833414465189e-10
"13249",2017-05-13 00:33:34,31884.93,31884.9300000004
"13250",2017-05-13 01:48:21,-31884.93,4.43833414465189e-10
"13251",2017-05-13 02:22:55,33219.42,33219.4200000004
"13252",2017-05-13 02:22:55,64410.92,97630.3400000004
"13253",2017-05-13 02:22:55,39528.27,137158.61
"13254",2017-05-13 02:24:46,52759.01,189917.62
"13255",2017-05-13 02:27:08,-189917.62,4.36557456851006e-10
"13256",2017-05-13 02:35:11,121610.26,121610.26
"13257",2017-05-13 02:37:42,39804.22,161414.48
"13258",2017-05-13 02:37:42,-121610.26,39804.2200000005
"13259",2017-05-13 02:40:01,31474.76,71278.9800000004
"13260",2017-05-13 02:47:33,-39804.22,31474.7600000004
"13261",2017-05-13 02:54:18,-31474.76,4.47471393272281e-10
"13262",2017-05-13 02:54:18,29887.13,29887.1300000004
"181",2017-05-13 03:14:50,37778.5,67665.6300000004
"13263",2017-05-13 03:14:50,40250.54,107916.17
"13264",2017-05-13 03:14:50,74768.06,182684.23
"13265",2017-05-13 03:14:50,39743.99,222428.22
"13266",2017-05-13 03:14:50,-29887.13,192541.09
"13267",2017-05-13 03:18:35,-154762.59,37778.5000000004
"13268",2017-05-13 03:29:38,77778.51,115557.01
"13269",2017-05-13 03:34:20,-77778.51,37778.5000000004
"182",2017-05-13 03:43:09,-37778.5,4.36557456851006e-10
"13270",2017-05-13 04:32:35,60384.57,60384.5700000004
"13271",2017-05-13 04:35:04,38192.02,98576.5900000004
"13272",2017-05-13 04:35:04,-60384.57,38192.0200000004
"13273",2017-05-13 06:02:26,30934.92,69126.9400000004
"13274",2017-05-13 06:02:26,42120.81,111247.75
"13275",2017-05-13 06:02:26,32502.6,143750.35
"13276",2017-05-13 06:02:26,30110.62,173860.97
"13277",2017-05-13 06:02:26,37799.53,211660.5
"13278",2017-05-13 06:13:57,65731.13,277391.63
"13279",2017-05-13 06:35:34,83983.65,361375.28
"13280",2017-05-13 06:43:14,33915.79,395291.07
"13281",2017-05-13 06:43:14,-38192.02,357099.05
"13282",2017-05-13 06:43:14,-38192.02,318907.03
"13283",2017-05-13 06:43:14,-277391.63,41515.4000000004
"13284",2017-05-13 06:46:42,37988.09,79503.4900000004
"13285",2017-05-13 06:46:42,-41515.4,37988.0900000004
"13286",2017-05-13 06:59:24,32400.15,70388.2400000004
"13287",2017-05-13 06:59:24,-37988.09,32400.1500000004
"13288",2017-05-13 07:07:07,-32400.15,4.29281499236822e-10
"183",2017-05-13 07:10:20,22156.79,22156.7900000004
"13289",2017-05-13 07:22:38,34346.8,56503.5900000004
"184",2017-05-13 07:30:53,-22156.79,34346.8000000004
"13290",2017-05-13 07:30:53,42794.09,77140.8900000004
"13291",2017-05-13 07:30:53,-34346.8,42794.0900000004
"13292",2017-05-13 07:30:53,-34346.8,8447.29000000042
"13293",2017-05-13 07:52:17,88889.67,97336.9600000004
"13294",2017-05-13 07:52:17,-8447.29,88889.6700000004
"13295",2017-05-13 07:52:17,-8447.29,80442.3800000004
"13296",2017-05-13 08:08:48,-80442.38,4.07453626394272e-10
"13297",2017-05-13 10:21:30,10653.85,10653.8500000004
"13298",2017-05-13 10:44:18,-10653.85,4.07453626394272e-10
"13299",2017-05-13 11:36:38,5639.08,5639.08000000041
"13300",2017-05-13 12:00:17,-5639.08,4.07453626394272e-10
"13301",2017-05-13 12:09:08,4354.28,4354.28000000041
"13302",2017-05-13 12:18:02,-4354.28,4.07453626394272e-10
"13303",2017-05-13 12:18:02,5946.51,5946.51000000041
"13304",2017-05-13 12:48:23,-5946.51,4.07453626394272e-10
"13305",2017-05-13 12:48:30,8392.45,8392.45000000041
"13306",2017-05-13 13:10:10,-8392.45,4.07453626394272e-10
"185",2017-05-13 21:44:50,23634.17,23634.1700000004
"186",2017-05-13 21:48:53,-23634.17,4.07453626394272e-10
"13307",2017-05-13 21:55:48,60517.59,60517.5900000004
"13308",2017-05-13 22:03:37,38661.43,99179.0200000004
"13309",2017-05-13 22:03:37,-60517.59,38661.4300000004
"13310",2017-05-13 22:14:02,-38661.43,4.00177668780088e-10
"187",2017-05-13 22:55:29,17853.43,17853.4300000004
"13311",2017-05-13 22:55:29,24514.37,42367.8000000004
"188",2017-05-13 23:20:19,-17853.43,24514.3700000004
"13312",2017-05-13 23:20:19,-24514.37,3.96539689972997e-10
"13313",2017-05-14 09:20:33,56773.39,56773.3900000004
"13314",2017-05-14 09:55:34,28994.15,85767.5400000004
"13315",2017-05-14 09:55:34,-56773.39,28994.1500000004
"13316",2017-05-14 10:00:56,-28994.15,3.85625753551722e-10
"189",2017-05-14 10:25:07,19295.77,19295.7700000004
"190",2017-05-14 10:38:33,-19295.77,3.85625753551722e-10
"13317",2017-05-14 10:38:33,7751.01,7751.01000000039
"13318",2017-05-14 10:41:36,-7751.01,3.85625753551722e-10
"13319",2017-05-14 13:16:21,78167.36,78167.3600000004
"13320",2017-05-14 13:19:21,-78167.36,3.92901711165905e-10
"13321",2017-05-14 13:35:19,63443.33,63443.3300000004
"13322",2017-05-14 13:46:48,-63443.33,3.92901711165905e-10
"13323",2017-05-14 14:39:33,62940.47,62940.4700000004
"13324",2017-05-14 14:46:40,-62940.47,3.92901711165905e-10
"13325",2017-05-14 14:55:05,25472.49,25472.4900000004
"13326",2017-05-14 15:05:06,-25472.49,3.92901711165905e-10
"13327",2017-05-14 18:15:56,38088.12,38088.1200000004
"13328",2017-05-14 18:31:33,-38088.12,3.92901711165905e-10
"13329",2017-05-14 18:40:24,75056.3,75056.3000000004
"13330",2017-05-14 18:43:48,-75056.3,3.92901711165905e-10
"13331",2017-05-14 20:21:08,80689.87,80689.8700000004
"13332",2017-05-14 20:51:25,69746.04,150435.91
"13333",2017-05-14 21:20:22,57540.14,207976.05
"13334",2017-05-14 22:51:36,40548.8,248524.85
"13335",2017-05-15 00:15:00,61652.03,310176.88
"13336",2017-05-15 02:48:45,64241.76,374418.64
"13337",2017-05-15 02:53:19,-374418.64,3.49245965480804e-10
"191",2017-05-15 06:00:02,29895.24,29895.2400000004
"13338",2017-05-15 06:00:02,88531.61,118426.85
"13339",2017-05-15 06:00:02,77777.56,196204.41
"13340",2017-05-15 06:06:26,-166309.17,29895.2400000003
"13341",2017-05-15 06:17:29,32459.4,62354.6400000003
"13342",2017-05-15 06:27:25,-32459.4,29895.2400000003
"13343",2017-05-15 06:37:38,65490.56,95385.8000000003
"13344",2017-05-15 06:39:35,-65490.56,29895.2400000003
"13345",2017-05-15 10:24:33,39625.78,69521.0200000003
"13346",2017-05-15 10:31:53,-39625.78,29895.2400000003
"13347",2017-05-15 14:20:47,42179.95,72075.1900000003
"13348",2017-05-15 15:04:07,-42179.95,29895.2400000003
"13349",2017-05-15 20:35:45,70725.39,100620.63
"13350",2017-05-15 20:37:58,-70725.39,29895.2400000003
"13351",2017-05-15 20:42:07,69107.87,99003.1100000003
"13352",2017-05-15 21:15:51,28103.55,127106.66
"13353",2017-05-15 21:15:51,-69107.87,57998.7900000003
"13354",2017-05-15 21:31:29,84435.59,142434.38
"13355",2017-05-15 21:31:29,-69107.87,73326.5100000004
"13356",2017-05-15 21:46:38,-43431.27,29895.2400000004
"13357",2017-05-15 22:12:39,61296.13,91191.3700000004
"13358",2017-05-15 23:02:45,-61296.13,29895.2400000004
"13359",2017-05-15 23:33:44,83103.18,112998.42
"13360",2017-05-15 23:46:48,-83103.18,29895.2400000004
"13361",2017-05-16 00:35:24,73354.81,103250.05
"13362",2017-05-16 00:36:35,73102.33,176352.38
"13363",2017-05-16 00:41:32,-146457.14,29895.2400000003
"13364",2017-05-16 00:56:22,69201.74,99096.9800000003
"13365",2017-05-16 00:59:16,-69201.74,29895.2400000003
"13366",2017-05-16 01:24:16,62994.49,92889.7300000003
"13367",2017-05-16 02:28:38,71694.68,164584.41
"13368",2017-05-16 02:28:38,69851.39,234435.8
"13369",2017-05-16 02:32:21,75272.18,309707.98
"13370",2017-05-16 02:42:57,109788.38,419496.36
"13371",2017-05-16 02:42:57,84966.51,504462.87
"13372",2017-05-16 03:21:59,67614.83,572077.7
"13373",2017-05-16 03:21:59,-62994.49,509083.21
"13374",2017-05-16 03:21:59,-62994.49,446088.72
"13375",2017-05-16 03:21:59,-204540.56,241548.16
"13376",2017-05-16 03:21:59,-62994.49,178553.67
"13377",2017-05-16 03:29:35,-148658.43,29895.2400000003
"13378",2017-05-16 03:48:50,76119.74,106014.98
"13379",2017-05-16 04:06:09,-76119.74,29895.2400000003
"13380",2017-05-16 04:52:51,73622.87,103518.11
"13381",2017-05-16 05:06:51,-73622.87,29895.2400000003
"13382",2017-05-16 07:16:14,80186.15,110081.39
"13383",2017-05-16 07:30:01,-80186.15,29895.2400000003
"13384",2017-05-17 06:04:26,23512.91,53408.1500000003
"192",2017-05-17 12:40:28,37780.13,91188.2800000003
"193",2017-05-17 12:41:51,-29895.24,61293.0400000003
"13385",2017-05-17 16:06:47,-23512.91,37780.1300000003
"194",2017-05-17 19:17:19,-37780.13,3.41970007866621e-10
"13386",2017-05-17 20:57:38,149065.99,149065.99
"13387",2017-05-17 21:18:15,96695.04,245761.03
"13388",2017-05-17 21:32:06,-23512.91,222248.12
"13389",2017-05-17 21:32:06,-23512.91,198735.21
"13390",2017-05-17 21:32:06,-23512.91,175222.3
"13391",2017-05-17 22:11:11,67705.89,242928.19
"13392",2017-05-17 22:37:20,75914.56,318842.75
"13393",2017-05-17 23:11:25,61780.29,380623.04
"13394",2017-05-17 23:11:25,83886.1,464509.14
"13395",2017-05-17 23:11:25,68684.87,533194.01
"13396",2017-05-17 23:59:55,42781.99,575976
"13397",2017-05-18 00:43:11,15912.02,591888.02
"13398",2017-05-18 01:05:01,41899.78,633787.8
"13399",2017-05-18 01:20:30,-23512.91,610274.89
"13400",2017-05-18 01:20:30,-23512.91,586761.98
"13401",2017-05-18 01:41:06,45093.44,631855.42
"13402",2017-05-18 01:41:06,40561.52,672416.94
"13403",2017-05-18 01:41:06,-23512.91,648904.03
"13404",2017-05-18 01:41:06,-23512.91,625391.12
"13405",2017-05-18 01:41:06,-23512.91,601878.21
"13406",2017-05-18 01:45:45,-23512.91,578365.3
"13407",2017-05-18 01:45:45,-23512.91,554852.39
"13408",2017-05-18 02:19:03,7468.38,562320.77
"13409",2017-05-18 03:17:10,44592.44,606913.21
"13410",2017-05-18 03:32:12,40818.43,647731.64
"13411",2017-05-18 03:44:43,59437.38,707169.02
"195",2017-05-18 03:45:27,50003.19,757172.21
"13412",2017-05-18 03:45:27,-23512.91,733659.3
"13413",2017-05-18 03:45:27,-23512.91,710146.39
"13414",2017-05-18 03:45:27,-23512.91,686633.48
"196",2017-05-18 04:05:29,-50003.19,636630.29
"13415",2017-05-18 04:27:36,62034.1,698664.39
"13416",2017-05-18 04:27:36,-23512.91,675151.48
"13417",2017-05-18 04:48:09,-23512.91,651638.57
"13418",2017-05-18 04:48:09,44678.49,696317.06
"13419",2017-05-18 08:39:57,-696317.06,-3.49245965480804e-10
"13420",2017-05-18 09:42:34,75571.91,75571.9099999997
"13421",2017-05-18 09:42:34,69557.2,145129.11
"13422",2017-05-18 09:42:34,48992.01,194121.12
"197",2017-05-18 10:16:23,20512.62,214633.74
"13423",2017-05-18 10:16:23,44720.16,259353.9
"198",2017-05-18 10:25:42,-20512.62,238841.28
"13424",2017-05-18 10:48:21,44788.14,283629.42
"13425",2017-05-18 11:12:41,-194121.12,89508.2999999996
"13426",2017-05-18 11:30:44,92890.82,182399.12
"13427",2017-05-18 11:30:44,52737.55,235136.67
"13428",2017-05-18 11:30:44,6618.69,241755.36
"13429",2017-05-18 11:48:23,-194121.12,47634.2399999996
"13430",2017-05-18 12:31:10,39096.66,86730.8999999996
"13431",2017-05-18 13:53:17,-47634.24,39096.6599999996
"13432",2017-05-18 14:08:42,56679.3,95775.9599999996
"199",2017-05-18 14:23:16,22126.55,117902.51
"13433",2017-05-18 14:23:16,43052.14,160954.65
"13434",2017-05-18 14:23:16,-86730.9,74223.7499999997
"13435",2017-05-18 14:23:16,-47634.24,26589.5099999997
"13436",2017-05-18 14:23:16,46423.17,73012.6799999996
"13437",2017-05-18 14:36:09,53871.61,126884.29
"13438",2017-05-18 15:23:38,68645.44,195529.73
"13439",2017-05-18 15:24:06,-86730.9,108798.83
"200",2017-05-18 15:36:37,-22126.55,86672.2799999996
"13440",2017-05-18 15:36:37,-39096.66,47575.6199999996
"13441",2017-05-18 16:43:19,-47575.62,-3.71073838323355e-10
"201",2017-05-18 18:03:22,30003.65,30003.6499999996
"13442",2017-05-18 19:06:24,55780.24,85783.8899999996
"13443",2017-05-18 19:41:10,79823.98,165607.87
"13444",2017-05-18 19:50:28,-55780.24,109827.63
"13445",2017-05-18 19:50:28,-55780.24,54047.3899999997
"13446",2017-05-18 20:26:26,50583.51,104630.9
"13447",2017-05-18 20:26:26,-24043.74,80587.1599999997
"13448",2017-05-18 20:31:04,-24043.74,56543.4199999996
"13449",2017-05-18 21:17:22,-24043.74,32499.6799999996
"13450",2017-05-18 22:57:58,47802.23,80301.9099999997
"13451",2017-05-18 23:34:42,66606.24,146908.15
"13452",2017-05-18 23:34:42,52666.79,199574.94
"202",2017-05-19 04:26:33,70003.75,269578.69
"203",2017-05-19 05:06:53,-30003.65,239575.04
"13453",2017-05-19 06:18:01,67895.75,307470.79
"13454",2017-05-19 06:25:51,-237467.04,70003.7499999997
"13455",2017-05-19 07:52:08,41397.37,111401.12
"13456",2017-05-19 07:52:08,100003.78,211404.9
"13457",2017-05-19 08:01:06,55484.57,266889.47
"13458",2017-05-19 10:11:29,-141401.15,125488.32
"13459",2017-05-19 13:26:19,-55484.57,70003.7499999997
"13460",2017-05-19 14:39:29,40033.01,110036.76
"13461",2017-05-19 14:40:29,88891.87,198928.63
"13462",2017-05-19 14:40:29,-55484.57,143444.06
"13463",2017-05-19 14:40:29,-55484.57,87959.4899999997
"204",2017-05-19 15:08:26,70003.85,157963.34
"13464",2017-05-19 16:02:16,77780.88,235744.22
"13465",2017-05-19 16:14:25,-17955.74,217788.48
"13466",2017-05-19 16:14:25,-17955.74,199832.74
"13467",2017-05-19 16:14:25,-17955.74,181877
"13468",2017-05-19 16:14:25,-17955.74,163921.26
"13469",2017-05-19 16:20:35,-17955.74,145965.52
"13470",2017-05-19 18:10:19,-5957.92,140007.6
"205",2017-05-19 22:35:16,-140007.6,-2.91038304567337e-10
"13471",2017-05-20 01:45:52,7633.1,7633.09999999971
"13472",2017-05-20 01:51:55,14762.9,22395.9999999997
"13473",2017-05-20 03:19:57,76079.3,98475.2999999997
"13474",2017-05-20 03:19:57,39998.13,138473.43
"13475",2017-05-20 03:31:05,-7633.1,130840.33
"13476",2017-05-20 03:31:17,38236.4,169076.73
"13477",2017-05-20 03:33:07,-7633.1,161443.63
"13478",2017-05-20 03:42:04,-22396,139047.63
"13479",2017-05-20 04:19:36,-22396,116651.63
"13480",2017-05-20 04:19:36,50409.06,167060.69
"13481",2017-05-20 04:55:27,-22396,144664.69
"13482",2017-05-20 04:55:27,-22396,122268.69
"13483",2017-05-20 05:42:47,-22396,99872.6899999997
"13484",2017-05-20 05:57:24,-22396,77476.6899999997
"13485",2017-05-20 05:57:24,-22396,55080.6899999997
"13486",2017-05-20 08:36:41,-55080.69,-3.20142135024071e-10
"13487",2017-05-20 11:06:40,13215.86,13215.8599999997
"13488",2017-05-20 11:29:10,50944.68,64160.5399999997
"13489",2017-05-20 11:29:10,37213.98,101374.52
"13490",2017-05-20 11:29:10,-55080.69,46293.8299999997
"13491",2017-05-20 11:29:10,46671.45,92965.2799999997
"13492",2017-05-20 11:29:10,46125.48,139090.76
"13493",2017-05-20 11:34:48,54826.27,193917.03
"13494",2017-05-20 12:36:10,40844.81,234761.84
"13495",2017-05-20 13:35:30,56562.02,291323.86
"13496",2017-05-20 13:58:51,40379.05,331702.91
"13497",2017-05-20 14:00:42,53345.69,385048.6
"13498",2017-05-20 14:11:15,72523.82,457572.42
"13499",2017-05-20 14:27:35,37344.38,494916.8
"13500",2017-05-20 14:28:51,37942.68,532859.48
"13501",2017-05-20 15:00:50,39501.7,572361.18
"13502",2017-05-20 15:00:50,53514.97,625876.15
"13503",2017-05-20 15:33:08,-139090.76,486785.39
"13504",2017-05-20 15:33:08,-13215.86,473569.53
"13505",2017-05-20 15:38:56,-193917.03,279652.5
"13506",2017-05-20 15:54:09,54503.77,334156.27
"13507",2017-05-20 15:54:09,-234761.84,99394.4299999997
"13508",2017-05-20 16:02:46,43998.22,143392.65
"13509",2017-05-20 16:02:46,39285.82,182678.47
"13510",2017-05-20 16:26:21,75262.89,257941.36
"13511",2017-05-20 16:44:45,-234761.84,23179.5199999997
"13512",2017-05-20 16:52:36,53311.73,76491.2499999997
"13513",2017-05-20 17:28:23,66522.7,143013.95
"13514",2017-05-20 17:55:05,66146.2,209160.15
"13515",2017-05-20 18:32:52,78518.69,287678.84
"13516",2017-05-20 19:24:58,42241.37,329920.21
"13517",2017-05-20 19:24:58,79363.05,409283.26
"13518",2017-05-20 19:48:08,41017.03,450300.29
"13519",2017-05-20 19:48:08,44711.53,495011.82
"13520",2017-05-20 19:48:08,55222.58,550234.4
"13521",2017-05-20 19:48:08,-532859.48,17374.9199999997
"13522",2017-05-20 20:00:46,52993.97,70368.8899999997
"13523",2017-05-20 20:41:17,48205.63,118574.52
"13524",2017-05-20 21:41:02,37606.54,156181.06
"13525",2017-05-20 22:28:15,-99394.43,56786.6299999997
"13526",2017-05-20 22:33:14,136770.12,193556.75
"13527",2017-05-20 22:33:14,43486.34,237043.09
"13528",2017-05-20 22:34:23,37786.66,274829.75
"13529",2017-05-20 22:43:16,-257941.36,16888.3899999997
"206",2017-05-20 23:49:56,40064.79,56953.1799999997
"207",2017-05-21 00:55:42,-40064.79,16888.3899999997
"13530",2017-05-21 01:20:08,-16888.39,-2.7648638933897e-10
"208",2017-05-21 23:35:31,37781.75,37781.7499999997
"13531",2017-05-21 23:35:31,167152.83,204934.58
"13532",2017-05-21 23:35:31,77781.74,282716.32
"209",2017-05-22 00:34:23,-37781.75,244934.57
"210",2017-05-22 07:11:57,23165.39,268099.96
"13533",2017-05-22 07:11:57,-244934.57,23165.3899999997
"13534",2017-05-22 09:26:11,53484.38,76649.7699999997
"211",2017-05-22 09:45:04,50004.91,126654.68
"13535",2017-05-22 09:45:04,77781.9,204436.58
"13536",2017-05-22 09:45:04,42688.94,247125.52
"13537",2017-05-22 10:23:46,195666.56,442792.08
"13538",2017-05-22 10:23:46,22304.69,465096.77
"13539",2017-05-22 10:33:46,45898.03,510994.8
"13540",2017-05-22 10:33:46,106947.39,617942.19
"13541",2017-05-22 11:00:37,44073.27,662015.46
"13542",2017-05-22 11:00:37,66999.07,729014.53
"13543",2017-05-22 11:00:37,65725.12,794739.65
"13544",2017-05-22 11:00:37,39658.28,834397.93
"13545",2017-05-22 11:34:52,81118.62,915516.55
"13546",2017-05-22 11:34:52,98130.8,1013647.35
"13547",2017-05-22 11:34:52,23643.31,1037290.66
"13548",2017-05-22 11:39:01,40552.91,1077843.57
"13549",2017-05-22 12:06:12,29478.99,1107322.56
"13550",2017-05-22 12:06:12,104071.9,1211394.46
"13551",2017-05-22 12:10:39,81546.57,1292941.03
"212",2017-05-22 13:00:18,46520.33,1339461.36
"13552",2017-05-22 13:00:18,41185.51,1380646.87
"13553",2017-05-22 13:00:18,64520.28,1445167.15
"13554",2017-05-22 13:00:18,36590.81,1481757.96
"13555",2017-05-22 13:00:18,43954.96,1525712.92
"13556",2017-05-22 13:23:00,67591.05,1593303.97
"13557",2017-05-22 14:35:35,64744.39,1658048.36
"13558",2017-05-22 14:35:35,167403.53,1825451.89
"13559",2017-05-22 14:35:35,27585.42,1853037.31
"13560",2017-05-22 14:42:50,46708.46,1899745.77
"13561",2017-05-22 15:29:04,27397.44,1927143.21
"13562",2017-05-22 15:29:04,27147.37,1954290.58
"13563",2017-05-22 15:29:04,46652.21,2000942.79
"13564",2017-05-22 16:04:32,25529.71,2026472.5
"13565",2017-05-22 16:31:58,35682.87,2062155.37
"13566",2017-05-22 16:32:57,39411.01,2101566.38
"13567",2017-05-22 16:32:57,-244934.57,1856631.81
"13568",2017-05-22 16:42:18,51802.12,1908433.93
"13569",2017-05-22 17:06:16,77155.65,1985589.58
"13570",2017-05-22 17:29:22,52708.58,2038298.16
"13571",2017-05-22 17:29:22,46134.26,2084432.42
"13572",2017-05-22 17:34:34,52243.59,2136676.01
"13573",2017-05-22 17:40:34,-244934.57,1891741.44
"13574",2017-05-22 17:40:34,-244934.57,1646806.87
"13575",2017-05-22 17:40:34,34555.95,1681362.82
"213",2017-05-22 17:54:15,35967.8,1717330.62
"13576",2017-05-22 17:54:15,25916.1,1743246.72
"13577",2017-05-22 17:54:15,42924.47,1786171.19
"13578",2017-05-22 18:05:11,-244934.57,1541236.62
"13579",2017-05-22 18:33:41,-244934.57,1296302.05
"13580",2017-05-22 18:40:23,88391.62,1384693.67
"13581",2017-05-22 18:44:21,-244934.57,1139759.1
"13582",2017-05-22 18:52:06,-244934.57,894824.529999999
"13583",2017-05-22 19:27:34,-244934.57,649889.959999999
"13584",2017-05-22 19:41:11,-244934.57,404955.389999999
"13585",2017-05-22 20:09:49,-244934.57,160020.819999999
"13586",2017-05-22 22:08:54,19992.28,180013.099999999
"13587",2017-05-22 22:08:54,94995.97,275009.069999999
"13588",2017-05-22 22:47:52,-119350.64,155658.429999999
"13589",2017-05-22 23:00:49,70223.96,225882.389999999
"13590",2017-05-22 23:05:11,-70223.96,155658.429999999
"13591",2017-05-22 23:09:15,135339.59,290998.019999999
"13592",2017-05-22 23:37:11,-135339.59,155658.429999999
"13593",2017-05-22 23:37:11,57058.74,212717.169999999
"13594",2017-05-22 23:37:11,82362.41,295079.579999999
"13595",2017-05-22 23:37:11,50278.02,345357.599999999
"13596",2017-05-22 23:37:11,102576.06,447933.659999999
"214",2017-05-22 23:37:52,14939.39,462873.049999999
"13597",2017-05-22 23:41:20,-292275.23,170597.819999999
"215",2017-05-23 00:05:46,19525.54,190123.359999999
"13598",2017-05-23 00:05:46,105763.07,295886.429999999
"13599",2017-05-23 00:05:46,38591.07,334477.499999999
"13600",2017-05-23 00:10:29,-144354.14,190123.359999999
"13601",2017-05-23 00:48:16,155436.8,345560.159999999
"13602",2017-05-23 00:52:13,141876.99,487437.149999999
"13603",2017-05-23 00:52:13,-155436.8,332000.349999999
"13604",2017-05-23 00:56:42,-141876.99,190123.359999999
"13605",2017-05-23 03:48:18,93636.57,283759.929999999
"13606",2017-05-23 03:56:48,-93636.57,190123.359999999
"13607",2017-05-23 04:34:40,61912.57,252035.929999999
"13608",2017-05-23 04:51:02,-61912.57,190123.359999999
"13609",2017-05-23 05:58:21,40587.14,230710.499999999
"13610",2017-05-23 06:06:45,-40587.14,190123.359999999
"13611",2017-05-23 06:28:40,76274.37,266397.729999999
"13612",2017-05-23 06:35:06,-76274.37,190123.359999999
"13613",2017-05-23 06:56:28,97409.64,287532.999999999
"13614",2017-05-23 07:24:35,-97409.64,190123.359999999
"13615",2017-05-23 07:24:35,59463.68,249587.039999999
"13616",2017-05-23 07:29:52,-59463.68,190123.359999999
"13617",2017-05-23 09:05:21,57067.98,247191.339999999
"13618",2017-05-23 09:23:31,-57067.98,190123.359999999
"13619",2017-05-23 11:02:01,79684.57,269807.929999999
"13620",2017-05-23 11:22:17,-79684.57,190123.359999999
"13621",2017-05-23 11:22:17,58071.76,248195.119999999
"13622",2017-05-23 11:50:20,70787.59,318982.709999999
"13623",2017-05-23 11:50:20,-58071.76,260910.949999999
"13624",2017-05-23 11:50:20,116414.03,377324.979999999
"13625",2017-05-23 11:58:04,-187201.62,190123.359999999
"13626",2017-05-23 12:13:48,92432.93,282556.289999999
"13627",2017-05-23 12:28:21,-92432.93,190123.359999999
"13628",2017-05-23 12:51:24,38303.8,228427.159999999
"13629",2017-05-23 13:15:38,-38303.8,190123.359999999
"13630",2017-05-23 13:15:38,53933.32,244056.679999999
"13631",2017-05-23 13:28:54,-53933.32,190123.359999999
"13632",2017-05-23 14:48:12,64194.33,254317.689999999
"13633",2017-05-23 14:48:12,55738.07,310055.759999999
"13634",2017-05-23 14:48:12,174545.58,484601.339999999
"13635",2017-05-23 14:48:12,64143.29,548744.629999999
"13636",2017-05-23 14:54:00,-358621.27,190123.359999999
"13637",2017-05-23 15:14:26,85947.78,276071.139999999
"13638",2017-05-23 15:14:26,95866.03,371937.169999999
"13639",2017-05-23 15:14:26,114323.27,486260.439999999
"13640",2017-05-23 15:23:56,39345.26,525605.699999999
"13641",2017-05-23 15:23:56,-296137.08,229468.619999999
"13642",2017-05-23 15:23:56,109674.81,339143.429999999
"13643",2017-05-23 15:31:44,94443.51,433586.939999999
"13644",2017-05-23 15:31:44,-149020.07,284566.869999999
"13645",2017-05-23 15:31:44,125141.33,409708.199999999
"13646",2017-05-23 15:45:31,59239.91,468948.109999999
"13647",2017-05-23 15:45:31,174275.05,643223.159999999
"13648",2017-05-23 15:45:31,60398.01,703621.169999999
"13649",2017-05-23 15:45:31,-149020.07,554601.099999999
"13650",2017-05-23 15:45:31,-219584.84,335016.259999999
"13651",2017-05-23 15:56:28,37695.77,372712.029999999
"13652",2017-05-23 15:56:28,56820.52,429532.549999999
"13653",2017-05-23 15:56:28,-144892.9,284639.649999999
"13654",2017-05-23 15:56:28,88893.89,373533.539999999
"13655",2017-05-23 16:23:10,88893.94,462427.479999999
"13656",2017-05-23 16:23:10,107128.93,569556.409999999
"13657",2017-05-23 16:23:10,112639.03,682195.439999999
"13658",2017-05-23 16:23:10,-183410.18,498785.259999999
"13659",2017-05-23 16:27:29,100005.95,598791.209999999
"13660",2017-05-23 16:27:29,-308661.9,290129.309999999
"13661",2017-05-23 16:31:19,-100005.95,190123.359999999
"13662",2017-05-23 16:43:55,73626.14,263749.499999999
"13663",2017-05-23 16:55:04,42392.68,306142.179999999
"13664",2017-05-23 16:55:04,-73626.14,232516.039999999
"13665",2017-05-23 16:59:09,-42392.68,190123.359999999
"13666",2017-05-23 17:03:05,86902.81,277026.169999999
"13667",2017-05-23 17:13:22,81248.79,358274.959999999
"13668",2017-05-23 17:13:22,-86902.81,271372.149999999
"13669",2017-05-23 17:20:33,-81248.79,190123.359999999
"13670",2017-05-23 18:45:37,53841.09,243964.449999999
"13671",2017-05-23 18:45:37,72056.11,316020.559999999
"13672",2017-05-23 18:45:37,70353.26,386373.819999999
"13673",2017-05-23 18:45:37,70815.34,457189.159999999
"13674",2017-05-23 19:09:47,-267065.8,190123.359999999
"13675",2017-05-23 22:40:52,85987.66,276111.019999999
"13676",2017-05-23 22:48:13,-85987.66,190123.359999999
"13677",2017-05-23 22:48:13,103727.37,293850.729999999
"13678",2017-05-23 22:52:47,267427.92,561278.649999999
"13679",2017-05-23 22:52:47,70580.84,631859.489999999
"13680",2017-05-23 22:52:47,-103727.37,528132.119999999
"13681",2017-05-23 22:59:31,-338008.76,190123.359999999
"13682",2017-05-23 23:17:47,58253.47,248376.829999999
"13683",2017-05-23 23:17:47,73625.26,322002.089999999
"13684",2017-05-23 23:27:18,49807.88,371809.969999999
"13685",2017-05-23 23:31:13,-181686.61,190123.359999999
"13686",2017-05-23 23:54:29,71706,261829.359999999
"13687",2017-05-24 00:40:52,67144.88,328974.239999999
"13688",2017-05-24 00:40:52,75090.33,404064.569999999
"13689",2017-05-24 00:40:52,-71706,332358.569999999
"13690",2017-05-24 00:40:52,-71706,260652.569999999
"13691",2017-05-24 00:40:52,179726.59,440379.159999999
"13692",2017-05-24 00:40:52,75511.8,515890.959999999
"13693",2017-05-24 00:53:23,88361.94,604252.899999999
"13694",2017-05-24 00:53:23,221222.59,825475.489999999
"13695",2017-05-24 00:53:23,-325767.6,499707.889999999
"13696",2017-05-24 01:00:02,96389.08,596096.969999999
"13697",2017-05-24 01:00:02,-309584.53,286512.439999999
"13698",2017-05-24 01:19:46,112739.04,399251.479999999
"13699",2017-05-24 01:19:46,67202.02,466453.499999999
"13700",2017-05-24 01:19:46,-96389.08,370064.419999999
"13701",2017-05-24 01:30:08,-179941.06,190123.359999999
"13702",2017-05-24 01:30:08,69300.06,259423.419999999
"13703",2017-05-24 01:44:41,179124.95,438548.369999999
"13704",2017-05-24 01:44:41,83740.64,522289.009999999
"13705",2017-05-24 01:44:41,-69300.06,452988.949999999
"13706",2017-05-24 01:44:41,-69300.06,383688.889999999
"13707",2017-05-24 02:06:11,94848.46,478537.349999999
"13708",2017-05-24 02:06:11,-193565.53,284971.819999999
"13709",2017-05-24 02:26:12,-94848.46,190123.359999999
"13710",2017-05-24 15:50:51,41441.09,231564.449999999
"13711",2017-05-24 15:55:20,-41441.09,190123.359999999
"13712",2017-05-24 16:08:13,122954.74,313078.099999999
"13713",2017-05-24 16:13:12,-122954.74,190123.359999999
"13714",2017-05-24 17:30:40,97598.08,287721.439999999
"13715",2017-05-24 17:38:47,451402.16,739123.599999999
"13716",2017-05-24 17:52:27,146256.13,885379.729999999
"13717",2017-05-24 17:52:27,79661.46,965041.189999999
"13718",2017-05-24 18:10:37,68927.9,1033969.09
"13719",2017-05-24 18:17:16,65902.69,1099871.78
"13720",2017-05-24 18:17:16,83160.26,1183032.04
"13721",2017-05-24 18:28:49,61331.91,1244363.95
"13722",2017-05-24 18:28:49,169742.86,1414106.81
"13723",2017-05-24 18:35:29,87506.59,1501613.4
"13724",2017-05-24 18:58:30,81775.14,1583388.54
"13725",2017-05-24 18:58:30,105174.3,1688562.84
"13726",2017-05-24 19:02:10,99755.92,1788318.76
"13727",2017-05-24 19:15:05,55623.04,1843941.8
"13728",2017-05-24 19:15:05,72574.85,1916516.65
"13729",2017-05-24 19:15:05,116047.77,2032564.42
"13730",2017-05-24 19:35:15,65577.7,2098142.12
"13731",2017-05-24 19:39:25,57971.86,2156113.98
"13732",2017-05-24 20:14:25,59543.44,2215657.42
"13733",2017-05-24 20:44:09,149770.66,2365428.08
"13734",2017-05-24 20:44:09,101688.59,2467116.67
"13735",2017-05-24 20:44:09,188719.82,2655836.49
"13736",2017-05-24 21:01:51,65020.15,2720856.64
"13737",2017-05-24 21:01:51,130405.38,2851262.02
"13738",2017-05-24 21:10:43,50697.7,2901959.72
"13739",2017-05-24 21:10:43,79363.7,2981323.42
"13740",2017-05-24 21:27:00,66716.84,3048040.26
"13741",2017-05-25 00:43:45,245391.73,3293431.99
"13742",2017-05-25 00:43:45,82340.81,3375772.8
"13743",2017-05-25 00:43:45,58996.25,3434769.05
"13744",2017-05-25 01:36:14,124022.41,3558791.46
"13745",2017-05-25 01:36:14,100318.18,3659109.64
"13746",2017-05-25 01:36:14,97913.38,3757023.02
"13747",2017-05-25 01:36:14,76973.52,3833996.54
"13748",2017-05-25 01:36:14,127904.13,3961900.67
"13749",2017-05-25 01:38:19,168978.73,4130879.4
"13750",2017-05-25 01:55:22,216603.09,4347482.49
"13751",2017-05-25 01:55:22,86514.2,4433996.69
"13752",2017-05-25 02:00:18,80120.78,4514117.47
"13753",2017-05-25 02:08:35,55517.88,4569635.35
"13754",2017-05-25 02:08:35,62674.38,4632309.73
"13755",2017-05-25 02:12:30,-4442186.37,190123.359999999
"13756",2017-05-25 02:12:30,80181.38,270304.739999999
"13757",2017-05-25 02:20:54,-80181.38,190123.359999999
"13758",2017-05-25 02:20:54,88699.08,278822.439999999
"13759",2017-05-25 02:27:23,107099.21,385921.649999999
"13760",2017-05-25 02:27:23,85735.21,471656.859999999
"13761",2017-05-25 02:27:23,-88699.08,382957.779999999
"13762",2017-05-25 02:41:16,-192834.42,190123.359999999
"13763",2017-05-25 08:26:03,77795,267918.359999999
"13764",2017-05-25 08:55:13,77795.01,345713.369999999
"13765",2017-05-25 08:55:13,-77795,267918.369999999
"13766",2017-05-25 09:03:43,170018.02,437936.389999999
"13767",2017-05-25 09:03:43,-77795.01,360141.379999999
"13768",2017-05-25 09:06:59,-170018.02,190123.359999999
"13769",2017-05-25 09:14:29,117931.7,308055.059999999
"13770",2017-05-25 09:24:16,124034.73,432089.789999999
"13771",2017-05-25 09:24:16,-117931.7,314158.089999999
"13772",2017-05-25 09:24:16,-117931.7,196226.389999999
"13773",2017-05-25 09:35:24,315864.3,512090.689999999
"13774",2017-05-25 09:35:24,-6103.03,505987.659999999
"13775",2017-05-25 09:48:57,166215.78,672203.439999999
"13776",2017-05-25 09:48:57,-315864.3,356339.139999999
"13777",2017-05-25 10:00:17,104079.8,460418.939999999
"13778",2017-05-25 10:00:17,-166215.78,294203.159999999
"13779",2017-05-25 10:12:47,173820.91,468024.069999999
"13780",2017-05-25 10:12:47,-104079.8,363944.269999999
"13781",2017-05-25 10:16:23,-173820.91,190123.359999999
"13782",2017-05-25 10:42:58,149368.09,339491.449999999
"13783",2017-05-25 10:50:50,-149368.09,190123.359999999
"13784",2017-05-25 10:55:23,148912.56,339035.919999999
"13785",2017-05-25 11:02:13,-148912.56,190123.359999999
"13786",2017-05-25 12:24:44,173996.07,364119.429999999
"13787",2017-05-25 12:24:44,115270.33,479389.759999999
"13788",2017-05-25 12:30:24,-289266.4,190123.359999999
"13789",2017-05-25 12:43:34,228307.54,418430.899999999
"13790",2017-05-25 12:43:34,110795.82,529226.719999999
"13791",2017-05-25 12:57:27,183807.79,713034.509999999
"13792",2017-05-25 12:57:27,-339103.36,373931.149999999
"13793",2017-05-25 13:02:28,-183807.79,190123.359999999
"13794",2017-05-25 13:12:33,140526.05,330649.409999999
"13795",2017-05-25 13:25:16,-140526.05,190123.359999999
"13796",2017-05-25 13:52:57,121757.33,311880.689999999
"13797",2017-05-25 13:52:57,187222.3,499102.989999999
"13798",2017-05-25 14:13:56,145817.38,644920.369999999
"13799",2017-05-25 14:13:56,135118.06,780038.429999999
"13800",2017-05-25 14:13:56,-308979.63,471058.799999999
"13801",2017-05-25 14:25:44,162561.78,633620.579999999
"13802",2017-05-25 14:25:44,-280935.44,352685.139999999
"13803",2017-05-25 14:29:46,-162561.78,190123.359999999
"13804",2017-05-25 14:54:53,134809.47,324932.829999999
"13805",2017-05-25 15:05:12,-134809.47,190123.359999999
"13806",2017-05-25 15:10:04,84759.82,274883.179999999
"13807",2017-05-25 15:10:04,41053.77,315936.949999999
"13808",2017-05-25 15:15:55,-125813.59,190123.359999999
"13809",2017-05-25 15:33:29,64674.38,254797.739999999
"13810",2017-05-25 15:41:40,71619.31,326417.049999999
"13811",2017-05-25 15:41:40,-64674.38,261742.669999999
"13812",2017-05-25 15:47:27,100466.58,362209.249999999
"13813",2017-05-25 15:47:27,-71619.31,290589.939999999
"13814",2017-05-25 15:56:04,71176.44,361766.379999999
"13815",2017-05-25 15:56:04,46809.53,408575.909999999
"13816",2017-05-25 15:56:04,57425.91,466001.819999999
"13817",2017-05-25 15:56:04,-100466.58,365535.239999999
"13818",2017-05-25 16:00:16,47793.23,413328.469999999
"13819",2017-05-25 16:00:16,-175411.88,237916.589999999
"13820",2017-05-25 16:02:31,86690.3,324606.889999999
"13821",2017-05-25 16:24:34,49601.3,374208.189999999
"13822",2017-05-25 16:24:34,-134483.53,239724.659999999
"13823",2017-05-25 16:24:34,-47793.23,191931.429999999
"13824",2017-05-25 16:28:32,47900.14,239831.569999999
"13825",2017-05-25 16:28:32,-1808.07,238023.499999999
"13826",2017-05-25 16:48:36,38331.18,276354.679999999
"13827",2017-05-25 16:48:36,-47900.14,228454.539999999
"13828",2017-05-25 17:03:46,-38331.18,190123.359999999
"13829",2017-05-25 19:04:54,255198.48,445321.839999999
"13830",2017-05-25 19:04:54,182130.82,627452.659999999
"13831",2017-05-25 19:07:28,-437329.3,190123.359999999
"13832",2017-05-25 19:14:04,38763.82,228887.179999999
"13833",2017-05-25 19:14:04,132662.31,361549.489999999
"13834",2017-05-25 19:14:04,153287.09,514836.579999999
"13835",2017-05-25 19:32:35,111232.84,626069.419999999
"13836",2017-05-25 19:32:35,179401.79,805471.209999999
"13837",2017-05-25 19:32:35,73841.51,879312.72
"13838",2017-05-25 19:32:35,-324713.22,554599.5
"13839",2017-05-25 19:32:35,-324713.22,229886.28
"13840",2017-05-25 19:50:44,-39762.92,190123.36
"13841",2017-05-25 20:27:25,100019.63,290142.99
"13842",2017-05-25 20:51:30,-100019.63,190123.36
"13843",2017-05-25 21:24:28,130019.64,320143
"13844",2017-05-25 21:42:03,-130019.64,190123.36
"13845",2017-05-25 21:58:04,130019.65,320143.01
"13846",2017-05-25 21:58:04,130019.62,450162.63
"13847",2017-05-25 22:23:34,-260039.27,190123.36
"13848",2017-05-25 22:50:44,130019.67,320143.03
"13849",2017-05-25 23:02:37,295916.29,616059.32
"13850",2017-05-25 23:02:37,-130019.67,486039.65
"13851",2017-05-25 23:07:23,-295916.29,190123.36
"13852",2017-05-25 23:11:02,184845.79,374969.15
"13853",2017-05-25 23:19:26,136779.42,511748.57
"13854",2017-05-25 23:19:26,106702.67,618451.24
"13855",2017-05-25 23:19:26,-184845.79,433605.45
"13856",2017-05-25 23:25:17,-243482.09,190123.36
"13857",2017-05-25 23:29:49,84590.38,274713.74
"13858",2017-05-25 23:38:31,179012.45,453726.19
"13859",2017-05-25 23:38:31,102296.34,556022.53
"13860",2017-05-25 23:38:31,-84590.38,471432.15
"13861",2017-05-25 23:43:43,130019.74,601451.89
"13862",2017-05-25 23:43:43,-281308.79,320143.1
"13863",2017-05-25 23:47:09,61486.67,381629.77
"13864",2017-05-25 23:58:35,57697.75,439327.52
"13865",2017-05-25 23:58:35,78926.72,518254.24
"13866",2017-05-26 00:10:39,104968.09,623222.33
"13867",2017-05-26 00:13:50,80229,703451.33
"13868",2017-05-26 00:17:30,105625.3,809076.63
"13869",2017-05-26 00:25:11,66515.99,875592.62
"13870",2017-05-26 00:25:11,77796.85,953389.47
"13871",2017-05-26 00:36:47,133789.33,1087178.8
"13872",2017-05-26 00:41:36,111359.44,1198538.24
"13873",2017-05-26 01:30:22,92665.55,1291203.79
"13874",2017-05-26 01:30:22,58779.13,1349982.92
"13875",2017-05-26 01:30:22,76951.31,1426934.23
"13876",2017-05-26 02:01:16,65669.87,1492604.1
"13877",2017-05-26 02:01:28,62761.37,1555365.47
"13878",2017-05-26 02:18:55,82620.79,1637986.26
"13879",2017-05-26 02:41:20,109873.52,1747859.78
"13880",2017-05-26 02:49:14,118914.22,1866774
"13881",2017-05-26 03:06:47,97631.65,1964405.65
"13882",2017-05-26 03:19:24,173985.85,2138391.5
"13883",2017-05-26 07:58:55,108665.71,2247057.21
"13884",2017-05-26 07:58:55,31926.35,2278983.56
"13885",2017-05-26 07:58:55,123870.19,2402853.75
"13886",2017-05-26 07:58:55,-1948268.14,454585.61
"13887",2017-05-26 07:58:55,98529.83,553115.44
"13888",2017-05-26 08:45:09,-362992.08,190123.36
"13889",2017-05-26 10:32:46,90172.21,280295.57
"13890",2017-05-26 10:32:46,109124.35,389419.92
"13891",2017-05-26 10:32:46,87643.98,477063.9
"13892",2017-05-26 10:42:45,-286940.54,190123.36
"13893",2017-05-26 10:54:28,130504.08,320627.44
"13894",2017-05-26 10:56:11,101947.35,422574.79
"13895",2017-05-26 11:03:13,75855.7,498430.49
"13896",2017-05-26 11:03:13,-232451.43,265979.06
"13897",2017-05-26 11:22:02,67378.2,333357.26
"13898",2017-05-26 11:22:02,-75855.7,257501.56
"13899",2017-05-26 11:41:39,61380.25,318881.81
"13900",2017-05-26 11:41:39,49329.33,368211.14
"13901",2017-05-26 11:41:39,-67378.2,300832.94
"13902",2017-05-26 11:41:39,-67378.2,233454.74
"13903",2017-05-26 11:59:02,-43331.38,190123.36
"13904",2017-05-26 13:57:35,75222.62,265345.98
"13905",2017-05-26 13:57:35,311518.17,576864.15
"13906",2017-05-26 14:14:45,160473.87,737338.02
"13907",2017-05-26 14:14:45,137497.81,874835.83
"13908",2017-05-26 14:14:45,-386740.79,488095.04
"13909",2017-05-26 14:35:29,111554.49,599649.53
"13910",2017-05-26 14:35:29,146544.94,746194.47
"13911",2017-05-26 14:35:29,-297971.68,448222.79
"13912",2017-05-26 14:42:10,125839.29,574062.08
"13913",2017-05-26 14:42:10,-258099.43,315962.65
"13914",2017-05-26 14:48:36,91751.68,407714.33
"13915",2017-05-26 14:48:36,68753.17,476467.5
"13916",2017-05-26 14:48:36,-125839.29,350628.21
"13917",2017-05-26 14:53:15,184212.27,534840.48
"13918",2017-05-26 14:53:15,-160504.85,374335.63
"13919",2017-05-26 14:56:49,97353.27,471688.9
"13920",2017-05-26 14:56:49,-184212.27,287476.63
"13921",2017-05-26 15:36:52,121692.03,409168.66
"13922",2017-05-26 15:36:52,154854.58,564023.24
"13923",2017-05-26 15:36:52,104563.53,668586.77
"13924",2017-05-26 15:36:52,-97353.27,571233.5
"13925",2017-05-26 15:36:52,-97353.27,473880.23
"13926",2017-05-26 15:39:30,-283756.87,190123.36
"13927",2017-05-26 15:58:07,65951.45,256074.81
"13928",2017-05-26 15:58:07,104551.13,360625.94
"13929",2017-05-26 15:58:07,80058.07,440684.01
"13930",2017-05-26 16:06:02,125703.48,566387.49
"13931",2017-05-26 16:06:02,-250560.65,315826.84
"13932",2017-05-26 16:13:22,53274.34,369101.18
"13933",2017-05-26 16:13:22,-125703.48,243397.7
"13934",2017-05-26 16:25:17,-53274.34,190123.36
"13935",2017-05-26 18:38:59,107785.92,297909.28
"13936",2017-05-26 18:54:21,177412.52,475321.8
"13937",2017-05-26 18:54:21,129145.36,604467.16
"13938",2017-05-26 18:54:21,-107785.92,496681.24
"13939",2017-05-26 19:27:11,100021.29,596702.53
"13940",2017-05-26 19:27:11,150518.59,747221.12
"13941",2017-05-26 19:27:11,128926.16,876147.28
"13942",2017-05-26 19:27:11,-306557.88,569589.4
"13943",2017-05-26 19:27:11,-306557.88,263031.52
"13944",2017-05-26 19:54:43,130021.3,393052.82
"13945",2017-05-26 19:54:43,-72908.16,320144.66
"13946",2017-05-26 19:54:43,-72908.16,247236.5
"13947",2017-05-26 20:00:17,201659.93,448896.43
"13948",2017-05-26 20:00:17,-57113.14,391783.29
"13949",2017-05-26 20:10:46,166888.57,558671.86
"13950",2017-05-26 20:10:46,110931.38,669603.24
"13951",2017-05-26 20:10:46,-201659.93,467943.31
"13952",2017-05-26 20:11:57,157955.61,625898.92
"13953",2017-05-26 20:15:50,-435775.56,190123.36
"13954",2017-05-26 20:39:50,132435.11,322558.47
"13955",2017-05-26 20:39:50,10021.52,332579.99
"13956",2017-05-26 21:31:28,-142456.63,190123.36
"13957",2017-05-26 22:03:32,462206.32,652329.68
"13958",2017-05-26 22:08:29,304478.83,956808.51
"13959",2017-05-26 22:08:29,89133.06,1045941.57
"13960",2017-05-26 22:15:25,156470.97,1202412.54
"13961",2017-05-26 22:15:25,127700.67,1330113.21
"13962",2017-05-26 22:16:59,239721.76,1569834.97
"13963",2017-05-26 22:54:43,185922.3,1755757.27
"13964",2017-05-26 22:54:43,276877.22,2032634.49
"13965",2017-05-26 22:59:26,165846.92,2198481.41
"13966",2017-05-26 23:09:52,116732.58,2315213.99
"13967",2017-05-26 23:09:52,94672.51,2409886.5
"13968",2017-05-26 23:17:16,83874.29,2493760.79
"13969",2017-05-26 23:27:36,98381.22,2592142.01
"13970",2017-05-27 00:07:33,81827.76,2673969.77
"13971",2017-05-27 00:07:33,56836.68,2730806.45
"13972",2017-05-27 00:07:33,70674.04,2801480.49
"13973",2017-05-27 00:07:33,68126.93,2869607.42
"13974",2017-05-27 00:18:35,90645.68,2960253.1
"13975",2017-05-27 00:21:41,154142.14,3114395.24
"13976",2017-05-27 00:31:27,131450.96,3245846.2
"13977",2017-05-27 01:01:23,100861.75,3346707.95
"13978",2017-05-27 01:05:13,119593,3466300.95
"13979",2017-05-27 01:24:19,168263.16,3634564.11
"13980",2017-05-27 01:24:19,143919.04,3778483.15
"13981",2017-05-27 01:24:19,118497.01,3896980.16
"13982",2017-05-27 01:50:58,185366.45,4082346.61
"13983",2017-05-27 01:50:58,118871.1,4201217.71
"13984",2017-05-27 02:30:53,105041.95,4306259.66
"13985",2017-05-27 02:30:53,159917.37,4466177.03
"13986",2017-05-27 02:30:53,118987.41,4585164.44
"13987",2017-05-27 03:18:04,120680.76,4705845.2
"13988",2017-05-27 03:18:47,143077.76,4848922.96
"13989",2017-05-27 03:32:05,166994.27,5015917.23
"13990",2017-05-27 03:53:24,104969.13,5120886.36
"13991",2017-05-27 04:06:14,155926.56,5276812.92
"13992",2017-05-27 04:06:14,118035.05,5394847.97
"13993",2017-05-27 04:19:27,152339.09,5547187.06
"13994",2017-05-27 04:39:09,124904.23,5672091.29
"13995",2017-05-27 04:39:09,219945.86,5892037.15
"13996",2017-05-27 04:56:08,131842.78,6023879.93
"13997",2017-05-27 04:56:08,155682.89,6179562.82
"13998",2017-05-27 05:01:48,129950.18,6309513
"13999",2017-05-27 05:28:47,161250.77,6470763.77
"14000",2017-05-27 05:28:47,208219.72,6678983.49
"14001",2017-05-27 05:45:16,152209.02,6831192.51
"14002",2017-05-27 05:45:16,111084.18,6942276.69
"14003",2017-05-27 05:45:16,-6488860.13,453416.559999998
"14004",2017-05-27 06:06:31,283627.04,737043.599999998
"14005",2017-05-27 06:06:31,146391.37,883434.969999998
"14006",2017-05-27 06:06:31,-263293.2,620141.769999998
"14007",2017-05-27 06:06:31,-263293.2,356848.569999998
"14008",2017-05-27 06:20:24,298551.27,655399.839999998
"14009",2017-05-27 06:20:24,-166725.21,488674.629999998
"14010",2017-05-27 06:31:22,313431.09,802105.719999998
"14011",2017-05-27 06:31:22,-298551.27,503554.449999998
"14012",2017-05-27 06:54:10,136986.94,640541.389999998
"14013",2017-05-27 06:54:10,139151.56,779692.949999998
"14014",2017-05-27 06:54:10,-313431.09,466261.859999998
"14015",2017-05-27 07:04:02,133282.59,599544.449999998
"14016",2017-05-27 07:04:02,105180.89,704725.339999998
"14017",2017-05-27 07:04:02,-276138.5,428586.839999998
"14018",2017-05-27 07:11:44,-238463.48,190123.359999998
"14019",2017-05-27 07:48:18,104348.17,294471.529999998
"14020",2017-05-27 08:11:37,110214.36,404685.889999998
"14021",2017-05-27 08:11:37,134319.97,539005.859999998
"14022",2017-05-27 08:11:37,-104348.17,434657.689999998
"14023",2017-05-27 08:34:36,111331.35,545989.039999998
"14024",2017-05-27 08:34:36,143758.1,689747.139999998
"14025",2017-05-27 08:34:36,-244534.33,445212.809999998
"14026",2017-05-27 08:51:43,137477.12,582689.929999998
"14027",2017-05-27 08:51:43,-255089.45,327600.479999998
"14028",2017-05-27 08:59:17,-137477.12,190123.359999998
"14029",2017-05-27 08:59:17,140450.86,330574.219999998
"14030",2017-05-27 09:16:14,-140450.86,190123.359999998
"14031",2017-05-27 11:20:26,118110.53,308233.889999998
"14032",2017-05-27 11:23:09,-118110.53,190123.359999998
"14033",2017-05-27 11:40:25,277330.75,467454.109999998
"14034",2017-05-27 11:40:25,300023.29,767477.399999998
"14035",2017-05-27 11:40:25,130023.27,897500.669999998
"14036",2017-05-27 11:45:28,-707377.31,190123.359999998
"14037",2017-05-27 12:06:15,188949.33,379072.689999998
"14038",2017-05-27 12:12:35,-188949.33,190123.359999998
"14039",2017-05-27 12:30:44,165694.71,355818.069999998
"14040",2017-05-27 12:45:36,155504.43,511322.499999998
"14041",2017-05-27 12:45:36,190640.97,701963.469999998
"14042",2017-05-27 12:45:36,-165694.71,536268.759999998
"14043",2017-05-27 12:54:40,204497.21,740765.969999998
"14044",2017-05-27 12:54:40,-346145.4,394620.569999998
"14045",2017-05-27 13:02:22,150770.89,545391.459999998
"14046",2017-05-27 13:02:22,-204497.21,340894.249999998
"14047",2017-05-27 13:07:15,-150770.89,190123.359999998
"14048",2017-05-27 13:35:21,137112.45,327235.809999998
"14049",2017-05-27 13:35:21,164148.36,491384.169999998
"14050",2017-05-27 13:41:51,361706.89,853091.059999998
"14051",2017-05-27 13:41:51,-301260.81,551830.249999998
"14052",2017-05-27 14:07:46,108900.87,660731.119999998
"14053",2017-05-27 14:07:46,181356.92,842088.039999998
"14054",2017-05-27 14:07:46,129067.98,971156.019999998
"14055",2017-05-27 14:07:46,-361706.89,609449.129999998
"14056",2017-05-27 14:20:10,108886.66,718335.789999998
"14057",2017-05-27 14:20:10,-419325.77,299010.019999998
"14058",2017-05-27 14:26:35,174332.25,473342.269999998
"14059",2017-05-27 14:26:35,-108886.66,364455.609999998
"14060",2017-05-27 14:26:35,-108886.66,255568.949999998
"14061",2017-05-27 14:42:22,99858.19,355427.139999998
"14062",2017-05-27 14:42:22,-65445.59,289981.549999998
"14063",2017-05-27 14:42:30,155199.1,445180.649999998
"14064",2017-05-27 15:03:46,126810.65,571991.299999998
"14065",2017-05-27 15:03:46,165091.13,737082.429999998
"14066",2017-05-27 15:03:46,-255057.29,482025.139999998
"14067",2017-05-27 15:03:46,-255057.29,226967.849999998
"14068",2017-05-27 15:14:05,-36844.49,190123.359999998
"14069",2017-05-27 15:57:26,15023.69,205147.049999998
"14070",2017-05-27 15:57:26,167144.75,372291.799999998
"14071",2017-05-27 15:59:42,-182168.44,190123.359999998
"14072",2017-05-27 17:38:21,139664.4,329787.759999998
"14073",2017-05-27 17:38:21,143749.41,473537.169999998
"14074",2017-05-27 17:49:21,169152.67,642689.839999998
"14075",2017-05-27 20:08:09,114587.18,757277.019999998
"14076",2017-05-27 20:38:32,157819.9,915096.919999998
"14077",2017-05-27 20:49:01,157424.44,1072521.36
"14078",2017-05-27 21:07:19,154424.66,1226946.02
"14079",2017-05-27 21:15:32,189872.93,1416818.95
"14080",2017-05-27 21:29:28,150575.25,1567394.2
"14081",2017-05-27 21:36:56,226667.98,1794062.18
"14082",2017-05-27 21:36:56,151406.24,1945468.42
"14083",2017-05-27 21:43:01,179807.63,2125276.05
"14084",2017-05-27 21:59:32,250248.1,2375524.15
"14085",2017-05-27 21:59:32,136194.99,2511719.14
"14086",2017-05-27 22:09:17,162974.17,2674693.31
"14087",2017-05-27 22:09:17,197279.64,2871972.95
"216",2017-05-27 22:58:12,-23165.39,2848807.56
"14088",2017-05-28 04:43:07,-2681849.59,166957.969999998
"14089",2017-05-28 06:22:12,261199.74,428157.709999998
"14090",2017-05-28 06:35:57,-261199.74,166957.969999998
"14091",2017-05-28 08:00:57,62952.09,229910.059999998
"14092",2017-05-28 08:22:43,-62952.09,166957.969999998
"14093",2017-05-28 10:22:20,154891.3,321849.269999998
"14094",2017-05-28 10:25:46,-154891.3,166957.969999998
"14095",2017-05-28 17:49:40,115860.03,282817.999999998
"14096",2017-05-28 17:49:40,129813.72,412631.719999998
"14097",2017-05-28 17:49:40,160489.52,573121.239999998
"14098",2017-05-28 17:49:40,132160.68,705281.919999998
"14099",2017-05-28 18:03:46,251959.68,957241.599999998
"14100",2017-05-28 18:03:46,282842.45,1240084.05
"14101",2017-05-28 18:03:46,-538323.95,701760.099999998
"14102",2017-05-28 18:11:46,-534802.13,166957.969999998
"14103",2017-05-28 18:26:06,188549.6,355507.569999998
"14104",2017-05-28 18:26:06,181253.5,536761.069999998
"14105",2017-05-28 18:45:39,220577.31,757338.379999998
"14106",2017-05-28 18:45:39,166277.23,923615.609999998
"14107",2017-05-28 18:45:39,-369803.1,553812.509999998
"14108",2017-05-28 18:56:40,-386854.54,166957.969999998
"14109",2017-05-28 19:06:30,150382.82,317340.789999998
"14110",2017-05-28 19:29:27,-150382.82,166957.969999998
"14111",2017-05-28 19:53:42,145443.82,312401.789999998
"14112",2017-05-28 20:12:54,-145443.82,166957.969999998
"14113",2017-05-28 20:14:33,162791.46,329749.429999998
"14114",2017-05-28 20:53:16,-162791.46,166957.969999998
"14115",2017-05-28 20:59:54,125762.04,292720.009999998
"14116",2017-05-28 21:05:39,-125762.04,166957.969999998
"14117",2017-05-28 22:47:47,73878.66,240836.629999998
"14118",2017-05-28 22:47:47,127612.76,368449.389999998
"14119",2017-05-28 22:51:18,-201491.42,166957.969999998
"14120",2017-05-29 00:38:29,209925.94,376883.909999998
"14121",2017-05-29 00:52:16,153439.91,530323.819999998
"14122",2017-05-29 00:52:16,-209925.94,320397.879999998
"14123",2017-05-29 01:01:47,-153439.91,166957.969999998
"14124",2017-05-29 01:29:03,140813.03,307770.999999998
"14125",2017-05-29 01:29:03,223554.26,531325.259999998
"14126",2017-05-29 01:41:40,-364367.29,166957.969999998
"14127",2017-05-29 13:09:00,151559.48,318517.449999998
"14128",2017-05-29 13:09:00,174100.85,492618.299999998
"14129",2017-05-29 13:10:05,190006.45,682624.749999998
"14130",2017-05-29 13:15:24,-515666.78,166957.969999998
"217",2017-05-29 14:38:57,7000,173957.969999998
"14131",2017-05-29 14:38:57,182589.73,356547.699999998
"14132",2017-05-29 14:47:57,-182589.73,173957.969999998
"14133",2017-05-29 16:28:42,131509.02,305466.989999998
"14134",2017-05-29 16:33:50,-131509.02,173957.969999998
"14135",2017-05-29 17:28:21,84978.94,258936.909999998
"14136",2017-05-29 17:38:40,-84978.94,173957.969999998
"14137",2017-05-29 17:56:37,97223.04,271181.009999998
"14138",2017-05-29 18:02:03,-97223.04,173957.969999998
"14139",2017-05-29 18:15:31,92944.2,266902.169999998
"14140",2017-05-29 18:15:31,93821.55,360723.719999998
"14141",2017-05-29 18:21:30,-186765.75,173957.969999998
"14142",2017-05-29 18:57:25,163397.34,337355.309999998
"14143",2017-05-29 18:57:25,152411.19,489766.499999998
"14144",2017-05-29 19:20:30,-315808.53,173957.969999998
"14145",2017-05-29 19:28:51,82726.85,256684.819999998
"14146",2017-05-29 19:38:17,-82726.85,173957.969999998
"14147",2017-05-29 19:52:29,131939.2,305897.169999998
"14148",2017-05-29 19:56:49,138859.44,444756.609999998
"14149",2017-05-29 19:56:49,-131939.2,312817.409999998
"14150",2017-05-29 19:59:37,-138859.44,173957.969999998
"14151",2017-05-29 20:11:01,117088.83,291046.799999998
"14152",2017-05-29 20:24:45,105083.41,396130.209999998
"14153",2017-05-29 20:24:45,-117088.83,279041.379999998
"14154",2017-05-29 20:46:13,174627.33,453668.709999998
"14155",2017-05-29 20:46:13,-105083.41,348585.299999998
"14156",2017-05-29 20:55:25,-174627.33,173957.969999998
"218",2017-05-29 23:25:13,70025.23,243983.199999998
"14157",2017-05-29 23:27:12,157700.99,401684.189999998
"219",2017-05-29 23:54:51,-173957.97,227726.219999998
"14158",2017-05-29 23:54:51,76576.35,304302.569999998
"14159",2017-05-29 23:54:51,-157700.99,146601.579999998
"14160",2017-05-29 23:58:55,-76576.35,70025.2299999979
"220",2017-05-30 00:02:57,-70025.23,-2.13913153856993e-09
"221",2017-05-30 00:10:20,47862.56,47862.5599999979
"222",2017-05-30 00:20:28,-47862.56,-2.13913153856993e-09
"223",2017-05-30 00:37:31,42973.96,42973.9599999979
"224",2017-05-30 00:43:24,-42973.96,-2.13913153856993e-09
"14161",2017-05-30 00:49:35,121543.42,121543.419999998
"14162",2017-05-30 01:00:17,54142.04,175685.459999998
"14163",2017-05-30 01:00:17,-121543.42,54142.0399999979
"14164",2017-05-30 01:04:07,-54142.04,-2.13185558095574e-09
"14165",2017-05-30 01:22:15,103067,103066.999999998
"14166",2017-05-30 01:22:15,67260.91,170327.909999998
"14167",2017-05-30 01:25:28,-170327.91,-2.12457962334156e-09
"225",2017-05-30 02:05:57,34153.13,34153.1299999979
"226",2017-05-30 02:09:12,-34153.13,-2.12457962334156e-09
"14168",2017-05-30 02:43:42,60534.63,60534.6299999979
"14169",2017-05-30 02:43:42,91379.73,151914.359999998
"227",2017-05-30 02:48:41,33555.41,185469.769999998
"14170",2017-05-30 02:48:41,50516.83,235986.599999998
"14171",2017-05-30 02:48:41,-151914.36,84072.2399999979
"228",2017-05-30 02:50:32,-33555.41,50516.8299999979
"14172",2017-05-30 03:30:43,-50516.83,-2.11002770811319e-09
"229",2017-05-30 03:45:05,36991.74,36991.7399999979
"230",2017-05-30 04:15:49,-36991.74,-2.11002770811319e-09
"231",2017-05-30 07:23:47,53910.7,53910.6999999979
"232",2017-05-30 07:25:15,-53910.7,-2.11002770811319e-09
"14173",2017-05-30 08:23:33,62528.3,62528.2999999979
"14174",2017-05-30 08:27:25,-62528.3,-2.11002770811319e-09
"14175",2017-05-30 08:38:28,70349.06,70349.0599999979
"14176",2017-05-30 08:51:20,-70349.06,-2.11002770811319e-09
"233",2017-05-30 09:20:19,59361.71,59361.7099999979
"14177",2017-05-30 09:20:19,51090.22,110451.929999998
"234",2017-05-30 09:26:16,-59361.71,51090.2199999979
"14178",2017-05-30 09:26:16,58166.95,109257.169999998
"14179",2017-05-30 09:26:16,-51090.22,58166.9499999979
"14180",2017-05-30 09:29:05,17033.12,75200.0699999979
"14181",2017-05-30 09:29:05,-58166.95,17033.1199999979
"14182",2017-05-30 09:51:01,-17033.12,-2.11366568692029e-09
"14183",2017-05-30 10:14:44,51858.66,51858.6599999979
"14184",2017-05-30 10:14:44,53389.44,105248.099999998
"14185",2017-05-30 10:20:54,50987.46,156235.559999998
"14186",2017-05-30 10:20:54,-105248.1,50987.4599999979
"14187",2017-05-30 10:40:55,70068.46,121055.919999998
"14188",2017-05-30 10:40:55,92326.96,213382.879999998
"14189",2017-05-30 10:40:55,10453.98,223836.859999998
"14190",2017-05-30 10:40:55,-50987.46,172849.399999998
"14191",2017-05-30 10:40:55,-50987.46,121861.939999998
"14192",2017-05-30 10:51:07,-121861.94,-2.06637196242809e-09
"235",2017-05-30 12:26:13,51077.79,51077.7899999979
"236",2017-05-30 12:32:22,-51077.79,-2.06637196242809e-09
"237",2017-05-30 13:47:17,58564.74,58564.7399999979
"238",2017-05-30 13:53:58,-58564.74,-2.06637196242809e-09
"239",2017-05-30 14:42:56,36321.3,36321.2999999979
"240",2017-05-30 14:49:47,-36321.3,-2.06637196242809e-09
"14193",2017-05-30 16:15:39,348511.28,348511.279999998
"14194",2017-05-30 16:19:27,-348511.28,-2.09547579288483e-09
"241",2017-05-30 16:24:52,25566.24,25566.2399999979
"242",2017-05-30 16:34:02,-25566.24,-2.09547579288483e-09
"14195",2017-05-30 16:56:49,79350.58,79350.5799999979
"14196",2017-05-30 17:02:52,-79350.58,-2.09547579288483e-09
"243",2017-05-30 17:37:32,40683.22,40683.2199999979
"244",2017-05-30 18:03:45,-40683.22,-2.09547579288483e-09
"14197",2017-05-30 19:02:09,90972.93,90972.9299999979
"14198",2017-05-30 19:17:18,-90972.93,-2.09547579288483e-09
"245",2017-05-30 19:28:12,50967.86,50967.8599999979
"246",2017-05-30 19:48:15,-50967.86,-2.09547579288483e-09
"247",2017-05-30 20:32:15,58933.23,58933.2299999979
"248",2017-05-30 20:39:17,-58933.23,-2.09547579288483e-09
"249",2017-05-30 20:49:59,39296.35,39296.3499999979
"250",2017-05-30 20:59:18,-39296.35,-2.09547579288483e-09
"251",2017-05-30 22:30:53,23401.93,23401.9299999979
"252",2017-05-30 22:30:53,41883.55,65285.4799999979
"253",2017-05-30 22:33:17,-65285.48,-2.09547579288483e-09
"254",2017-05-30 23:12:18,32137.82,32137.8199999979
"14199",2017-05-30 23:12:18,15154.8,47292.6199999979
"255",2017-05-30 23:15:29,-32137.82,15154.7999999979
"14200",2017-05-30 23:27:14,38332.02,53486.8199999979
"256",2017-05-30 23:38:28,42801.08,96287.8999999979
"14201",2017-05-30 23:38:28,89778.63,186066.529999998
"14202",2017-05-30 23:38:28,125948.48,312015.009999998
"257",2017-05-30 23:48:31,-42801.08,269213.929999998
"14203",2017-05-30 23:48:31,92011.24,361225.169999998
"14204",2017-05-30 23:58:24,50652.89,411878.059999998
"14205",2017-05-30 23:58:24,24571.26,436449.319999998
"258",2017-05-31 00:23:45,13671.74,450121.059999998
"14206",2017-05-31 00:23:45,115188.28,565309.339999998
"14207",2017-05-31 00:23:45,22906.23,588215.569999998
"259",2017-05-31 00:31:14,-13671.74,574543.829999998
"14208",2017-05-31 00:31:14,82518.43,657062.259999998
"260",2017-05-31 00:51:13,24230.82,681293.079999998
"261",2017-05-31 00:52:02,-24230.82,657062.259999998
"14209",2017-05-31 01:55:58,-657062.26,-2.09547579288483e-09
"14210",2017-05-31 01:55:58,88990.34,88990.3399999979
"14211",2017-05-31 02:05:33,-88990.34,-2.09547579288483e-09
"262",2017-05-31 04:17:29,52732.22,52732.2199999979
"263",2017-05-31 04:39:32,-52732.22,-2.09547579288483e-09
"14212",2017-05-31 04:47:38,14128.98,14128.9799999979
"14213",2017-05-31 04:52:29,11052.31,25181.2899999979
"14214",2017-05-31 04:52:29,10129.84,35311.1299999979
"14215",2017-05-31 04:52:29,-14128.98,21182.1499999979
"14216",2017-05-31 05:10:52,181159.46,202341.609999998
"14217",2017-05-31 05:10:52,-21182.15,181159.459999998
"14218",2017-05-31 05:16:45,-181159.46,-2.09547579288483e-09
"264",2017-05-31 05:34:31,42244.78,42244.7799999979
"14219",2017-05-31 05:34:31,60762.75,103007.529999998
"265",2017-05-31 05:40:47,-42244.78,60762.7499999979
"14220",2017-05-31 05:40:47,-60762.75,-2.09547579288483e-09
"266",2017-05-31 06:12:59,68572.6,68572.5999999979
"267",2017-05-31 06:24:33,-68572.6,-2.09547579288483e-09
"268",2017-05-31 07:04:05,51722.82,51722.8199999979
"269",2017-05-31 07:27:34,-51722.82,-2.09547579288483e-09
"14221",2017-05-31 08:59:18,77122.9,77122.8999999979
"14222",2017-05-31 08:59:18,21029.9,98152.7999999979
"14223",2017-05-31 09:08:06,-98152.8,-2.11002770811319e-09
"270",2017-05-31 10:03:41,54815.54,54815.5399999979
"271",2017-05-31 10:28:38,-54815.54,-2.11002770811319e-09
"272",2017-05-31 11:02:43,12276.49,12276.4899999979
"273",2017-05-31 11:06:20,-12276.49,-2.11002770811319e-09
"14224",2017-05-31 12:41:20,26192.76,26192.7599999979
"14225",2017-05-31 12:41:20,9500.52,35693.2799999979
"14226",2017-05-31 12:46:37,-35693.28,-2.11002770811319e-09
"14227",2017-05-31 12:46:37,105556.52,105556.519999998
"14228",2017-05-31 13:20:20,-105556.52,-2.11002770811319e-09
"14229",2017-05-31 14:41:45,72226.02,72226.0199999979
"14230",2017-05-31 14:43:02,-72226.02,-2.11002770811319e-09
"14231",2017-05-31 14:43:02,145444.15,145444.149999998
"14232",2017-05-31 16:04:21,226728.08,372172.229999998
"274",2017-05-31 16:07:51,3277.06,375449.289999998
"275",2017-05-31 16:22:51,-3277.06,372172.229999998
"14233",2017-05-31 16:22:51,140483.72,512655.949999998
"276",2017-05-31 16:33:53,27810.34,540466.289999998
"277",2017-05-31 16:48:50,-27810.34,512655.949999998
"14234",2017-05-31 16:48:50,185161.15,697817.099999998
"278",2017-05-31 19:46:09,48955.91,746773.009999998
"279",2017-05-31 19:49:29,-48955.91,697817.099999998
"14235",2017-06-01 01:34:26,258831.98,956649.079999998
"280",2017-06-01 01:44:50,63343.07,1019992.15
"281",2017-06-01 01:48:36,-63343.07,956649.079999998
"282",2017-06-01 02:05:08,3305.2,959954.279999998
"283",2017-06-01 02:19:48,-3305.2,956649.079999998
"284",2017-06-01 02:34:01,14160.58,970809.659999998
"285",2017-06-01 02:52:27,-14160.58,956649.079999998
"286",2017-06-01 03:03:31,68105.1,1024754.18
"287",2017-06-01 03:09:19,-68105.1,956649.079999998
"288",2017-06-01 04:07:37,12851.55,969500.629999998
"289",2017-06-01 04:25:11,-12851.55,956649.079999998
"290",2017-06-01 04:44:43,44720.89,1001369.97
"291",2017-06-01 04:49:33,-44720.89,956649.079999998
"292",2017-06-01 05:05:26,37518.97,994168.049999998
"293",2017-06-01 05:18:03,-37518.97,956649.079999998
"294",2017-06-01 05:33:39,9120.79,965769.869999998
"295",2017-06-01 05:41:40,-9120.79,956649.079999998
"14236",2017-06-01 05:41:40,92130.94,1048780.02
"296",2017-06-01 05:55:10,8754.56,1057534.58
"297",2017-06-01 05:57:32,-8754.56,1048780.02
"298",2017-06-01 07:03:55,30809.61,1079589.63
"299",2017-06-01 07:11:05,-30809.61,1048780.02
"14237",2017-06-01 07:11:05,66187.13,1114967.15
"300",2017-06-01 07:36:39,14506.99,1129474.14
"14238",2017-06-01 07:36:39,283881.12,1413355.26
"301",2017-06-01 07:59:00,-14506.99,1398848.27
"302",2017-06-01 08:09:13,10452.47,1409300.74
"303",2017-06-01 08:32:54,-10452.47,1398848.27
"14239",2017-06-01 08:32:54,129282.86,1528131.13
"14240",2017-06-01 08:32:54,12146.55,1540277.68
"14241",2017-06-01 09:22:34,56284.09,1596561.77
"304",2017-06-01 09:31:36,53364.4,1649926.17
"14242",2017-06-01 09:31:36,59108.45,1709034.62
"305",2017-06-01 10:02:13,-53364.4,1655670.22
"306",2017-06-01 10:21:35,35483.41,1691153.63
"14243",2017-06-01 10:21:35,36358.2,1727511.83
"14244",2017-06-01 10:21:35,10140.16,1737651.99
"307",2017-06-01 10:52:28,-35483.41,1702168.58
"14245",2017-06-01 10:52:28,65680.56,1767849.14
"14246",2017-06-01 11:15:02,61794.91,1829644.05
"308",2017-06-01 11:40:33,50434.8,1880078.85
"309",2017-06-01 11:46:08,-50434.8,1829644.05
"14247",2017-06-01 12:01:49,79035.59,1908679.64
"14248",2017-06-01 12:01:49,26141.3,1934820.94
"310",2017-06-01 12:37:09,39593.32,1974414.26
"311",2017-06-01 12:38:34,-39593.32,1934820.94
"14249",2017-06-01 12:45:23,76097.16,2010918.1
"14250",2017-06-01 12:45:23,25836.37,2036754.47
"14251",2017-06-01 16:24:58,100203.22,2136957.69
"14252",2017-06-01 16:45:38,62910.98,2199868.67
"14253",2017-06-01 16:45:38,65712.58,2265581.25
"14254",2017-06-01 16:53:44,121786.04,2387367.29
"14255",2017-06-01 17:03:43,67288.83,2454656.12
"14256",2017-06-01 17:17:01,63867.42,2518523.54
"14257",2017-06-01 17:17:01,90971.42,2609494.96
"14258",2017-06-01 17:49:55,-2609494.96,-2.3283064365387e-09
"312",2017-06-01 17:57:42,13352.47,13352.4699999977
"313",2017-06-01 18:09:47,-13352.47,-2.3283064365387e-09
"314",2017-06-01 18:09:47,6230.14,6230.13999999767
"14259",2017-06-01 18:09:47,12946.2,19176.3399999977
"14260",2017-06-01 18:09:47,31466.61,50642.9499999977
"315",2017-06-01 18:14:27,-6230.14,44412.8099999977
"14261",2017-06-01 18:14:27,17624.2,62037.0099999977
"14262",2017-06-01 18:14:27,-44412.81,17624.1999999977
"14263",2017-06-01 18:23:13,-17624.2,-2.33194441534579e-09
"316",2017-06-01 18:32:34,14318.83,14318.8299999977
"317",2017-06-01 18:51:43,-14318.83,-2.33194441534579e-09
"14264",2017-06-01 20:13:42,97147.73,97147.7299999977
"14265",2017-06-01 21:04:38,-97147.73,-2.3283064365387e-09
"14266",2017-06-01 21:50:36,81097.91,81097.9099999977
"14267",2017-06-01 21:58:19,-81097.91,-2.3283064365387e-09
"318",2017-06-01 22:39:20,58060.53,58060.5299999977
"319",2017-06-01 22:45:07,-58060.53,-2.3283064365387e-09
"320",2017-06-01 23:05:49,30384.79,30384.7899999977
"321",2017-06-01 23:14:18,-30384.79,-2.3283064365387e-09
"322",2017-06-02 02:21:30,51184.35,51184.3499999977
"323",2017-06-02 02:28:01,-51184.35,-2.3283064365387e-09
"14268",2017-06-02 05:15:14,71687.39,71687.3899999977
"14269",2017-06-02 05:18:53,-71687.39,-2.3283064365387e-09
"324",2017-06-02 06:13:03,59962.58,59962.5799999977
"325",2017-06-02 06:40:01,-59962.58,-2.3283064365387e-09
"326",2017-06-02 07:59:13,31821.84,31821.8399999977
"327",2017-06-02 08:01:21,-31821.84,-2.3283064365387e-09
"14270",2017-06-02 08:01:21,95980.95,95980.9499999977
"14271",2017-06-02 08:01:21,9150.93,105131.879999998
"14272",2017-06-02 08:04:06,-105131.88,-2.3283064365387e-09
"328",2017-06-02 08:26:01,59559.66,59559.6599999977
"14273",2017-06-02 08:26:01,60503.35,120063.009999998
"14274",2017-06-02 08:26:01,58166.68,178229.689999998
"14275",2017-06-02 08:26:01,10615.68,188845.369999998
"329",2017-06-02 08:34:03,-59559.66,129285.709999998
"14276",2017-06-02 08:34:03,75144.5,204430.209999998
"14277",2017-06-02 08:34:03,-129285.71,75144.4999999977
"14278",2017-06-02 08:39:49,-75144.5,-2.34285835176706e-09
"330",2017-06-02 09:07:35,42074.45,42074.4499999977
"14279",2017-06-02 09:07:35,89321.6,131396.049999998
"14280",2017-06-02 09:07:35,91658.22,223054.269999998
"14281",2017-06-02 09:07:35,23771.57,246825.839999998
"331",2017-06-02 09:15:00,-42074.45,204751.389999998
"14282",2017-06-02 09:15:00,61608.47,266359.859999998
"14283",2017-06-02 09:15:00,-204751.39,61608.4699999976
"14284",2017-06-02 09:15:00,73873.93,135482.399999998
"14285",2017-06-02 09:15:00,100626.01,236108.409999998
"332",2017-06-02 09:42:46,45195.93,281304.339999998
"14286",2017-06-02 09:42:46,94154.05,375458.389999998
"14287",2017-06-02 09:42:46,43331.72,418790.109999998
"14288",2017-06-02 09:42:46,-236108.41,182681.699999998
"333",2017-06-02 09:47:53,-45195.93,137485.769999998
"14289",2017-06-02 09:47:53,-137485.77,-2.3283064365387e-09
"14290",2017-06-02 09:59:40,90661.43,90661.4299999977
"14291",2017-06-02 09:59:40,33497.51,124158.939999998
"14292",2017-06-02 10:10:06,-124158.94,-2.3283064365387e-09
"334",2017-06-02 10:23:03,54303.51,54303.5099999977
"335",2017-06-02 10:28:42,-54303.51,-2.3283064365387e-09
"14293",2017-06-02 10:36:32,62123.72,62123.7199999977
"14294",2017-06-02 10:36:32,43552.64,105676.359999998
"14295",2017-06-02 10:45:46,-105676.36,-2.3283064365387e-09
"336",2017-06-02 10:55:06,65308.98,65308.9799999977
"337",2017-06-02 11:07:12,-65308.98,-2.3283064365387e-09
"338",2017-06-02 13:33:36,67566.5,67566.4999999977
"339",2017-06-02 13:41:04,-67566.5,-2.3283064365387e-09
"14296",2017-06-02 15:13:23,69877.62,69877.6199999977
"14297",2017-06-02 15:18:32,-69877.62,-2.3283064365387e-09
"340",2017-06-02 15:52:06,3640.43,3640.42999999767
"341",2017-06-02 15:57:04,-3640.43,-2.3283064365387e-09
"342",2017-06-02 16:05:26,17362.14,17362.1399999977
"343",2017-06-02 16:11:54,-17362.14,-2.3283064365387e-09
"344",2017-06-02 16:29:22,54558.51,54558.5099999977
"345",2017-06-02 16:52:44,-54558.51,-2.3283064365387e-09
"14298",2017-06-02 17:18:42,18422.65,18422.6499999977
"14299",2017-06-02 17:26:08,-18422.65,-2.3283064365387e-09
"346",2017-06-02 18:03:27,12673.68,12673.6799999977
"14300",2017-06-02 18:03:27,56718.91,69392.5899999977
"347",2017-06-02 18:06:46,-12673.68,56718.9099999977
"14301",2017-06-02 18:06:46,-56718.91,-2.33558239415288e-09
"14302",2017-06-02 18:26:58,60297.61,60297.6099999977
"14303",2017-06-02 18:37:41,71735.49,132033.099999998
"14304",2017-06-02 18:37:41,-60297.61,71735.4899999977
"14305",2017-06-02 18:37:41,-60297.61,11437.8799999977
"14306",2017-06-02 18:41:23,-11437.88,-2.32284946832806e-09
"348",2017-06-02 19:07:03,27662.06,27662.0599999977
"14307",2017-06-02 19:07:03,59922.52,87584.5799999977
"349",2017-06-02 19:15:01,-27662.06,59922.5199999977
"14308",2017-06-02 19:15:01,-59922.52,-2.32103047892451e-09
"350",2017-06-02 19:37:27,9834.44,9834.43999999768
"14309",2017-06-02 19:37:27,67325.94,77160.3799999977
"351",2017-06-02 19:39:29,-9834.44,67325.9399999977
"14310",2017-06-02 20:45:25,84239.33,151565.269999998
"14311",2017-06-02 20:45:25,-67325.94,84239.3299999977
"14312",2017-06-02 20:45:25,-67325.94,16913.3899999977
"14313",2017-06-02 21:04:40,69780.96,86694.3499999977
"352",2017-06-02 21:13:56,13219.94,99914.2899999977
"14314",2017-06-02 21:13:56,-16913.39,83000.8999999977
"353",2017-06-02 21:18:07,-13219.94,69780.9599999977
"14315",2017-06-02 21:18:07,69797.74,139578.699999998
"14316",2017-06-02 21:18:07,-69780.96,69797.7399999977
"14317",2017-06-02 21:31:38,-69797.74,-2.3283064365387e-09
"354",2017-06-02 22:50:40,31256.45,31256.4499999977
"14318",2017-06-02 22:50:40,71685.94,102942.389999998
"14319",2017-06-02 22:50:40,70179.71,173122.099999998
"14320",2017-06-02 22:50:40,76288.37,249410.469999998
"14321",2017-06-02 22:50:40,73764.43,323174.899999998
"14322",2017-06-02 23:02:01,58682.64,381857.539999998
"14323",2017-06-02 23:29:25,70029.72,451887.259999998
"14324",2017-06-03 00:33:52,72880.78,524768.039999998
"355",2017-06-03 00:54:53,-31256.45,493511.589999998
"14325",2017-06-03 01:03:58,-350601.09,142910.499999998
"14326",2017-06-03 01:09:35,-142910.5,-2.3283064365387e-09
"14327",2017-06-03 02:29:59,72619,72618.9999999977
"14328",2017-06-03 02:33:56,-72619,-2.3283064365387e-09
"356",2017-06-03 04:57:53,30019.23,30019.2299999977
"357",2017-06-03 04:59:26,-30019.23,-2.3283064365387e-09
"14329",2017-06-03 05:00:48,113655.34,113655.339999998
"14330",2017-06-03 05:08:24,81059.09,194714.429999998
"358",2017-06-03 05:14:19,14757.57,209471.999999998
"359",2017-06-03 05:18:32,-14757.57,194714.429999998
"14331",2017-06-03 05:23:07,65254.97,259969.399999998
"360",2017-06-03 05:42:42,11990.26,271959.659999998
"361",2017-06-03 05:54:51,-11990.26,259969.399999998
"362",2017-06-03 06:38:34,27393.59,287362.989999998
"363",2017-06-03 06:44:10,-27393.59,259969.399999998
"364",2017-06-03 07:11:16,37233.47,297202.869999998
"365",2017-06-03 07:41:39,-37233.47,259969.399999998
"366",2017-06-03 07:58:09,26061.92,286031.319999998
"367",2017-06-03 07:59:56,-26061.92,259969.399999998
"368",2017-06-03 08:31:08,28898.96,288868.359999998
"369",2017-06-03 08:44:05,-28898.96,259969.399999998
"370",2017-06-03 09:28:01,13155.08,273124.479999998
"371",2017-06-03 09:37:23,-13155.08,259969.399999998
"372",2017-06-03 10:06:44,9139.1,269108.499999998
"373",2017-06-03 10:17:37,-9139.1,259969.399999998
"374",2017-06-03 10:50:50,38021.37,297990.769999998
"375",2017-06-03 10:56:37,-38021.37,259969.399999998
"376",2017-06-03 11:23:26,28112.81,288082.209999998
"377",2017-06-03 11:33:58,-28112.81,259969.399999998
"378",2017-06-03 14:34:28,51959.23,311928.629999998
"379",2017-06-03 14:41:29,-51959.23,259969.399999998
"380",2017-06-03 15:06:23,21419.71,281389.109999998
"381",2017-06-03 15:26:54,-21419.71,259969.399999998
"382",2017-06-03 16:47:50,34202.49,294171.889999998
"383",2017-06-03 16:57:32,-34202.49,259969.399999998
"384",2017-06-03 17:39:13,17137,277106.399999998
"385",2017-06-03 17:42:47,-17137,259969.399999998
"14332",2017-06-03 18:45:04,82307.87,342277.269999998
"386",2017-06-03 19:03:43,32118.02,374395.289999998
"387",2017-06-03 19:09:02,-32118.02,342277.269999998
"14333",2017-06-03 19:14:59,36411.9,378689.169999998
"14334",2017-06-03 19:29:49,82020.24,460709.409999998
"388",2017-06-03 20:11:26,57413.25,518122.659999998
"14335",2017-06-03 20:29:05,79764.61,597887.269999998
"14336",2017-06-03 20:46:40,83532.62,681419.889999998
"14337",2017-06-03 20:46:40,72873.61,754293.499999998
"389",2017-06-03 21:08:14,-57413.25,696880.249999998
"14338",2017-06-03 21:08:14,93159.01,790039.259999998
"14339",2017-06-03 21:08:14,80776.8,870816.059999998
"14340",2017-06-03 21:08:14,142469.63,1013285.69
"14341",2017-06-03 21:15:11,38153.3,1051438.99
"14342",2017-06-03 21:15:11,58376.65,1109815.64
"14343",2017-06-03 21:22:55,95954.04,1205769.68
"14344",2017-06-03 21:24:53,71636.22,1277405.9
"14345",2017-06-03 21:40:09,60737.63,1338143.53
"14346",2017-06-03 22:05:49,60602,1398745.53
"14347",2017-06-03 22:14:36,21567.21,1420312.74
"390",2017-06-03 22:43:04,60092.32,1480405.06
"14348",2017-06-03 22:43:04,117007.73,1597412.79
"391",2017-06-03 22:51:41,-60092.32,1537320.47
"14349",2017-06-03 23:24:23,55424.23,1592744.7
"392",2017-06-04 01:07:46,35359.04,1628103.74
"393",2017-06-04 01:11:08,-35359.04,1592744.7
"14350",2017-06-04 02:57:18,94086.67,1686831.37
"394",2017-06-04 03:20:57,51683.25,1738514.62
"14351",2017-06-04 03:20:57,72935.58,1811450.2
"14352",2017-06-04 03:20:57,122056.4,1933506.6
"14353",2017-06-04 03:20:57,127911.73,2061418.33
"14354",2017-06-04 03:20:57,188365.46,2249783.79
"395",2017-06-04 03:27:26,-51683.25,2198100.54
"14355",2017-06-04 03:27:26,58238.37,2256338.91
"14356",2017-06-04 03:51:17,65386.48,2321725.39
"14357",2017-06-04 04:06:47,60691.29,2382416.68
"396",2017-06-04 04:35:58,56444.97,2438861.65
"397",2017-06-04 05:01:04,-56444.97,2382416.68
"14358",2017-06-04 05:01:04,90494.6,2472911.28
"398",2017-06-04 05:48:23,45755.35,2518666.63
"399",2017-06-04 06:02:38,-45755.35,2472911.28
"400",2017-06-04 06:24:49,44452.31,2517363.59
"401",2017-06-04 06:34:34,-44452.31,2472911.28
"402",2017-06-04 07:03:23,12260.11,2485171.39
"403",2017-06-04 07:17:43,-12260.11,2472911.28
"14359",2017-06-04 07:17:43,44232.5,2517143.78
"14360",2017-06-04 07:29:47,13565.63,2530709.41
"404",2017-06-04 07:46:43,50027.37,2580736.78
"405",2017-06-04 07:49:13,-50027.37,2530709.41
"406",2017-06-04 07:59:28,56842.94,2587552.35
"14361",2017-06-04 07:59:28,59894.3,2647446.65
"407",2017-06-04 08:17:51,-56842.94,2590603.71
"14362",2017-06-04 08:17:51,-2590603.71,-2.3283064365387e-09
"14363",2017-06-04 08:23:22,44268.01,44268.0099999977
"14364",2017-06-04 08:30:02,18971.01,63239.0199999977
"14365",2017-06-04 08:30:02,-44268.01,18971.0099999977
"14366",2017-06-04 08:35:18,-18971.01,-2.3246684577316e-09
"408",2017-06-04 08:50:58,66694.97,66694.9699999977
"409",2017-06-04 08:58:28,-66694.97,-2.3283064365387e-09
"14367",2017-06-04 08:58:28,125334.9,125334.899999998
"14368",2017-06-04 09:08:33,64937.6,190272.499999998
"14369",2017-06-04 09:08:33,-125334.9,64937.5999999977
"14370",2017-06-04 09:16:27,72074.12,137011.719999998
"14371",2017-06-04 09:16:27,-64937.6,72074.1199999977
"14372",2017-06-04 09:22:31,75270.2,147344.319999998
"14373",2017-06-04 09:22:31,-72074.12,75270.1999999977
"14374",2017-06-04 09:30:07,66876.99,142147.189999998
"14375",2017-06-04 09:30:07,-75270.2,66876.9899999977
"14376",2017-06-04 09:33:15,-66876.99,-2.3283064365387e-09
"410",2017-06-04 10:12:36,60289.33,60289.3299999977
"14377",2017-06-04 10:12:36,130040.68,190330.009999998
"411",2017-06-04 10:24:47,-60289.33,130040.679999998
"14378",2017-06-04 10:24:47,56037.49,186078.169999998
"14379",2017-06-04 10:24:47,-130040.68,56037.4899999977
"14380",2017-06-04 10:36:15,-56037.49,-2.30647856369615e-09
"14381",2017-06-04 11:04:04,22868.91,22868.9099999977
"14382",2017-06-04 11:10:19,-22868.91,-2.30647856369615e-09
"14383",2017-06-04 11:16:20,64612.39,64612.3899999977
"14384",2017-06-04 11:34:24,-64612.39,-2.30647856369615e-09
"14385",2017-06-04 13:39:48,72289.33,72289.3299999977
"14386",2017-06-04 13:39:48,127027.2,199316.529999998
"14387",2017-06-04 14:29:36,61388.24,260704.769999998
"412",2017-06-04 14:43:59,90368.21,351072.979999998
"413",2017-06-04 14:51:47,-90368.21,260704.769999998
"414",2017-06-04 21:46:07,61386.47,322091.239999998
"415",2017-06-04 22:17:00,-61386.47,260704.769999998
"14388",2017-06-04 23:19:21,41077.5,301782.269999998
"416",2017-06-04 23:34:47,48494.13,350276.399999998
"417",2017-06-04 23:51:20,-48494.13,301782.269999998
"418",2017-06-05 00:39:46,45596.47,347378.739999998
"419",2017-06-05 00:47:22,-45596.47,301782.269999998
"14389",2017-06-05 01:08:45,99296.06,401078.329999998
"14390",2017-06-05 01:08:45,19241.58,420319.909999998
"420",2017-06-05 01:18:56,19242.95,439562.859999998
"421",2017-06-05 01:32:41,-19242.95,420319.909999998
"422",2017-06-05 01:49:32,8772.04,429091.949999998
"423",2017-06-05 01:57:05,-8772.04,420319.909999998
"14391",2017-06-05 03:45:16,36646.65,456966.559999998
"424",2017-06-05 04:16:07,60169.34,517135.899999998
"425",2017-06-05 04:47:46,-60169.34,456966.559999998
"426",2017-06-05 05:12:09,16038.4,473004.959999998
"427",2017-06-05 05:26:07,-16038.4,456966.559999998
"428",2017-06-05 05:37:21,11968.44,468934.999999998
"429",2017-06-05 05:40:57,-11968.44,456966.559999998
"430",2017-06-05 06:04:58,5033,461999.559999998
"431",2017-06-05 06:04:58,22969,484968.559999998
"432",2017-06-05 06:09:14,-28002,456966.559999998
"433",2017-06-05 06:28:58,7795.39,464761.949999998
"434",2017-06-05 06:28:58,5232.92,469994.869999998
"435",2017-06-05 06:32:33,-13028.31,456966.559999998
"436",2017-06-05 07:21:55,23868.46,480835.019999998
"437",2017-06-05 07:48:17,-23868.46,456966.559999998
"438",2017-06-05 07:55:56,10178.52,467145.079999998
"439",2017-06-05 07:59:20,-10178.52,456966.559999998
"440",2017-06-05 08:58:44,18385.28,475351.839999998
"441",2017-06-05 09:12:29,39844.09,515195.929999998
"442",2017-06-05 09:12:29,-18385.28,496810.649999998
"443",2017-06-05 09:34:54,-39844.09,456966.559999998
"444",2017-06-05 10:36:57,63335.58,520302.139999998
"445",2017-06-05 10:40:40,-63335.58,456966.559999998
"14392",2017-06-05 10:53:12,13881.44,470847.999999998
"14393",2017-06-05 10:53:12,62584.96,533432.959999998
"14394",2017-06-05 11:08:37,79036.18,612469.139999998
"446",2017-06-05 11:41:06,59278.3,671747.439999998
"14395",2017-06-05 11:41:06,67040.06,738787.499999998
"14396",2017-06-05 11:43:30,64171.33,802958.829999998
"447",2017-06-05 11:48:14,-59278.3,743680.529999998
"14397",2017-06-05 12:49:18,29099.63,772780.159999998
"14398",2017-06-05 12:52:28,69616.27,842396.429999998
"448",2017-06-05 14:46:33,62245.17,904641.599999998
"449",2017-06-05 14:59:16,-62245.17,842396.429999998
"14399",2017-06-05 15:39:11,62414.79,904811.219999998
"450",2017-06-05 16:07:18,5411.81,910223.029999998
"14400",2017-06-05 16:07:18,16817.85,927040.879999998
"451",2017-06-05 16:12:19,-5411.81,921629.069999998
"452",2017-06-05 16:21:48,6390.67,928019.739999998
"453",2017-06-05 16:24:58,-6390.67,921629.069999998
"454",2017-06-05 17:04:56,54070.79,975699.859999998
"455",2017-06-05 17:19:44,-54070.79,921629.069999998
"456",2017-06-05 17:39:10,54508.78,976137.849999998
"457",2017-06-05 17:44:36,-54508.78,921629.069999998
"458",2017-06-05 18:45:22,26220.17,947849.239999998
"459",2017-06-05 18:59:53,-26220.17,921629.069999998
"460",2017-06-05 20:16:04,38887.21,960516.279999998
"461",2017-06-05 20:22:41,-38887.21,921629.069999998
"462",2017-06-05 20:40:13,63482.08,985111.149999998
"14401",2017-06-05 20:40:13,113266.19,1098377.34
"14402",2017-06-05 21:22:49,78456.64,1176833.98
"463",2017-06-05 21:25:40,-63482.08,1113351.9
"464",2017-06-05 21:32:06,48976.35,1162328.25
"14403",2017-06-05 21:32:06,114993.58,1277321.83
"465",2017-06-05 21:38:44,-48976.35,1228345.48
"14404",2017-06-05 21:38:44,110445.84,1338791.32
"466",2017-06-05 21:40:28,12258.18,1351049.5
"467",2017-06-05 21:54:32,42386.84,1393436.34
"468",2017-06-05 21:54:32,-12258.18,1381178.16
"469",2017-06-05 22:14:52,-42386.84,1338791.32
"14405",2017-06-05 22:14:52,74832.16,1413623.48
"14406",2017-06-05 22:23:24,74802.25,1488425.73
"470",2017-06-05 22:58:32,34909.55,1523335.28
"471",2017-06-05 22:58:32,45125.72,1568461
"472",2017-06-05 23:05:05,-80035.27,1488425.73
"14407",2017-06-05 23:10:32,66238.79,1554664.52
"14408",2017-06-05 23:34:24,94773.39,1649437.91
"14409",2017-06-05 23:49:11,68373.75,1717811.66
"14410",2017-06-06 00:28:14,20492.05,1738303.71
"14411",2017-06-06 00:28:14,54915.39,1793219.1
"14412",2017-06-06 01:27:37,69053.25,1862272.35
"14413",2017-06-06 01:27:37,113765.79,1976038.14
"14414",2017-06-06 01:27:37,92519.38,2068557.52
"14415",2017-06-06 01:27:37,165808.11,2234365.63
"14416",2017-06-06 01:44:34,287131.99,2521497.62
"14417",2017-06-06 01:44:34,65634,2587131.62
"14418",2017-06-06 01:44:34,70530.4,2657662.02
"14419",2017-06-06 01:59:14,144503.55,2802165.57
"14420",2017-06-06 02:05:52,75644.58,2877810.15
"14421",2017-06-06 02:05:52,97914.11,2975724.26
"14422",2017-06-06 02:19:44,62764.96,3038489.22
"14423",2017-06-06 02:19:44,112419.22,3150908.44
"14424",2017-06-06 02:19:44,75496.09,3226404.53
"14425",2017-06-06 02:19:44,174729.93,3401134.46
"14426",2017-06-06 02:28:01,169492.91,3570627.37
"14427",2017-06-06 02:28:01,87113.86,3657741.23
"14428",2017-06-06 02:32:11,122807.25,3780548.48
"14429",2017-06-06 02:37:39,101999.6,3882548.08
"14430",2017-06-06 02:37:39,210543.75,4093091.83
"14431",2017-06-06 02:40:41,94035.81,4187127.64
"14432",2017-06-06 02:45:55,209869.2,4396996.84
"14433",2017-06-06 02:49:39,140872.77,4537869.61
"14434",2017-06-06 03:01:32,200168.69,4738038.3
"14435",2017-06-06 03:01:32,60819.48,4798857.78
"14436",2017-06-06 03:01:32,53004.81,4851862.59
"14437",2017-06-06 03:14:18,56257.78,4908120.37
"14438",2017-06-06 03:14:18,263883.04,5172003.41
"14439",2017-06-06 03:28:48,64192.36,5236195.77
"14440",2017-06-06 03:28:48,295225.44,5531421.21
"473",2017-06-06 03:37:51,64262.35,5595683.56
"474",2017-06-06 03:37:51,48914.15,5644597.71
"14441",2017-06-06 03:37:51,64820.07,5709417.78
"14442",2017-06-06 03:37:51,5613.63,5715031.41
"14443",2017-06-06 03:37:51,4808.67,5719840.08
"475",2017-06-06 03:42:42,-113176.5,5606663.58
"14444",2017-06-06 03:42:42,95869.2,5702532.78
"14445",2017-06-06 03:42:42,-5606663.58,95869.1999999983
"14446",2017-06-06 03:46:24,100188.65,196057.849999998
"14447",2017-06-06 03:46:24,249417.34,445475.189999998
"14448",2017-06-06 03:46:24,-95869.2,349605.989999998
"14449",2017-06-06 03:54:10,161065.64,510671.629999998
"14450",2017-06-06 03:54:10,135840.27,646511.899999998
"14451",2017-06-06 03:54:10,-349605.99,296905.909999998
"476",2017-06-06 04:01:00,45830.58,342736.489999998
"14452",2017-06-06 04:01:00,67009.28,409745.769999998
"14453",2017-06-06 04:01:00,-296905.91,112839.859999998
"477",2017-06-06 04:07:05,32599.92,145439.779999998
"478",2017-06-06 04:07:05,-45830.58,99609.1999999983
"479",2017-06-06 04:07:05,4377.08,103986.279999998
"14454",2017-06-06 04:07:05,167570.64,271556.919999998
"14455",2017-06-06 04:07:05,229761.77,501318.689999998
"14456",2017-06-06 04:07:05,-67009.28,434309.409999998
"480",2017-06-06 04:13:26,46284.76,480594.169999998
"481",2017-06-06 04:13:26,-36977,443617.169999998
"14457",2017-06-06 04:13:26,-397332.41,46284.7599999983
"14458",2017-06-06 04:14:18,133404.58,179689.339999998
"482",2017-06-06 04:28:28,-46284.76,133404.579999998
"14459",2017-06-06 04:28:28,126683.62,260088.199999998
"14460",2017-06-06 04:28:28,104158.11,364246.309999998
"14461",2017-06-06 04:28:28,75283.93,439530.239999998
"14462",2017-06-06 04:28:28,53766.97,493297.209999998
"14463",2017-06-06 04:28:28,86736.28,580033.489999998
"14464",2017-06-06 04:28:28,-133404.58,446628.909999998
"14465",2017-06-06 04:28:28,-133404.58,313224.329999998
"483",2017-06-06 04:35:55,26012.67,339236.999999998
"484",2017-06-06 04:35:55,27889.69,367126.689999998
"14466",2017-06-06 04:35:55,106250.37,473377.059999998
"14467",2017-06-06 04:35:55,70233.2,543610.259999998
"14468",2017-06-06 04:35:55,58745.05,602355.309999998
"14469",2017-06-06 04:35:55,-313224.33,289130.979999998
"485",2017-06-06 04:43:10,-53902.36,235228.619999998
"14470",2017-06-06 04:43:10,159718.5,394947.119999998
"14471",2017-06-06 04:43:10,-235228.62,159718.499999998
"14472",2017-06-06 04:51:25,85443.18,245161.679999998
"14473",2017-06-06 04:51:25,-159718.5,85443.1799999984
"486",2017-06-06 05:13:47,64835.12,150278.299999998
"14474",2017-06-06 05:13:47,95511.38,245789.679999998
"14475",2017-06-06 05:13:47,103254.57,349044.249999998
"14476",2017-06-06 05:13:47,-85443.18,263601.069999998
"487",2017-06-06 05:25:10,45633.43,309234.499999998
"488",2017-06-06 05:25:10,-64835.12,244399.379999998
"14477",2017-06-06 05:25:10,128651.16,373050.539999998
"14478",2017-06-06 05:25:10,-198765.95,174284.589999998
"489",2017-06-06 05:38:55,-45633.43,128651.159999998
"14479",2017-06-06 05:38:55,214746.51,343397.669999998
"14480",2017-06-06 05:38:55,76056.02,419453.689999998
"14481",2017-06-06 05:38:55,15594.17,435047.859999998
"14482",2017-06-06 05:38:55,-128651.16,306396.699999998
"14483",2017-06-06 05:44:43,-306396.7,-1.57160684466362e-09
"490",2017-06-06 05:55:04,47426.8,47426.7999999984
"14484",2017-06-06 05:55:04,21847.37,69274.1699999984
"491",2017-06-06 06:15:40,38525.51,107799.679999998
"492",2017-06-06 06:15:40,-47426.8,60372.8799999984
"14485",2017-06-06 06:15:40,69363.03,129735.909999998
"14486",2017-06-06 06:15:40,116206.11,245942.019999998
"14487",2017-06-06 06:15:40,-21847.37,224094.649999998
"493",2017-06-06 06:25:45,-38525.51,185569.139999998
"14488",2017-06-06 06:25:45,63429.08,248998.219999998
"14489",2017-06-06 06:25:45,-185569.14,63429.0799999984
"14490",2017-06-06 06:30:43,-63429.08,-1.61526259034872e-09
"14491",2017-06-06 07:21:43,602765.12,602765.119999998
"14492",2017-06-06 07:21:43,71439.27,674204.389999998
"494",2017-06-06 07:50:28,46548.2,720752.589999998
"14493",2017-06-06 07:50:28,23184.09,743936.679999998
"14494",2017-06-06 07:50:28,-674204.39,69732.2899999983
"495",2017-06-06 08:06:30,-46548.2,23184.0899999983
"14495",2017-06-06 08:06:30,-23184.09,-1.70621206052601e-09
"14496",2017-06-06 08:21:24,25762.08,25762.0799999983
"496",2017-06-06 08:29:57,13057.1,38819.1799999983
"14497",2017-06-06 08:29:57,72787.73,111606.909999998
"14498",2017-06-06 08:29:57,-25762.08,85844.8299999983
"497",2017-06-06 08:36:25,-13057.1,72787.7299999983
"14499",2017-06-06 08:36:25,-72787.73,-1.71712599694729e-09
"14500",2017-06-06 09:04:00,77454.05,77454.0499999983
"14501",2017-06-06 09:05:10,-77454.05,-1.71712599694729e-09
"14502",2017-06-06 09:25:54,109808.59,109808.589999998
"14503",2017-06-06 09:37:26,64726.3,174534.889999998
"14504",2017-06-06 09:37:26,-109808.59,64726.2999999983
"14505",2017-06-06 09:41:13,-64726.3,-1.73167791217566e-09
"498",2017-06-06 10:10:25,67689,67688.9999999983
"499",2017-06-06 10:15:44,-67689,-1.73167791217566e-09
"500",2017-06-06 11:14:18,68568.25,68568.2499999983
"501",2017-06-06 11:31:27,-68568.25,-1.73167791217566e-09
"502",2017-06-06 12:02:06,49432.38,49432.3799999983
"14506",2017-06-06 12:02:06,36671.77,86104.1499999983
"503",2017-06-06 12:11:05,-49432.38,36671.7699999983
"14507",2017-06-06 12:11:05,126112.23,162783.999999998
"14508",2017-06-06 12:11:05,-36671.77,126112.229999998
"14509",2017-06-06 12:17:19,177055.27,303167.499999998
"14510",2017-06-06 12:17:19,-126112.23,177055.269999998
"14511",2017-06-06 12:17:19,-126112.23,50943.0399999983
"14512",2017-06-06 12:17:19,87684.06,138627.099999998
"504",2017-06-06 12:32:23,42677.9,181304.999999998
"505",2017-06-06 12:32:23,74463.28,255768.279999998
"14513",2017-06-06 12:32:23,87034.11,342802.389999998
"14514",2017-06-06 12:32:23,177609.34,520411.729999998
"14515",2017-06-06 12:32:23,193756.18,714167.909999998
"14516",2017-06-06 12:32:23,45288.8,759456.709999998
"14517",2017-06-06 12:32:23,-138627.1,620829.609999998
"14518",2017-06-06 12:32:23,5887.06,626716.669999998
"14519",2017-06-06 12:32:23,-138627.1,488089.569999998
"506",2017-06-06 13:04:44,-117141.18,370948.389999998
"14520",2017-06-06 13:04:44,126170.69,497119.079999998
"14521",2017-06-06 13:04:44,75686.99,572806.069999998
"14522",2017-06-06 13:04:44,74388.53,647194.599999998
"14523",2017-06-06 13:04:44,133272.16,780466.759999998
"14524",2017-06-06 13:06:29,99543.14,880009.899999999
"14525",2017-06-06 13:06:29,-370948.39,509061.509999998
"507",2017-06-06 13:24:38,52354,561415.509999998
"14526",2017-06-06 13:24:38,135330.61,696746.119999998
"14527",2017-06-06 13:24:38,-509061.51,187684.609999998
"14528",2017-06-06 13:24:38,6289.44,193974.049999998
"508",2017-06-06 13:45:16,52242.27,246216.319999998
"509",2017-06-06 13:45:16,-52354,193862.319999998
"14529",2017-06-06 13:45:16,65756.21,259618.529999998
"14530",2017-06-06 13:45:16,96831.29,356449.819999998
"14531",2017-06-06 13:45:16,103868.14,460317.959999998
"14532",2017-06-06 13:45:16,-141620.05,318697.909999998
"510",2017-06-06 13:58:13,-52242.27,266455.639999998
"14533",2017-06-06 13:58:13,83661.03,350116.669999998
"14534",2017-06-06 13:58:13,102342.61,452459.279999998
"14535",2017-06-06 13:58:13,-266455.64,186003.639999998
"511",2017-06-06 14:12:50,10740.58,196744.219999998
"14536",2017-06-06 14:12:50,73409.22,270153.439999998
"14537",2017-06-06 14:12:50,-186003.64,84149.7999999984
"512",2017-06-06 14:16:47,-10740.58,73409.2199999984
"14538",2017-06-06 14:16:47,104759.95,178169.169999998
"14539",2017-06-06 14:16:47,-73409.22,104759.949999998
"14540",2017-06-06 14:21:46,109635.13,214395.079999998
"14541",2017-06-06 14:21:46,-104759.95,109635.129999998
"14542",2017-06-06 14:27:15,-109635.13,-1.64436642080545e-09
"513",2017-06-06 15:02:51,54569.19,54569.1899999984
"14543",2017-06-06 15:02:51,159587.98,214157.169999998
"14544",2017-06-06 15:02:51,73372.82,287529.989999998
"514",2017-06-06 15:07:51,-54569.19,232960.799999998
"515",2017-06-06 15:07:51,67751.92,300712.719999998
"14545",2017-06-06 15:07:51,107150.52,407863.239999998
"14546",2017-06-06 15:07:51,-232960.8,174902.439999998
"516",2017-06-06 16:04:17,51365.64,226268.079999998
"14547",2017-06-06 16:04:17,90125.42,316393.499999998
"14548",2017-06-06 16:04:17,82063.02,398456.519999998
"14549",2017-06-06 16:04:17,66621.65,465078.169999998
"14550",2017-06-06 16:33:34,96174.52,561252.689999998
"14551",2017-06-06 16:33:34,185368.95,746621.639999999
"14552",2017-06-06 16:33:34,149686.42,896308.059999999
"517",2017-06-06 16:38:38,-67751.92,828556.139999999
"518",2017-06-06 16:38:38,80035.25,908591.389999999
"519",2017-06-06 16:45:37,-131400.89,777190.499999998
"14553",2017-06-06 16:45:37,83528.94,860719.439999999
"14554",2017-06-06 16:45:37,104920.16,965639.599999999
"14555",2017-06-06 16:45:37,193504.87,1159144.47
"520",2017-06-06 16:50:33,110033.81,1269178.28
"14556",2017-06-06 16:50:33,81706.62,1350884.9
"521",2017-06-06 16:57:40,-110033.81,1240851.09
"14557",2017-06-06 16:57:40,99841,1340692.09
"14558",2017-06-06 16:57:40,72460.02,1413152.11
"14559",2017-06-06 16:57:40,205645.63,1618797.74
"14560",2017-06-06 16:57:40,24598.29,1643396.03
"14561",2017-06-06 17:02:12,121397.95,1764793.98
"14562",2017-06-06 17:02:12,-1643396.03,121397.949999998
"14563",2017-06-06 17:02:12,4592.17,125990.119999998
"14564",2017-06-06 17:02:12,-107150.52,18839.5999999983
"14565",2017-06-06 17:02:12,13425.87,32265.4699999983
"522",2017-06-06 17:15:02,13223.2,45488.6699999983
"523",2017-06-06 17:15:02,8802.86,54291.5299999983
"14566",2017-06-06 17:15:02,110927.63,165219.159999998
"14567",2017-06-06 17:15:02,172246.93,337466.089999998
"14568",2017-06-06 17:15:02,-32265.47,305200.619999998
"524",2017-06-06 17:18:08,-22026.06,283174.559999998
"14569",2017-06-06 17:46:26,293808.44,576982.999999998
"14570",2017-06-06 17:50:56,391097.2,968080.199999998
"525",2017-06-06 18:02:01,65942.87,1034023.07
"14571",2017-06-06 18:02:12,87845.56,1121868.63
"526",2017-06-06 18:05:14,-65942.87,1055925.76
"527",2017-06-06 18:05:14,157390.77,1213316.53
"14572",2017-06-06 18:05:14,150675.01,1363991.54
"528",2017-06-06 18:10:22,54612.9,1418604.44
"529",2017-06-06 18:10:22,-157390.77,1261213.67
"530",2017-06-06 18:27:37,-54612.9,1206600.77
"14573",2017-06-06 18:27:37,149546.98,1356147.75
"14574",2017-06-06 18:27:37,76804.78,1432952.53
"14575",2017-06-06 18:27:37,3798.19,1436750.72
"531",2017-06-06 18:43:26,87190.22,1523940.94
"14576",2017-06-06 18:43:26,39329.54,1563270.48
"14577",2017-06-06 18:43:26,44056.93,1607327.41
"14578",2017-06-06 19:04:09,186400.54,1793727.95
"14579",2017-06-06 19:04:09,61238.64,1854966.59
"14580",2017-06-06 19:18:15,97258.31,1952224.9
"532",2017-06-06 19:46:56,-87190.22,1865034.68
"14581",2017-06-06 20:03:37,65734.82,1930769.5
"14582",2017-06-06 20:03:37,73084.57,2003854.07
"533",2017-06-06 22:06:41,53263.1,2057117.17
"534",2017-06-06 22:18:39,-53263.1,2003854.07
"535",2017-06-06 23:14:17,59170.42,2063024.49
"536",2017-06-06 23:21:22,-59170.42,2003854.07
"537",2017-06-07 00:03:02,91856.94,2095711.01
"538",2017-06-07 00:06:11,-91856.94,2003854.07
"539",2017-06-07 01:16:01,16606.34,2020460.41
"540",2017-06-07 01:19:43,-16606.34,2003854.07
"541",2017-06-07 02:58:14,55032.15,2058886.22
"542",2017-06-07 03:02:22,-55032.15,2003854.07
"543",2017-06-07 05:55:48,13428.99,2017283.06
"544",2017-06-07 06:05:57,-13428.99,2003854.07
"14583",2017-06-07 06:51:59,18946.01,2022800.08
"14584",2017-06-07 07:18:13,158331.6,2181131.68
"14585",2017-06-07 07:18:13,74382.43,2255514.11
"545",2017-06-07 07:39:14,58054.84,2313568.95
"546",2017-06-07 07:57:57,-58054.84,2255514.11
"14586",2017-06-07 08:06:37,53426.5,2308940.61
"14587",2017-06-07 08:20:40,76406.46,2385347.07
"547",2017-06-07 08:34:00,76756.42,2462103.49
"14588",2017-06-07 09:17:54,105294.64,2567398.13
"14589",2017-06-07 09:17:54,76133.01,2643531.14
"548",2017-06-07 09:18:31,-76756.42,2566774.72
"14590",2017-06-07 09:30:51,80973.38,2647748.1
"549",2017-06-07 09:36:08,58404.81,2706152.91
"550",2017-06-07 09:46:26,-58404.81,2647748.1
"14591",2017-06-07 09:46:26,21318.57,2669066.67
"551",2017-06-07 10:06:16,13347.77,2682414.44
"552",2017-06-07 10:34:02,-13347.77,2669066.67
"14592",2017-06-07 10:34:02,68215.36,2737282.03
"14593",2017-06-07 11:00:08,74228.94,2811510.97
"14594",2017-06-07 11:50:46,85061.87,2896572.84
"553",2017-06-07 13:00:44,19692.77,2916265.61
"554",2017-06-07 13:18:07,-19692.77,2896572.84
"14595",2017-06-07 13:18:07,64293.22,2960866.06
"14596",2017-06-07 13:32:07,96255.05,3057121.11
"14597",2017-06-07 13:32:07,27444.07,3084565.18
"14598",2017-06-07 13:52:05,18273.35,3102838.53
"14599",2017-06-07 13:52:05,24908.55,3127747.08
"14600",2017-06-07 13:52:05,20718.3,3148465.38
"555",2017-06-07 13:59:54,21521.79,3169987.17
"14601",2017-06-07 13:59:54,68118.04,3238105.21
"556",2017-06-07 14:06:02,-21521.79,3216583.42
"14602",2017-06-07 14:06:02,92848.24,3309431.66
"14603",2017-06-07 14:42:08,26576.31,3336007.97
"557",2017-06-07 14:54:35,69507.96,3405515.93
"14604",2017-06-07 14:54:35,17591.81,3423107.74
"558",2017-06-07 15:04:21,-69507.96,3353599.78
"14605",2017-06-07 15:09:09,72645.43,3426245.21
"559",2017-06-07 16:04:20,87893.72,3514138.93
"560",2017-06-07 16:04:20,26487.67,3540626.6
"561",2017-06-07 16:04:57,-114381.39,3426245.21
"14606",2017-06-07 16:17:37,98089.71,3524334.92
"14607",2017-06-07 16:17:37,32754.77,3557089.69
"14608",2017-06-07 16:28:08,139665.87,3696755.56
"562",2017-06-07 16:31:10,18704.78,3715460.34
"563",2017-06-07 16:35:15,-18704.78,3696755.56
"14609",2017-06-07 16:35:15,116102.83,3812858.39
"564",2017-06-07 17:17:30,26886.55,3839744.94
"565",2017-06-07 17:31:03,-26886.55,3812858.39
"14610",2017-06-07 17:31:03,66598.24,3879456.63
"566",2017-06-07 18:12:40,3880.62,3883337.25
"567",2017-06-07 18:15:25,-3880.62,3879456.63
"14611",2017-06-07 19:02:17,66521.24,3945977.87
"568",2017-06-07 19:37:28,15757.27,3961735.14
"569",2017-06-07 19:50:26,-15757.27,3945977.87
"14612",2017-06-07 19:50:26,64331.14,4010309.01
"14613",2017-06-07 19:54:07,67263.48,4077572.49
"570",2017-06-07 21:04:31,18558.44,4096130.93
"571",2017-06-07 21:07:42,-18558.44,4077572.49
"14614",2017-06-07 21:07:42,140781.34,4218353.83
"14615",2017-06-07 22:09:44,104851.77,4323205.6
"572",2017-06-07 22:32:40,81874.92,4405080.52
"14616",2017-06-07 22:32:40,156717.64,4561798.16
"14617",2017-06-07 22:32:40,178427.49,4740225.65
"14618",2017-06-07 22:32:40,237147.3,4977372.95
"573",2017-06-07 22:56:07,73392.43,5050765.38
"574",2017-06-07 22:56:07,-81874.92,4968890.46
"14619",2017-06-07 22:56:07,70685.08,5039575.54
"14620",2017-06-07 22:56:07,64867.4,5104442.94
"14621",2017-06-07 22:56:07,68185.69,5172628.63
"14622",2017-06-07 22:56:07,73043.06,5245671.69
"14623",2017-06-07 22:56:07,80188.48,5325860.17
"575",2017-06-07 23:01:54,-73392.43,5252467.74
"576",2017-06-07 23:03:09,55241.39,5307709.13
"577",2017-06-07 23:18:17,100819.32,5408528.45
"578",2017-06-07 23:18:17,-55241.39,5353287.06
"14624",2017-06-07 23:18:17,176362.47,5529649.53
"14625",2017-06-07 23:18:17,114433.13,5644082.66
"579",2017-06-07 23:24:40,-100819.32,5543263.34
"14626",2017-06-07 23:24:40,143454.02,5686717.36
"14627",2017-06-07 23:29:00,35736.73,5722454.09
"580",2017-06-08 00:04:34,64516.82,5786970.91
"581",2017-06-08 00:12:18,-64516.82,5722454.09
"14628",2017-06-08 00:12:18,91585,5814039.09
"582",2017-06-08 00:21:48,13984.01,5828023.1
"14629",2017-06-08 00:21:48,107271.55,5935294.65
"583",2017-06-08 00:29:25,-13984.01,5921310.64
"14630",2017-06-08 00:29:25,137837.74,6059148.38
"14631",2017-06-08 00:30:20,104283.13,6163431.51
"584",2017-06-08 00:32:17,73704.93,6237136.44
"585",2017-06-08 00:34:06,-73704.93,6163431.51
"14632",2017-06-08 00:34:06,146119.95,6309551.46
"14633",2017-06-08 00:40:04,77149.02,6386700.48
"14634",2017-06-08 00:46:14,99244.7,6485945.18
"14635",2017-06-08 00:46:14,77120.84,6563066.02
"14636",2017-06-08 00:59:42,89173.07,6652239.09
"586",2017-06-08 01:21:06,75337.06,6727576.15
"14637",2017-06-08 01:21:06,76612.55,6804188.7
"14638",2017-06-08 01:21:06,118090.99,6922279.69
"14639",2017-06-08 01:21:06,71720.6,6994000.29
"14640",2017-06-08 01:21:06,13588.61,7007588.9
"587",2017-06-08 01:33:48,-75337.06,6932251.84
"14641",2017-06-08 01:33:48,153718.37,7085970.21
"14642",2017-06-08 01:33:48,82875.82,7168846.03
"14643",2017-06-08 01:33:48,7109.3,7175955.33
"14644",2017-06-08 01:33:48,102030.09,7277985.42
"588",2017-06-08 01:48:16,56690.43,7334675.85
"589",2017-06-08 02:01:45,-56690.43,7277985.42
"14645",2017-06-08 02:01:45,165410.74,7443396.16
"14646",2017-06-08 02:16:46,100647.63,7544043.79
"14647",2017-06-08 02:16:46,80765.7,7624809.49
"14648",2017-06-08 02:29:13,104397.93,7729207.42
"14649",2017-06-08 08:08:41,-7729207.42,-9.31322574615479e-10
"590",2017-06-08 09:43:58,60286.74,60286.7399999991
"591",2017-06-08 09:43:58,61910.21,122196.949999999
"592",2017-06-08 09:45:31,63348.76,185545.709999999
"14650",2017-06-08 13:30:04,68296.02,253841.729999999
"14651",2017-06-08 13:41:32,67306.29,321148.019999999
"14652",2017-06-08 14:28:37,65184.29,386332.309999999
"14653",2017-06-08 14:28:37,70739.36,457071.669999999
"14654",2017-06-08 14:28:37,73466.55,530538.219999999
"14655",2017-06-08 15:17:32,74708.14,605246.359999999
"14656",2017-06-08 15:28:49,69778.21,675024.569999999
"14657",2017-06-08 15:47:18,77221.8,752246.369999999
"14658",2017-06-08 18:23:03,66762.71,819009.079999999
"14659",2017-06-08 19:01:56,67056.66,886065.739999999
"14660",2017-06-08 19:06:56,78715.58,964781.319999999
"593",2017-06-08 22:16:01,-185545.71,779235.609999999
"594",2017-06-09 01:24:04,23196.07,802431.679999999
"595",2017-06-09 01:31:00,-23196.07,779235.609999999
"14661",2017-06-09 02:29:36,11470.31,790705.919999999
"596",2017-06-09 03:04:08,66505.9,857211.819999999
"14662",2017-06-09 03:04:08,137092.27,994304.089999999
"14663",2017-06-09 03:04:08,116796.83,1111100.92
"597",2017-06-09 03:20:25,-66505.9,1044595.02
"598",2017-06-09 06:43:29,12047.02,1056642.04
"599",2017-06-09 06:48:41,-12047.02,1044595.02
"600",2017-06-09 07:11:45,64090.9,1108685.92
"601",2017-06-09 07:25:20,-64090.9,1044595.02
"602",2017-06-09 09:28:29,69366.87,1113961.89
"603",2017-06-09 09:32:34,-69366.87,1044595.02
"604",2017-06-09 10:17:16,58671.71,1103266.73
"605",2017-06-09 10:31:36,-58671.71,1044595.02
"606",2017-06-09 11:43:15,56909.42,1101504.44
"607",2017-06-09 11:46:28,-56909.42,1044595.02
"608",2017-06-09 14:00:05,76177.19,1120772.21
"609",2017-06-09 14:10:01,-76177.19,1044595.02
"610",2017-06-09 14:21:47,66509.63,1111104.65
"611",2017-06-09 14:34:56,-66509.63,1044595.02
"14664",2017-06-09 14:40:27,77024.68,1121619.7
"612",2017-06-09 15:29:42,16378.78,1137998.48
"14665",2017-06-09 15:29:42,75861.97,1213860.45
"613",2017-06-09 15:33:23,-16378.78,1197481.67
"614",2017-06-09 15:40:51,70830.96,1268312.63
"615",2017-06-09 15:43:33,-70830.96,1197481.67
"14666",2017-06-09 16:14:49,44870.13,1242351.8
"616",2017-06-09 17:15:34,69762.59,1312114.39
"617",2017-06-09 17:26:25,-69762.59,1242351.8
"618",2017-06-09 19:11:59,70958.89,1313310.69
"619",2017-06-09 19:33:41,-70958.89,1242351.8
"620",2017-06-09 21:12:30,84324.33,1326676.13
"621",2017-06-09 21:24:11,-84324.33,1242351.8
"622",2017-06-09 22:14:32,65404.24,1307756.04
"623",2017-06-09 22:26:33,-65404.24,1242351.8
"624",2017-06-09 23:18:43,63313.97,1305665.77
"625",2017-06-09 23:26:32,-63313.97,1242351.8
"626",2017-06-09 23:50:54,18534.19,1260885.99
"627",2017-06-09 23:57:00,-18534.19,1242351.8
"628",2017-06-09 23:57:00,57558.34,1299910.14
"629",2017-06-10 00:17:43,-57558.34,1242351.8
"630",2017-06-10 01:53:50,58389.03,1300740.83
"631",2017-06-10 02:09:09,-58389.03,1242351.8
"632",2017-06-10 02:53:43,66174.76,1308526.56
"633",2017-06-10 02:58:03,-66174.76,1242351.8
"634",2017-06-10 03:41:41,75983.17,1318334.97
"635",2017-06-10 04:13:33,-75983.17,1242351.8
"636",2017-06-10 05:12:23,58746.17,1301097.97
"637",2017-06-10 05:16:01,-58746.17,1242351.8
"638",2017-06-10 06:18:41,84665.31,1327017.11
"639",2017-06-10 06:51:24,-84665.31,1242351.8
"640",2017-06-10 07:13:07,58335.6,1300687.4
"14667",2017-06-10 07:13:07,-1242351.8,58335.5999999989
"641",2017-06-10 08:22:54,-58335.6,-1.06956576928496e-09
"642",2017-06-10 08:47:00,23957.95,23957.9499999989
"643",2017-06-10 09:00:49,-23957.95,-1.06956576928496e-09
"14668",2017-06-10 10:04:44,12254.9,12254.8999999989
"14669",2017-06-10 10:23:11,-12254.9,-1.06956576928496e-09
"14670",2017-06-10 10:38:58,21509.71,21509.7099999989
"14671",2017-06-10 10:57:12,-21509.71,-1.06956576928496e-09
"644",2017-06-10 11:02:25,70655.05,70655.0499999989
"14672",2017-06-10 11:02:25,80771.38,151426.429999999
"645",2017-06-10 11:09:21,-70655.05,80771.3799999989
"14673",2017-06-10 11:09:21,-80771.38,-1.06228981167078e-09
"646",2017-06-10 11:48:23,77456.63,77456.6299999989
"647",2017-06-10 11:50:28,-77456.63,-1.06228981167078e-09
"648",2017-06-10 12:28:16,70950.18,70950.1799999989
"14674",2017-06-10 13:02:26,14072.11,85022.2899999989
"649",2017-06-10 13:07:19,-70950.18,14072.1099999989
"650",2017-06-10 13:41:54,71229.78,85301.8899999989
"651",2017-06-10 13:41:54,86954.01,172255.899999999
"652",2017-06-10 13:53:49,-158183.79,14072.1099999989
"653",2017-06-10 14:35:26,67735.14,81807.2499999989
"654",2017-06-10 14:42:07,-67735.14,14072.1099999989
"14675",2017-06-10 14:53:48,66968.86,81040.9699999989
"14676",2017-06-10 15:04:21,111055.51,192096.479999999
"655",2017-06-10 17:42:48,123459.56,315556.039999999
"14677",2017-06-10 17:42:48,172549.66,488105.699999999
"656",2017-06-10 17:48:13,-123459.56,364646.139999999
"14678",2017-06-10 18:40:28,124864.51,489510.649999999
"14679",2017-06-10 18:40:28,233212.37,722723.019999999
"14680",2017-06-10 18:41:10,48624.43,771347.449999999
"657",2017-06-10 20:22:01,7617.55,778964.999999999
"658",2017-06-10 20:22:01,7921.07,786886.069999999
"659",2017-06-10 20:29:58,-15538.62,771347.449999999
"660",2017-06-10 20:42:22,60442.83,831790.279999999
"661",2017-06-10 20:54:56,-60442.83,771347.449999999
"662",2017-06-10 21:29:06,70255.33,841602.779999999
"663",2017-06-10 21:58:34,-70255.33,771347.449999999
"14681",2017-06-10 22:26:30,98805.14,870152.589999999
"14682",2017-06-10 22:30:19,112611.22,982763.809999999
"664",2017-06-10 23:10:12,102553.76,1085317.57
"14683",2017-06-10 23:10:12,73798.57,1159116.14
"665",2017-06-10 23:19:54,-102553.76,1056562.38
"666",2017-06-10 23:46:54,81525.36,1138087.74
"667",2017-06-10 23:52:46,-81525.36,1056562.38
"14684",2017-06-10 23:52:46,96412.34,1152974.72
"14685",2017-06-11 00:00:35,105175.28,1258150
"14686",2017-06-11 00:00:35,66977.62,1325127.62
"668",2017-06-11 00:20:18,14948.35,1340075.97
"669",2017-06-11 00:33:22,-14948.35,1325127.62
"14687",2017-06-11 00:33:22,148127.46,1473255.08
"14688",2017-06-11 00:41:58,67670.79,1540925.87
"670",2017-06-11 01:21:56,58400.6,1599326.47
"14689",2017-06-11 01:21:56,105140.9,1704467.37
"14690",2017-06-11 01:21:56,94307.66,1798775.03
"671",2017-06-11 01:43:09,-58400.6,1740374.43
"14691",2017-06-11 02:27:09,119642.96,1860017.39
"14692",2017-06-11 02:27:09,157345.15,2017362.54
"672",2017-06-11 04:42:20,71658.47,2089021.01
"14693",2017-06-11 05:04:28,12970.13,2101991.14
"14694",2017-06-11 05:12:08,99761.9,2201753.04
"14695",2017-06-11 05:12:08,70949.34,2272702.38
"673",2017-06-11 06:35:28,-71658.47,2201043.91
"14696",2017-06-11 06:49:40,57746.88,2258790.79
"674",2017-06-11 07:28:23,77196.57,2335987.36
"675",2017-06-11 07:41:22,-77196.57,2258790.79
"676",2017-06-11 08:31:28,65740.82,2324531.61
"677",2017-06-11 08:35:38,-65740.82,2258790.79
"678",2017-06-11 09:18:04,15022.44,2273813.23
"679",2017-06-11 09:26:42,-15022.44,2258790.79
"680",2017-06-11 09:36:30,83820.93,2342611.72
"681",2017-06-11 09:52:20,-83820.93,2258790.79
"14697",2017-06-11 10:23:31,105451.4,2364242.19
"682",2017-06-11 10:51:46,129019.16,2493261.35
"683",2017-06-11 10:56:04,-129019.16,2364242.19
"684",2017-06-11 11:18:50,65110.44,2429352.63
"685",2017-06-11 11:21:04,-65110.44,2364242.19
"686",2017-06-11 11:43:40,17927.47,2382169.66
"687",2017-06-11 11:56:21,-17927.47,2364242.19
"14698",2017-06-11 13:30:44,137817.86,2502060.05
"688",2017-06-11 14:18:28,83276.96,2585337.01
"689",2017-06-11 14:23:51,-83276.96,2502060.05
"14699",2017-06-11 14:23:51,191379.13,2693439.18
"14700",2017-06-11 14:53:42,191379.13,2884818.31
"14701",2017-06-11 14:53:42,118658.55,3003476.86
"14702",2017-06-11 14:53:42,72802.73,3076279.59
"14703",2017-06-11 15:15:54,111435.9,3187715.49
"14704",2017-06-11 15:33:19,215429.01,3403144.5
"14705",2017-06-11 15:33:19,83608.78,3486753.28
"690",2017-06-11 15:38:02,91166.68,3577919.96
"691",2017-06-11 15:41:37,67846.59,3645766.55
"692",2017-06-11 15:41:37,-91166.68,3554599.87
"14706",2017-06-11 15:41:37,74636.94,3629236.81
"14707",2017-06-11 15:42:29,76381.9,3705618.71
"693",2017-06-11 16:03:04,65619.47,3771238.18
"694",2017-06-11 16:03:04,75823.17,3847061.35
"695",2017-06-11 16:03:04,-67846.59,3779214.76
"14708",2017-06-11 16:03:04,70566.65,3849781.41
"14709",2017-06-11 16:03:04,81402.33,3931183.74
"14710",2017-06-11 16:03:04,89136.23,4020319.97
"14711",2017-06-11 16:03:04,74001.86,4094321.83
"696",2017-06-11 16:09:13,-141442.64,3952879.19
"14712",2017-06-11 16:09:13,225797.61,4178676.8
"697",2017-06-11 16:30:03,97467.03,4276143.83
"698",2017-06-11 16:45:45,75398.32,4351542.15
"699",2017-06-11 16:45:45,-97467.03,4254075.12
"14713",2017-06-11 16:45:45,133081.58,4387156.7
"14714",2017-06-11 16:45:45,95270.16,4482426.86
"700",2017-06-11 16:56:43,-75398.32,4407028.54
"14715",2017-06-11 16:56:43,82868.39,4489896.93
"14716",2017-06-11 17:13:13,66870.5,4556767.43
"701",2017-06-11 18:22:00,70059.33,4626826.76
"14717",2017-06-11 18:22:00,86610.66,4713437.42
"702",2017-06-11 18:34:49,9057.14,4722494.56
"703",2017-06-11 18:34:49,-70059.33,4652435.23
"14718",2017-06-11 18:34:49,120005.91,4772441.14
"14719",2017-06-11 18:34:49,85873.94,4858315.08
"14720",2017-06-11 18:34:49,106145.5,4964460.58
"704",2017-06-11 18:38:37,-9057.14,4955403.44
"14721",2017-06-11 21:02:13,77642.4,5033045.84
"14722",2017-06-11 21:13:19,87815.69,5120861.53
"705",2017-06-11 21:20:40,93839.9,5214701.43
"14723",2017-06-11 21:20:40,86354.92,5301056.35
"706",2017-06-11 21:25:30,-93839.9,5207216.45
"14724",2017-06-11 21:26:10,94811.03,5302027.48
"707",2017-06-11 21:30:07,80473.94,5382501.42
"708",2017-06-11 21:42:59,-80473.94,5302027.48
"14725",2017-06-11 21:42:59,56842.54,5358870.02
"709",2017-06-11 21:58:57,12925.8,5371795.82
"14726",2017-06-11 21:58:57,101953.16,5473748.98
"14727",2017-06-11 21:58:57,88939.47,5562688.45
"710",2017-06-11 22:25:36,-12925.8,5549762.65
"14728",2017-06-11 22:25:36,121087.06,5670849.71
"14729",2017-06-12 06:11:34,89918.68,5760768.39
"14730",2017-06-12 06:11:34,25067.97,5785836.36
"14731",2017-06-12 06:11:34,28792.94,5814629.3
"14732",2017-06-12 06:18:50,107297.7,5921927
"14733",2017-06-12 06:18:50,108880.29,6030807.29
"14734",2017-06-12 06:48:50,89136.23,6119943.52
"14735",2017-06-12 06:53:33,73353.92,6193297.44
"711",2017-06-12 07:03:01,127428.86,6320726.3
"712",2017-06-12 07:10:21,-127428.86,6193297.44
"713",2017-06-12 07:31:31,122486.16,6315783.6
"714",2017-06-12 07:51:44,-122486.16,6193297.44
"715",2017-06-12 09:08:18,60742.29,6254039.73
"716",2017-06-12 09:25:15,-60742.29,6193297.44
"717",2017-06-12 10:14:01,12463.31,6205760.75
"718",2017-06-12 10:15:55,-12463.31,6193297.44
"719",2017-06-12 10:36:38,4813.49,6198110.93
"720",2017-06-12 10:40:33,-4813.49,6193297.44
"14736",2017-06-12 10:40:33,69509.49,6262806.93
"14737",2017-06-12 10:40:33,250081.34,6512888.27
"14738",2017-06-12 11:00:07,85757.75,6598646.02
"721",2017-06-12 11:16:24,67926.65,6666572.67
"722",2017-06-12 11:16:24,22268.57,6688841.24
"14739",2017-06-12 11:16:24,128037.64,6816878.88
"14740",2017-06-12 11:16:24,284072.65,7100951.53
"723",2017-06-12 11:30:05,-90195.22,7010756.31
"14741",2017-06-12 11:30:05,78522.29,7089278.6
"14742",2017-06-12 11:30:05,4505.94,7093784.54
"724",2017-06-12 11:39:17,84278.04,7178062.58
"725",2017-06-12 11:54:36,91194.79,7269257.37
"726",2017-06-12 11:54:36,-84278.04,7184979.33
"14743",2017-06-12 11:54:36,154820.16,7339799.49
"14744",2017-06-12 11:54:36,191298.62,7531098.11
"727",2017-06-12 12:06:46,-91194.79,7439903.32
"14745",2017-06-12 12:06:46,74794.2,7514697.52
"14746",2017-06-12 12:06:46,128673.57,7643371.09
"14747",2017-06-12 12:11:01,199173.61,7842544.7
"14748",2017-06-12 12:11:01,241102.47,8083647.17
"728",2017-06-12 12:20:21,93249.85,8176897.02
"14749",2017-06-12 12:20:21,122398.02,8299295.04
"729",2017-06-12 12:31:18,-93249.85,8206045.19
"14750",2017-06-12 12:31:18,97079.97,8303125.16
"730",2017-06-12 12:51:45,61861.71,8364986.87
"14751",2017-06-12 12:51:45,81816.52,8446803.39
"14752",2017-06-12 12:51:45,108799.26,8555602.65
"731",2017-06-12 12:56:50,-61861.71,8493740.94
"14753",2017-06-12 12:57:57,128944.28,8622685.22
"732",2017-06-12 13:11:21,5889.77,8628574.99
"14754",2017-06-12 13:11:21,258859.36,8887434.35
"733",2017-06-12 13:22:45,-5889.77,8881544.58
"14755",2017-06-12 13:22:45,87928.06,8969472.64
"14756",2017-06-12 13:22:45,79273.21,9048745.85
"14757",2017-06-12 13:22:45,106085.82,9154831.67
"734",2017-06-12 13:38:43,10815.43,9165647.1
"14758",2017-06-12 13:38:43,78635.07,9244282.17
"14759",2017-06-12 13:38:43,101340.85,9345623.02
"14760",2017-06-12 13:38:43,56548.34,9402171.36
"14761",2017-06-12 13:38:43,13621.55,9415792.91
"14762",2017-06-12 13:38:43,43395.45,9459188.36
"735",2017-06-12 13:55:18,-10815.43,9448372.93
"14763",2017-06-12 13:55:18,71464.78,9519837.71
"14764",2017-06-12 14:05:53,93064.84,9612902.55
"14765",2017-06-12 14:05:53,58346.48,9671249.03
"14766",2017-06-12 14:07:54,84831.99,9756081.02
"14767",2017-06-12 14:16:37,159520.15,9915601.17
"14768",2017-06-12 14:16:37,81376.49,9996977.66
"14769",2017-06-12 14:16:37,23772.97,10020750.63
"14770",2017-06-12 14:21:00,4729.01,10025479.64
"736",2017-06-12 14:36:00,63111.46,10088591.1
"14771",2017-06-12 14:36:00,100032.17,10188623.27
"737",2017-06-12 14:54:26,-63111.46,10125511.81
"14772",2017-06-12 15:11:33,69930.75,10195442.56
"14773",2017-06-12 15:11:33,20165.74,10215608.3
"738",2017-06-12 15:26:44,9128.62,10224736.92
"14774",2017-06-12 15:26:44,219448.39,10444185.31
"14775",2017-06-12 15:26:44,62372.75,10506558.06
"14776",2017-06-12 15:26:44,144080.55,10650638.61
"14777",2017-06-12 15:26:44,36394.26,10687032.87
"739",2017-06-12 15:41:16,59873.55,10746906.42
"740",2017-06-12 15:41:16,-9128.62,10737777.8
"14778",2017-06-12 15:41:16,64996.77,10802774.57
"14779",2017-06-12 15:41:16,403447.06,11206221.63
"741",2017-06-12 15:50:16,6279.65,11212501.28
"742",2017-06-12 15:50:16,-59873.55,11152627.73
"743",2017-06-12 15:54:27,-6279.65,11146348.08
"14780",2017-06-12 15:54:27,139747.31,11286095.39
"14781",2017-06-12 15:59:18,58961.18,11345056.57
"14782",2017-06-12 16:25:57,95504.34,11440560.91
"14783",2017-06-12 16:33:03,292161.05,11732721.96
"14784",2017-06-12 16:33:03,117301.54,11850023.5
"14785",2017-06-12 16:38:48,60607.59,11910631.09
"14786",2017-06-12 16:53:55,88715.28,11999346.37
"14787",2017-06-12 16:53:55,139645.82,12138992.19
"744",2017-06-12 17:07:33,129762.07,12268754.26
"14788",2017-06-12 17:07:33,157878.54,12426632.8
"14789",2017-06-12 17:07:33,165835.29,12592468.09
"745",2017-06-12 17:18:51,70088.02,12662556.11
"746",2017-06-12 17:18:51,-129762.07,12532794.04
"14790",2017-06-12 17:18:51,107967.24,12640761.28
"747",2017-06-12 17:34:04,-70088.02,12570673.26
"14791",2017-06-12 17:34:04,206653.9,12777327.16
"14792",2017-06-12 17:34:04,131914.23,12909241.39
"14793",2017-06-12 17:47:31,107683.24,13016924.63
"748",2017-06-12 18:16:12,93410.6,13110335.23
"749",2017-06-12 18:16:12,82718.69,13193053.92
"14794",2017-06-12 18:16:12,188479.37,13381533.29
"14795",2017-06-12 18:16:12,151477.96,13533011.25
"750",2017-06-12 18:24:05,-176129.29,13356881.96
"14796",2017-06-12 18:24:05,120031.47,13476913.43
"14797",2017-06-12 18:42:36,300665.6,13777579.03
"14798",2017-06-12 18:42:36,143934.88,13921513.91
"751",2017-06-12 19:38:21,100049.2,14021563.11
"14799",2017-06-12 19:38:21,83305.65,14104868.76
"14800",2017-06-12 19:38:21,107581.34,14212450.1
"752",2017-06-12 19:43:55,-100049.2,14112400.9
"14801",2017-06-12 19:57:17,15801.79,14128202.69
"753",2017-06-12 20:22:41,60152.59,14188355.28
"754",2017-06-12 20:22:41,67086.17,14255441.45
"755",2017-06-12 20:43:56,-127238.76,14128202.69
"756",2017-06-12 20:43:56,21010.22,14149212.91
"757",2017-06-12 21:00:03,-21010.22,14128202.69
"14802",2017-06-12 22:41:54,72741.45,14200944.14
"758",2017-06-12 22:42:29,95142.46,14296086.6
"759",2017-06-12 22:46:09,-95142.46,14200944.14
"14803",2017-06-12 22:46:09,521151.9,14722096.04
"760",2017-06-12 23:11:18,50292.52,14772388.56
"14804",2017-06-12 23:11:18,82674.88,14855063.44
"14805",2017-06-12 23:11:18,253242.42,15108305.86
"14806",2017-06-12 23:11:18,32366.08,15140671.94
"14807",2017-06-12 23:11:18,66199.26,15206871.2
"14808",2017-06-12 23:11:18,126179.53,15333050.73
"761",2017-06-12 23:24:14,-50292.52,15282758.21
"14809",2017-06-12 23:35:36,98804.32,15381562.53
"14810",2017-06-12 23:35:36,472846.79,15854409.32
"14811",2017-06-12 23:35:36,13823.98,15868233.3
"14812",2017-06-13 00:22:05,129448.45,15997681.75
"14813",2017-06-13 00:22:05,65196.98,16062878.73
"14814",2017-06-13 00:22:05,91057.15,16153935.88
"14815",2017-06-13 00:22:05,13285.17,16167221.05
"762",2017-06-13 00:25:15,59399.13,16226620.18
"14816",2017-06-13 00:25:15,74346.17,16300966.35
"14817",2017-06-13 00:25:15,147434.09,16448400.44
"763",2017-06-13 00:36:54,-59399.13,16389001.31
"764",2017-06-13 01:46:24,77094.94,16466096.25
"765",2017-06-13 01:48:08,-77094.94,16389001.31
"14818",2017-06-13 02:02:22,67371.93,16456373.24
"14819",2017-06-13 03:29:01,87607.87,16543981.11
"14820",2017-06-13 03:29:01,60249.93,16604231.04
"14821",2017-06-13 03:29:01,60343.2,16664574.24
"14822",2017-06-13 03:29:01,101279.99,16765854.23
"14823",2017-06-13 04:07:40,82570.09,16848424.32
"14824",2017-06-13 04:07:40,63260.14,16911684.46
"14825",2017-06-13 04:07:40,78048.75,16989733.21
"14826",2017-06-13 04:07:40,84673.59,17074406.8
"14827",2017-06-13 04:07:40,66159.79,17140566.59
"14828",2017-06-13 07:58:25,-17140566.59,-3.72529029846191e-09
"766",2017-06-13 08:07:14,51626.92,51626.9199999963
"767",2017-06-13 08:07:14,68548.12,120175.039999996
"768",2017-06-13 08:20:59,-120175.04,-3.72529029846191e-09
"769",2017-06-13 08:20:59,63564.19,63564.1899999963
"770",2017-06-13 08:28:36,-63564.19,-3.72529029846191e-09
"771",2017-06-13 10:41:01,71519.79,71519.7899999963
"772",2017-06-13 10:41:01,26974.63,98494.4199999963
"773",2017-06-13 11:00:01,-98494.42,-3.72529029846191e-09
"14829",2017-06-13 11:00:01,7146.74,7146.73999999627
"14830",2017-06-13 11:18:15,-7146.74,-3.72529029846191e-09
"14831",2017-06-13 11:42:14,109231.72,109231.719999996
"774",2017-06-13 12:09:31,71783.43,181015.149999996
"14832",2017-06-13 12:09:31,-109231.72,71783.4299999963
"775",2017-06-13 12:23:09,-71783.43,-3.72529029846191e-09
"14833",2017-06-13 12:23:09,84564.88,84564.8799999963
"14834",2017-06-13 12:23:09,140875.39,225440.269999996
"14835",2017-06-13 12:33:59,78445.22,303885.489999996
"14836",2017-06-13 12:33:59,-225440.27,78445.2199999963
"14837",2017-06-13 12:38:41,97031.36,175476.579999996
"14838",2017-06-13 12:38:41,-78445.22,97031.3599999963
"14839",2017-06-13 12:38:41,-78445.22,18586.1399999963
"14840",2017-06-13 13:01:46,63777.54,82363.6799999963
"14841",2017-06-13 13:01:46,91248.85,173612.529999996
"14842",2017-06-13 13:01:46,-18586.14,155026.389999996
"14843",2017-06-13 13:11:01,-155026.39,-3.72529029846191e-09
"776",2017-06-13 13:31:41,3732.17,3732.16999999627
"777",2017-06-13 13:47:39,-3732.17,-3.72529029846191e-09
"14844",2017-06-13 13:47:39,100678.8,100678.799999996
"14845",2017-06-13 13:58:13,-100678.8,-3.72529029846191e-09
"14846",2017-06-13 14:02:53,48912.25,48912.2499999963
"14847",2017-06-13 14:33:39,-48912.25,-3.72529029846191e-09
"14848",2017-06-13 17:48:14,93969.16,93969.1599999963
"778",2017-06-13 18:23:10,62133.21,156102.369999996
"14849",2017-06-13 18:23:10,-93969.16,62133.2099999963
"779",2017-06-13 18:25:47,-62133.21,-3.7325662560761e-09
"14850",2017-06-13 19:30:22,22452.5,22452.4999999963
"14851",2017-06-13 19:32:52,-22452.5,-3.7325662560761e-09
"14852",2017-06-13 20:34:37,18737.59,18737.5899999963
"14853",2017-06-13 20:55:55,-18737.59,-3.7325662560761e-09
"14854",2017-06-13 21:35:31,19007.76,19007.7599999963
"14855",2017-06-13 21:39:27,-19007.76,-3.7325662560761e-09
"14856",2017-06-14 01:21:26,77822.04,77822.0399999963
"780",2017-06-14 03:50:03,77822.09,155644.129999996
"781",2017-06-14 04:24:13,-77822.09,77822.0399999963
"782",2017-06-14 06:23:50,77822.18,155644.219999996
"783",2017-06-14 06:39:13,-77822.18,77822.0399999963
"784",2017-06-14 08:22:26,125210.61,203032.649999996
"785",2017-06-14 08:34:31,-125210.61,77822.0399999962
"14857",2017-06-14 08:47:49,205658.55,283480.589999996
"14858",2017-06-14 08:47:49,100045.21,383525.799999996
"786",2017-06-14 08:55:19,86067.27,469593.069999996
"14859",2017-06-14 08:55:19,371821.13,841414.199999996
"787",2017-06-14 09:32:40,-86067.27,755346.929999996
"14860",2017-06-14 09:32:40,190750.59,946097.519999996
"788",2017-06-14 10:48:36,67468.75,1013566.27
"789",2017-06-14 10:55:38,-67468.75,946097.519999996
"790",2017-06-14 12:37:26,97782.75,1043880.27
"791",2017-06-14 12:53:06,-97782.75,946097.519999996
"792",2017-06-14 14:24:35,62685.56,1008783.08
"14861",2017-06-14 14:24:35,239032.97,1247816.05
"793",2017-06-14 14:31:48,-62685.56,1185130.49
"794",2017-06-14 15:40:52,76600.72,1261731.21
"14862",2017-06-14 15:40:52,87845.27,1349576.48
"795",2017-06-14 15:51:40,-76600.72,1272975.76
"14863",2017-06-14 16:18:38,77166.64,1350142.4
"796",2017-06-14 16:52:21,89759.05,1439901.45
"14864",2017-06-14 16:52:21,165289.34,1605190.79
"797",2017-06-14 16:59:35,-89759.05,1515431.74
"798",2017-06-14 16:59:35,10848.69,1526280.43
"14865",2017-06-14 16:59:35,70045.67,1596326.1
"799",2017-06-14 17:03:51,-10848.69,1585477.41
"800",2017-06-14 17:10:25,70045.69,1655523.1
"801",2017-06-14 17:10:25,77674.08,1733197.18
"14866",2017-06-14 17:10:25,80045.68,1813242.86
"802",2017-06-14 17:13:54,77695.84,1890938.7
"803",2017-06-14 17:13:54,-147719.77,1743218.93
"14867",2017-06-14 17:13:54,236206.99,1979425.92
"804",2017-06-14 17:41:24,-77695.84,1901730.08
"14868",2017-06-14 17:41:24,101093.79,2002823.87
"14869",2017-06-14 17:41:24,145279.7,2148103.57
"14870",2017-06-14 17:41:24,80045.7,2228149.27
"14871",2017-06-14 17:41:24,50027.3,2278176.57
"14872",2017-06-14 17:41:24,17193.98,2295370.55
"805",2017-06-14 17:59:13,61685.36,2357055.91
"14873",2017-06-14 17:59:13,130045.76,2487101.67
"14874",2017-06-14 17:59:13,84672.76,2571774.43
"14875",2017-06-14 17:59:13,10339.02,2582113.45
"806",2017-06-14 18:11:57,-61685.36,2520428.09
"14876",2017-06-14 18:11:57,134121.83,2654549.92
"14877",2017-06-14 18:11:57,88380.56,2742930.48
"14878",2017-06-14 18:11:57,75098.47,2818028.95
"14879",2017-06-14 18:18:10,90013.56,2908042.51
"807",2017-06-14 18:38:42,4050.23,2912092.74
"14880",2017-06-14 18:38:42,105207.62,3017300.36
"14881",2017-06-14 18:38:42,95957.26,3113257.62
"14882",2017-06-14 18:38:42,69548.98,3182806.6
"808",2017-06-14 18:49:10,95297.92,3278104.52
"809",2017-06-14 18:49:10,-4050.23,3274054.29
"810",2017-06-14 18:54:27,-95297.92,3178756.37
"14883",2017-06-14 18:54:27,60361.69,3239118.06
"14884",2017-06-14 18:54:27,167139.8,3406257.86
"811",2017-06-14 19:11:31,74167.29,3480425.15
"14885",2017-06-14 19:11:31,157521.42,3637946.57
"14886",2017-06-14 19:11:31,55312.36,3693258.93
"14887",2017-06-14 19:11:31,45753.15,3739012.08
"14888",2017-06-14 19:11:31,4328,3743340.08
"812",2017-06-14 19:22:36,-74167.29,3669172.79
"14889",2017-06-14 19:22:36,53277.79,3722450.58
"14890",2017-06-14 19:35:45,54400.49,3776851.07
"14891",2017-06-14 19:35:45,60550.91,3837401.98
"14892",2017-06-14 19:35:45,119027.8,3956429.78
"14893",2017-06-14 19:35:45,77173.73,4033603.51
"14894",2017-06-14 20:01:23,119695.82,4153299.33
"14895",2017-06-14 20:01:23,54453.47,4207752.8
"14896",2017-06-14 20:01:23,55033.95,4262786.75
"14897",2017-06-14 20:01:23,88357.04,4351143.79
"14898",2017-06-14 20:01:23,87551.43,4438695.22
"14899",2017-06-14 20:01:23,15429.89,4454125.10999999
"14900",2017-06-14 20:14:32,52806.87,4506931.97999999
"14901",2017-06-14 20:14:32,71481.51,4578413.48999999
"813",2017-06-14 20:22:31,60318.41,4638731.89999999
"814",2017-06-14 20:32:02,57181.57,4695913.47
"815",2017-06-14 20:32:02,-60318.41,4635595.05999999
"14902",2017-06-14 20:32:02,74681.32,4710276.38
"816",2017-06-14 20:40:07,-57181.57,4653094.80999999
"14903",2017-06-14 20:40:07,96272.13,4749366.93999999
"14904",2017-06-14 20:49:06,84063.76,4833430.69999999
"817",2017-06-14 21:13:15,13296.43,4846727.12999999
"14905",2017-06-14 21:13:15,74288.3,4921015.42999999
"818",2017-06-14 21:25:18,-13296.43,4907718.99999999
"14906",2017-06-14 21:25:18,77514.44,4985233.43999999
"14907",2017-06-14 21:45:19,231704.73,5216938.17
"14908",2017-06-14 21:51:09,152702.45,5369640.62
"819",2017-06-14 22:09:57,7998.17,5377638.79
"14909",2017-06-14 22:09:57,59963.67,5437602.46
"14910",2017-06-14 22:09:57,210901.26,5648503.72
"14911",2017-06-14 22:09:57,93598.15,5742101.87
"820",2017-06-14 22:12:33,-7998.17,5734103.7
"821",2017-06-14 22:12:33,56190.38,5790294.08
"14912",2017-06-14 22:12:33,73217.78,5863511.86
"822",2017-06-14 22:32:51,106055.33,5969567.19
"823",2017-06-14 22:32:51,-56190.38,5913376.81
"824",2017-06-14 22:45:46,-106055.33,5807321.48
"14913",2017-06-14 22:45:46,77823.28,5885144.76
"14914",2017-06-14 22:45:46,145050,6030194.76
"14915",2017-06-14 22:45:46,343855.83,6374050.59
"825",2017-06-14 22:56:08,69630.7,6443681.29
"826",2017-06-14 23:22:12,187670.84,6631352.13
"827",2017-06-14 23:22:12,-69630.7,6561721.43
"14916",2017-06-14 23:22:12,70365.42,6632086.85
"14917",2017-06-14 23:22:12,132098.81,6764185.66
"14918",2017-06-14 23:22:12,88934.34,6853120
"14919",2017-06-14 23:22:12,4728.73,6857848.73
"14920",2017-06-14 23:26:15,50410.76,6908259.49
"828",2017-06-14 23:46:01,-187670.84,6720588.65
"14921",2017-06-14 23:46:01,88934.41,6809523.06
"14922",2017-06-14 23:46:01,253333.9,7062856.96
"14923",2017-06-15 00:00:00,104925.29,7167782.25
"14924",2017-06-15 00:07:39,44644.44,7212426.69
"14925",2017-06-15 00:07:39,92126.65,7304553.34
"14926",2017-06-15 00:07:39,3054.72,7307608.06
"14927",2017-06-15 00:08:53,99029.89,7406637.95
"829",2017-06-15 00:18:40,50649.44,7457287.39
"14928",2017-06-15 00:18:40,128416,7585703.39
"14929",2017-06-15 00:18:40,177823.5,7763526.89
"830",2017-06-15 00:24:50,-50649.44,7712877.45
"831",2017-06-15 01:01:08,77823.52,7790700.97
"832",2017-06-15 01:01:08,80046.57,7870747.54
"14930",2017-06-15 01:01:08,81973.29,7952720.83
"14931",2017-06-15 01:01:08,188934.55,8141655.38
"14932",2017-06-15 01:01:08,61429.2,8203084.58
"14933",2017-06-15 01:01:08,180046.56,8383131.14
"14934",2017-06-15 01:01:08,91380.07,8474511.21
"833",2017-06-15 01:25:46,-157870.09,8316641.12
"14935",2017-06-15 01:25:46,155229.19,8471870.30999999
"14936",2017-06-15 01:25:46,50274.43,8522144.73999999
"14937",2017-06-15 01:25:46,89203.85,8611348.58999999
"14938",2017-06-15 01:37:26,153176.87,8764525.45999999
"14939",2017-06-15 01:37:26,104546.36,8869071.81999999
"14940",2017-06-15 01:48:59,86213.1,8955284.91999999
"14941",2017-06-15 01:48:59,35953.26,8991238.17999999
"834",2017-06-15 02:12:22,60791.44,9052029.61999999
"835",2017-06-15 02:12:22,10728.75,9062758.36999999
"14942",2017-06-15 02:12:22,119865.25,9182623.61999999
"836",2017-06-15 02:16:38,57479.41,9240103.02999999
"837",2017-06-15 02:16:38,-71520.19,9168582.83999999
"838",2017-06-15 02:31:30,-57479.41,9111103.42999999
"14943",2017-06-15 02:50:59,43927.81,9155031.23999999
"839",2017-06-15 02:59:28,19522.32,9174553.55999999
"840",2017-06-15 03:05:57,-19522.32,9155031.23999999
"841",2017-06-15 03:27:10,76848.96,9231880.19999999
"842",2017-06-15 03:30:33,-76848.96,9155031.23999999
"843",2017-06-15 03:41:24,83103,9238134.23999999
"14944",2017-06-15 03:41:24,53403.39,9291537.62999999
"844",2017-06-15 03:55:49,-83103,9208434.62999999
"14945",2017-06-15 03:55:49,23488.32,9231922.94999999
"14946",2017-06-15 04:17:03,80985.66,9312908.60999999
"14947",2017-06-15 04:17:03,50385,9363293.60999999
"845",2017-06-15 04:23:09,70338.67,9433632.27999999
"846",2017-06-15 04:26:36,-70338.67,9363293.60999999
"14948",2017-06-15 04:26:36,157460.38,9520753.98999999
"14949",2017-06-15 04:33:27,104753.43,9625507.41999999
"14950",2017-06-15 04:33:27,130108.18,9755615.59999999
"14951",2017-06-15 04:33:27,30305.46,9785921.05999999
"847",2017-06-15 04:54:07,22092.17,9808013.22999999
"14952",2017-06-15 04:54:07,247910.02,10055923.25
"14953",2017-06-15 04:54:07,124101.43,10180024.68
"14954",2017-06-15 04:54:07,88618.92,10268643.6
"14955",2017-06-15 04:54:07,72886.85,10341530.45
"848",2017-06-15 04:57:22,-22092.17,10319438.28
"14956",2017-06-15 05:00:41,124164.98,10443603.26
"14957",2017-06-15 05:10:19,177983.41,10621586.67
"849",2017-06-15 05:34:00,60095.32,10681681.99
"850",2017-06-15 05:34:00,6338.38,10688020.37
"14958",2017-06-15 05:34:00,258615.11,10946635.48
"14959",2017-06-15 05:34:00,112294.31,11058929.79
"14960",2017-06-15 05:34:00,68330.03,11127259.82
"14961",2017-06-15 05:34:00,35870.66,11163130.48
"851",2017-06-15 06:02:57,-66433.7,11096696.78
"14962",2017-06-15 06:02:57,58075.86,11154772.64
"14963",2017-06-15 06:02:57,127841.63,11282614.27
"14964",2017-06-15 06:02:57,400269.4,11682883.67
"852",2017-06-15 06:13:27,115822.89,11798706.56
"853",2017-06-15 06:15:24,-115822.89,11682883.67
"14965",2017-06-15 06:22:58,383507.9,12066391.57
"14966",2017-06-15 06:22:58,14480.05,12080871.62
"854",2017-06-15 06:34:14,5658.04,12086529.66
"855",2017-06-15 06:46:17,-5658.04,12080871.62
"14967",2017-06-15 07:04:33,188148.65,12269020.27
"14968",2017-06-15 07:04:33,97940.9,12366961.17
"14969",2017-06-15 07:06:48,280377.41,12647338.58
"856",2017-06-15 07:30:40,77759.34,12725097.92
"857",2017-06-15 07:31:45,-77759.34,12647338.58
"14970",2017-06-15 07:56:46,134848.61,12782187.19
"14971",2017-06-15 07:56:46,162489.15,12944676.34
"14972",2017-06-15 07:56:46,83413.37,13028089.71
"14973",2017-06-15 07:56:46,60457.56,13088547.27
"14974",2017-06-15 07:56:46,26960.66,13115507.93
"14975",2017-06-15 08:03:09,70351.88,13185859.81
"14976",2017-06-15 08:03:09,130047.23,13315907.04
"858",2017-06-15 08:16:45,166650.2,13482557.24
"859",2017-06-15 08:23:27,-166650.2,13315907.04
"14977",2017-06-15 08:23:27,85682.4,13401589.44
"14978",2017-06-15 08:26:52,84892.44,13486481.88
"14979",2017-06-15 08:26:52,86588.33,13573070.21
"860",2017-06-15 09:06:37,61558.85,13634629.06
"14980",2017-06-15 09:06:37,104385.51,13739014.57
"14981",2017-06-15 09:06:37,62922.58,13801937.15
"14982",2017-06-15 09:06:37,131376.26,13933313.41
"14983",2017-06-15 09:06:37,17483.74,13950797.15
"861",2017-06-15 09:23:52,66311.99,14017109.14
"862",2017-06-15 09:23:52,-61558.85,13955550.29
"863",2017-06-15 09:30:19,-66311.99,13889238.3
"14984",2017-06-15 09:30:19,77192.52,13966430.82
"864",2017-06-15 09:39:21,75083.24,14041514.06
"14985",2017-06-15 09:39:21,62096.2,14103610.26
"865",2017-06-15 10:07:08,-75083.24,14028527.02
"14986",2017-06-15 10:07:08,81979.57,14110506.59
"14987",2017-06-15 10:07:08,66737.7,14177244.29
"14988",2017-06-15 10:07:08,150065.3,14327309.59
"14989",2017-06-15 10:07:08,122924.97,14450234.56
"14990",2017-06-15 10:27:32,177824.44,14628059
"14991",2017-06-15 10:29:40,80338.58,14708397.58
"14992",2017-06-15 10:31:38,38122.48,14746520.06
"866",2017-06-15 10:49:14,56909.83,14803429.89
"14993",2017-06-15 10:49:14,135138.99,14938568.88
"14994",2017-06-15 10:49:14,79846.85,15018415.73
"867",2017-06-15 10:53:39,-56909.83,14961505.9
"868",2017-06-15 11:25:52,62243.55,15023749.45
"869",2017-06-15 11:25:52,77824.56,15101574.01
"870",2017-06-15 11:25:52,67513.4,15169087.41
"14995",2017-06-15 11:25:52,133495.89,15302583.3
"14996",2017-06-15 11:25:52,195080.08,15497663.38
"14997",2017-06-15 11:25:52,125512.97,15623176.35
"14998",2017-06-15 11:25:52,177935.55,15801111.9
"871",2017-06-15 13:19:25,88936.55,15890048.45
"14999",2017-06-15 13:19:25,384566.49,16274614.94
"15000",2017-06-15 13:19:25,300048.54,16574663.48
"15001",2017-06-15 13:19:25,70048.53,16644712.01
"15002",2017-06-15 13:19:25,177824.57,16822536.58
"872",2017-06-15 13:49:04,77825.59,16900362.17
"15003",2017-06-15 13:49:04,177825.58,17078187.75
"15004",2017-06-15 13:51:18,300048.6,17378236.35
"15005",2017-06-15 14:05:04,93527.4,17471763.75
"15006",2017-06-15 14:26:03,370048.62,17841812.37
"873",2017-06-15 14:38:01,-207581.51,17634230.86
"15007",2017-06-15 14:38:01,170242.11,17804472.97
"15008",2017-06-15 14:38:01,71322.12,17875795.09
"874",2017-06-15 14:57:03,-166762.14,17709032.95
"15009",2017-06-15 14:57:03,74620.53,17783653.48
"15010",2017-06-15 14:57:03,171673.87,17955327.35
"15011",2017-06-15 14:57:03,101298.96,18056626.31
"15012",2017-06-15 15:03:27,95841.75,18152468.06
"875",2017-06-15 15:18:05,3557.38,18156025.44
"876",2017-06-15 15:18:05,4330.99,18160356.43
"15013",2017-06-15 15:18:05,83067.27,18243423.7
"15014",2017-06-15 15:18:05,177825.74,18421249.44
"15015",2017-06-15 15:18:05,245764.13,18667013.57
"877",2017-06-15 15:22:24,-7888.37,18659125.2
"878",2017-06-15 15:37:36,4605.46,18663730.66
"15016",2017-06-15 15:37:36,191022.12,18854752.78
"15017",2017-06-15 15:37:36,3103.56,18857856.34
"15018",2017-06-15 15:37:36,36831.05,18894687.39
"879",2017-06-15 15:39:29,102381.79,18997069.18
"880",2017-06-15 15:39:29,-4605.46,18992463.72
"881",2017-06-15 15:48:57,-102381.79,18890081.93
"882",2017-06-15 16:14:34,66164.45,18956246.38
"883",2017-06-15 16:14:34,39837.34,18996083.72
"15019",2017-06-15 16:14:34,32652.24,19028735.96
"15020",2017-06-15 16:14:34,35567.67,19064303.63
"15021",2017-06-15 16:14:34,31648.44,19095952.07
"15022",2017-06-15 16:14:34,37041.27,19132993.34
"15023",2017-06-15 16:14:34,42489.51,19175482.85
"15024",2017-06-15 16:14:34,77233.98,19252716.83
"15025",2017-06-15 16:14:34,35650.69,19288367.52
"15026",2017-06-15 16:14:34,28265.3,19316632.82
"884",2017-06-15 16:21:44,-106001.79,19210631.03
"15027",2017-06-15 16:21:44,177825.94,19388456.97
"885",2017-06-15 16:47:38,77632.73,19466089.7
"886",2017-06-15 16:53:27,-77632.73,19388456.97
"887",2017-06-15 17:17:11,94101.81,19482558.78
"888",2017-06-15 17:24:18,-94101.81,19388456.97
"889",2017-06-15 18:42:21,110194.53,19498651.5
"890",2017-06-15 18:59:14,69329.11,19567980.61
"891",2017-06-15 18:59:14,-110194.53,19457786.08
"892",2017-06-15 19:32:24,100049.83,19557835.91
"893",2017-06-15 19:32:24,-69329.11,19488506.8
"894",2017-06-15 19:39:23,-100049.83,19388456.97
"895",2017-06-15 19:52:06,94912.74,19483369.71
"896",2017-06-15 19:57:08,-94912.74,19388456.97
"897",2017-06-15 20:41:44,102575.75,19491032.72
"898",2017-06-15 20:59:33,-102575.75,19388456.97
"899",2017-06-15 21:43:42,86784.16,19475241.13
"900",2017-06-15 21:48:21,-86784.16,19388456.97
"901",2017-06-15 22:13:21,90076.3,19478533.27
"902",2017-06-15 22:20:54,-90076.3,19388456.97
"903",2017-06-15 23:10:27,134065.31,19522522.28
"904",2017-06-15 23:13:34,-134065.31,19388456.97
"905",2017-06-15 23:19:09,16846.57,19405303.54
"906",2017-06-15 23:30:36,-16846.57,19388456.97
"15028",2017-06-15 23:30:36,-19388456.97,3.72529029846191e-09
"15029",2017-06-15 23:59:32,4604.33,4604.33000000373
"15030",2017-06-16 00:03:27,-4604.33,3.72529029846191e-09
"15031",2017-06-16 00:11:05,111144.25,111144.250000004
"15032",2017-06-16 00:19:47,-111144.25,3.72529029846191e-09
"907",2017-06-16 00:55:00,55406.46,55406.4600000037
"908",2017-06-16 01:35:46,-55406.46,3.72529029846191e-09
"15033",2017-06-16 01:35:46,97434.47,97434.4700000037
"15034",2017-06-16 01:43:08,-97434.47,3.72529029846191e-09
"15035",2017-06-16 02:18:50,105087.37,105087.370000004
"15036",2017-06-16 02:18:50,60435.33,165522.700000004
"15037",2017-06-16 02:18:50,4258.1,169780.800000004
"909",2017-06-16 02:36:27,67443.99,237224.790000004
"15038",2017-06-16 02:36:27,-169780.8,67443.9900000038
"15039",2017-06-16 02:36:27,113169.8,180613.790000004
"910",2017-06-16 03:08:15,-67443.99,113169.800000004
"15040",2017-06-16 03:08:15,68418.64,181588.440000004
"15041",2017-06-16 03:08:15,96892.23,278480.670000004
"15042",2017-06-16 03:08:15,122695.16,401175.830000004
"15043",2017-06-16 03:08:15,96363.61,497539.440000004
"15044",2017-06-16 03:08:15,-113169.8,384369.640000004
"15045",2017-06-16 03:08:15,3552.21,387921.850000004
"911",2017-06-16 03:22:29,95841.71,483763.560000004
"15046",2017-06-16 03:22:29,-387921.85,95841.7100000039
"15047",2017-06-16 03:22:29,27217.8,123059.510000004
"15048",2017-06-16 03:22:29,106778.65,229838.160000004
"15049",2017-06-16 03:36:05,67698.52,297536.680000004
"15050",2017-06-16 03:36:05,-133996.45,163540.230000004
"15051",2017-06-16 03:36:05,8718.01,172258.240000004
"15052",2017-06-16 03:51:49,58586.84,230845.080000004
"15053",2017-06-16 03:51:49,-76416.53,154428.550000004
"15054",2017-06-16 04:21:29,78405.92,232834.470000004
"15055",2017-06-16 04:21:29,-58586.84,174247.630000004
"15056",2017-06-16 04:27:42,-78405.92,95841.7100000039
"912",2017-06-16 04:41:08,-95841.71,3.87080945074558e-09
"15057",2017-06-16 04:41:08,25135.25,25135.2500000039
"15058",2017-06-16 04:47:43,-25135.25,3.87080945074558e-09
"913",2017-06-16 05:21:41,68627.79,68627.7900000039
"914",2017-06-16 05:29:57,-68627.79,3.87080945074558e-09
"915",2017-06-16 05:49:11,8868.1,8868.10000000387
"15059",2017-06-16 05:49:11,39023.25,47891.3500000039
"916",2017-06-16 05:52:06,-8868.1,39023.2500000039
"15060",2017-06-16 05:52:06,-39023.25,3.87080945074558e-09
"917",2017-06-16 07:54:50,89453.48,89453.4800000039
"918",2017-06-16 08:17:04,-89453.48,3.87080945074558e-09
"15061",2017-06-16 08:17:04,66771.07,66771.0700000039
"15062",2017-06-16 08:17:04,19668.32,86439.3900000039
"15063",2017-06-16 08:17:04,141640.82,228080.210000004
"15064",2017-06-16 08:30:51,-228080.21,3.89991328120232e-09
"15065",2017-06-16 08:48:16,21602.54,21602.5400000039
"919",2017-06-16 09:00:10,15404.64,37007.1800000039
"15066",2017-06-16 09:00:10,-21602.54,15404.6400000039
"920",2017-06-16 09:04:46,72617.79,88022.4300000039
"921",2017-06-16 09:04:46,-15404.64,72617.7900000039
"922",2017-06-16 09:29:08,-72617.79,3.89991328120232e-09
"923",2017-06-16 10:07:18,90988.45,90988.4500000039
"15067",2017-06-16 10:07:18,261604.77,352593.220000004
"924",2017-06-16 10:15:25,-90988.45,261604.770000004
"15068",2017-06-16 10:15:25,-261604.77,3.87080945074558e-09
"925",2017-06-16 10:33:57,69293.96,69293.9600000039
"926",2017-06-16 10:42:33,104198.14,173492.100000004
"927",2017-06-16 10:42:33,-69293.96,104198.140000004
"928",2017-06-16 11:02:37,99142.44,203340.580000004
"929",2017-06-16 11:02:37,-104198.14,99142.4400000039
"930",2017-06-16 11:11:35,-99142.44,3.85625753551722e-09
"931",2017-06-16 11:45:26,74671.92,74671.9200000039
"932",2017-06-16 11:53:58,-74671.92,3.85625753551722e-09
"15069",2017-06-16 11:55:34,172751.6,172751.600000004
"15070",2017-06-16 11:57:01,3593.11,176344.710000004
"15071",2017-06-16 11:57:01,-172751.6,3593.11000000386
"15072",2017-06-16 12:05:13,55365.12,58958.2300000039
"15073",2017-06-16 12:05:13,-3593.11,55365.1200000039
"15074",2017-06-16 12:05:13,-3593.11,51772.0100000039
"15075",2017-06-16 12:05:13,69681.46,121453.470000004
"15076",2017-06-16 12:05:13,104523.08,225976.550000004
"933",2017-06-16 12:28:34,77652.81,303629.360000004
"15077",2017-06-16 12:28:34,62064.06,365693.420000004
"15078",2017-06-16 12:28:34,60677.43,426370.850000004
"15079",2017-06-16 12:28:34,56194.41,482565.260000004
"15080",2017-06-16 12:28:34,-225976.55,256588.710000004
"934",2017-06-16 12:34:46,-77652.81,178935.900000004
"15081",2017-06-16 12:34:46,74548.33,253484.230000004
"15082",2017-06-16 12:34:46,-178935.9,74548.3300000039
"935",2017-06-16 12:54:32,66599.94,141148.270000004
"15083",2017-06-16 12:54:32,125214.79,266363.060000004
"15084",2017-06-16 12:54:32,63543.57,329906.630000004
"15085",2017-06-16 12:54:32,58928.61,388835.240000004
"15086",2017-06-16 12:54:32,-74548.33,314286.910000004
"15087",2017-06-16 12:54:32,53996.82,368283.730000004
"936",2017-06-16 13:07:04,13921.92,382205.650000004
"937",2017-06-16 13:07:04,-66599.94,315605.710000004
"15088",2017-06-16 13:07:04,97412.97,413018.680000004
"15089",2017-06-16 13:07:04,94527.54,507546.220000004
"15090",2017-06-16 13:07:04,66996.1,574542.320000004
"15091",2017-06-16 13:07:04,104006.19,678548.510000004
"15092",2017-06-16 13:07:04,-301683.79,376864.720000004
"938",2017-06-16 13:24:25,3177.5,380042.220000004
"939",2017-06-16 13:24:25,-13921.92,366120.300000004
"15093",2017-06-16 13:24:25,134731.92,500852.220000004
"15094",2017-06-16 13:24:25,77839.6,578691.820000004
"15095",2017-06-16 13:24:25,-362942.8,215749.020000004
"15096",2017-06-16 13:24:25,4007.96,219756.980000004
"940",2017-06-16 13:38:16,-3177.5,216579.480000004
"15097",2017-06-16 13:38:16,65397.98,281977.460000004
"15098",2017-06-16 13:38:16,11272.93,293250.390000004
"15099",2017-06-16 13:38:16,-216579.48,76670.910000004
"941",2017-06-16 13:40:20,91241.04,167911.950000004
"942",2017-06-16 13:54:33,-91241.04,76670.910000004
"15100",2017-06-16 13:54:33,60158.66,136829.570000004
"15101",2017-06-16 13:54:33,101236.47,238066.040000004
"15102",2017-06-16 13:54:33,125508.88,363574.920000004
"15103",2017-06-16 13:54:33,-76670.91,286904.010000004
"15104",2017-06-16 13:54:33,-76670.91,210233.100000004
"15105",2017-06-16 14:07:02,-210233.1,3.95812094211578e-09
"15106",2017-06-16 14:07:02,19153.24,19153.240000004
"15107",2017-06-16 14:15:56,70375.13,89528.370000004
"15108",2017-06-16 14:15:56,-19153.24,70375.130000004
"943",2017-06-16 14:19:48,67185.8,137560.930000004
"15109",2017-06-16 14:19:48,-70375.13,67185.8000000039
"944",2017-06-16 14:25:07,-67185.8,3.94356902688742e-09
"15110",2017-06-16 14:25:07,65876.35,65876.3500000039
"15111",2017-06-16 14:39:01,-65876.35,3.94356902688742e-09
"15112",2017-06-16 14:39:01,63234.86,63234.8600000039
"945",2017-06-16 14:46:15,97539.01,160773.870000004
"15113",2017-06-16 14:46:15,-63234.86,97539.010000004
"946",2017-06-16 14:59:43,-97539.01,3.95812094211578e-09
"15114",2017-06-16 14:59:43,93911.88,93911.880000004
"15115",2017-06-16 15:09:49,-93911.88,3.95812094211578e-09
"947",2017-06-16 15:46:26,8146.26,8146.26000000396
"948",2017-06-16 15:49:19,-8146.26,3.95812094211578e-09
"949",2017-06-16 16:15:31,71796.44,71796.440000004
"950",2017-06-16 16:18:35,-71796.44,3.95812094211578e-09
"15116",2017-06-16 18:05:03,89641.71,89641.710000004
"951",2017-06-16 18:16:50,106568.15,196209.860000004
"15117",2017-06-16 18:16:50,25673.46,221883.320000004
"952",2017-06-16 18:20:56,-106568.15,115315.170000004
"953",2017-06-16 18:29:08,94418.28,209733.450000004
"954",2017-06-16 18:33:53,64393.05,274126.500000004
"955",2017-06-16 18:33:53,-94418.28,179708.220000004
"956",2017-06-16 18:54:18,82335.76,262043.980000004
"957",2017-06-16 18:54:18,-64393.05,197650.930000004
"958",2017-06-16 18:54:18,66311.3,263962.230000004
"959",2017-06-16 19:02:13,-148647.06,115315.170000004
"15118",2017-06-16 19:02:13,102649.76,217964.930000004
"960",2017-06-16 19:41:28,56858.57,274823.500000004
"961",2017-06-16 19:41:28,69704.98,344528.480000004
"15119",2017-06-16 19:41:28,80314.2,424842.680000004
"962",2017-06-16 19:45:08,-126563.55,298279.130000004
"15120",2017-06-16 19:45:08,163842.38,462121.510000004
"963",2017-06-16 19:50:56,117983.66,580105.170000004
"964",2017-06-16 19:54:48,70281.46,650386.630000004
"965",2017-06-16 19:54:48,-117983.66,532402.970000004
"966",2017-06-16 20:03:36,126030.68,658433.650000004
"967",2017-06-16 20:03:36,-70281.46,588152.190000004
"968",2017-06-16 20:16:47,111360.23,699512.420000004
"969",2017-06-16 20:16:47,-126030.68,573481.740000004
"970",2017-06-16 20:24:13,90146.93,663628.670000004
"971",2017-06-16 20:24:13,-111360.23,552268.440000004
"972",2017-06-16 20:34:48,102134.72,654403.160000004
"973",2017-06-16 20:34:48,-90146.93,564256.230000004
"15121",2017-06-16 20:34:48,83613.19,647869.420000004
"15122",2017-06-16 20:34:48,95526.24,743395.660000004
"15123",2017-06-16 20:34:48,4312.43,747708.090000004
"974",2017-06-16 20:56:45,103329.8,851037.890000004
"975",2017-06-16 20:56:45,-102134.72,748903.170000004
"15124",2017-06-16 20:56:45,77885.71,826788.880000004
"15125",2017-06-16 20:56:45,16391.79,843180.670000004
"976",2017-06-16 21:17:08,82174.01,925354.680000004
"977",2017-06-16 21:17:08,-103329.8,822024.880000004
"978",2017-06-16 21:25:04,-82174.01,739850.870000004
"15126",2017-06-16 21:25:04,105043.14,844894.010000004
"979",2017-06-16 21:29:34,74504.19,919398.200000004
"980",2017-06-16 22:07:13,84717.79,1004115.99
"15127",2017-06-16 22:07:13,104449.06,1108565.05
"15128",2017-06-16 22:07:13,116244.47,1224809.52
"15129",2017-06-16 22:07:13,65131.24,1289940.76
"15130",2017-06-16 22:07:13,92642.94,1382583.7
"15131",2017-06-16 22:07:13,11894.13,1394477.83
"981",2017-06-16 22:30:59,-74504.19,1319973.64
"982",2017-06-16 22:39:55,-84717.79,1235255.85
"983",2017-06-16 22:58:32,109964.72,1345220.57
"984",2017-06-16 23:17:26,-109964.72,1235255.85
"985",2017-06-17 02:36:18,74601.9,1309857.75
"986",2017-06-17 02:44:15,-74601.9,1235255.85
"987",2017-06-17 02:53:39,78122.14,1313377.99
"988",2017-06-17 03:21:05,-78122.14,1235255.85
"989",2017-06-17 05:01:00,101034.79,1336290.64
"990",2017-06-17 05:04:11,-101034.79,1235255.85
"991",2017-06-17 05:13:03,100302,1335557.85
"992",2017-06-17 05:24:20,74851.13,1410408.98
"993",2017-06-17 05:24:20,-100302,1310106.98
"994",2017-06-17 05:38:44,-74851.13,1235255.85
"995",2017-06-17 05:57:03,72524.36,1307780.21
"996",2017-06-17 05:57:03,12053.05,1319833.26
"997",2017-06-17 05:57:03,74582.65,1394415.91
"998",2017-06-17 05:57:03,76119.99,1470535.9
"999",2017-06-17 06:07:28,-235280.05,1235255.85
"1000",2017-06-17 06:21:32,61592.51,1296848.36
"1001",2017-06-17 06:34:46,-61592.51,1235255.85
"1002",2017-06-17 06:46:03,67593.37,1302849.22
"1003",2017-06-17 06:51:05,-67593.37,1235255.85
"15132",2017-06-17 07:48:24,11623.67,1246879.52
"15133",2017-06-17 07:51:16,70882.92,1317762.44
"15134",2017-06-17 08:05:32,96804.3,1414566.74
"15135",2017-06-17 08:42:17,91857.83,1506424.57
"15136",2017-06-17 09:19:36,90632.7,1597057.27
"15137",2017-06-17 09:30:49,112112.45,1709169.72
"15138",2017-06-17 09:30:49,12660.31,1721830.03
"15139",2017-06-17 09:47:55,96378.39,1818208.42
"15140",2017-06-17 09:47:55,137385.91,1955594.33
"15141",2017-06-17 09:57:31,17175.89,1972770.22
"1004",2017-06-17 11:42:27,12959.36,1985729.58
"15142",2017-06-17 11:42:27,37659.72,2023389.3
"1005",2017-06-17 11:44:59,-12959.36,2010429.94
"1006",2017-06-17 14:35:17,71202.28,2081632.22
"1007",2017-06-17 14:39:27,-71202.28,2010429.94
"15143",2017-06-17 15:34:21,115743.82,2126173.76
"15144",2017-06-17 16:42:23,23528.57,2149702.33
"1008",2017-06-17 21:19:18,68766.73,2218469.06
"1009",2017-06-17 21:40:20,-68766.73,2149702.33
"15145",2017-06-17 22:33:08,91838.86,2241541.19
"15146",2017-06-18 00:06:44,97158.83,2338700.02
"15147",2017-06-18 00:06:44,107299.41,2445999.43
"15148",2017-06-18 00:19:04,147041.65,2593041.08
"15149",2017-06-18 00:33:44,169886.79,2762927.87
"15150",2017-06-18 00:33:44,114530.39,2877458.26
"1010",2017-06-18 00:35:19,72181.79,2949640.05
"1011",2017-06-18 00:40:48,-72181.79,2877458.26
"15151",2017-06-18 00:52:16,28911.32,2906369.58
"15152",2017-06-18 01:03:29,126252.41,3032621.99
"15153",2017-06-18 01:37:28,158469.65,3191091.64
"15154",2017-06-18 03:10:09,124227.19,3315318.83
"15155",2017-06-18 03:10:09,79101.54,3394420.37
"15156",2017-06-18 05:04:35,212987.31,3607407.68
"1012",2017-06-18 06:22:52,62490.83,3669898.51
"15157",2017-06-18 06:22:52,112834.71,3782733.22
"15158",2017-06-18 06:22:52,154974.3,3937707.52
"15159",2017-06-18 06:22:52,88155.09,4025862.61
"1013",2017-06-18 06:40:07,-62490.83,3963371.78
"1014",2017-06-18 08:11:10,62988.01,4026359.79
"15160",2017-06-18 08:11:10,352641.98,4379001.77
"1015",2017-06-18 08:16:11,-62988.01,4316013.76
"15161",2017-06-18 08:16:11,52237.05,4368250.81
"15162",2017-06-18 08:39:21,170748.38,4538999.19
"1016",2017-06-18 08:48:11,163921.79,4702920.98
"15163",2017-06-18 09:22:43,12265.99,4715186.97
"1017",2017-06-18 09:29:20,-163921.79,4551265.18
"15164",2017-06-18 10:43:18,77830.37,4629095.55
"15165",2017-06-18 10:43:18,77830.39,4706925.94
"15166",2017-06-18 11:00:51,118244.89,4825170.83
"15167",2017-06-18 11:44:40,111872.82,4937043.65
"15168",2017-06-18 12:01:18,122994.3,5060037.95
"1018",2017-06-18 12:27:26,77754.58,5137792.53
"1019",2017-06-18 12:27:26,71256.94,5209049.47
"15169",2017-06-18 12:27:26,69107.24,5278156.71
"1020",2017-06-18 12:40:00,-149011.52,5129145.19
"15170",2017-06-18 12:40:00,147444.43,5276589.62
"15171",2017-06-18 12:40:52,109498.8,5386088.42
"1021",2017-06-18 12:51:12,90588.86,5476677.28
"1022",2017-06-18 13:05:29,-90588.86,5386088.42
"15172",2017-06-18 13:05:29,142011.82,5528100.24
"15173",2017-06-18 13:19:03,90524.09,5618624.33
"15174",2017-06-18 13:19:03,126522.23,5745146.56
"15175",2017-06-18 13:35:59,176630.27,5921776.83
"15176",2017-06-18 13:38:20,214557.59,6136334.42
"15177",2017-06-18 13:40:49,190225.42,6326559.84
"1023",2017-06-18 14:05:34,94219.89,6420779.73
"15178",2017-06-18 14:05:34,82598.94,6503378.67
"15179",2017-06-18 14:05:34,80823.53,6584202.2
"1024",2017-06-18 14:14:34,-94219.89,6489982.31
"15180",2017-06-18 14:14:34,100176.45,6590158.76
"15181",2017-06-18 14:14:34,160749.25,6750908.01
"15182",2017-06-18 14:33:31,126778.08,6877686.09
"15183",2017-06-18 14:33:31,154440.85,7032126.94
"15184",2017-06-18 14:49:08,115506.45,7147633.39
"15185",2017-06-18 14:49:08,111595.59,7259228.98
"1025",2017-06-18 15:44:54,10290.76,7269519.74
"1026",2017-06-18 16:32:44,73099.67,7342619.41
"1027",2017-06-18 16:32:44,-10290.76,7332328.65
"1028",2017-06-18 17:48:34,-73099.67,7259228.98
"15186",2017-06-18 19:28:52,111160.64,7370389.62
"1029",2017-06-18 19:47:26,66169.25,7436558.87
"1030",2017-06-18 19:50:20,-66169.25,7370389.62
"1031",2017-06-18 20:20:58,21771.21,7392160.83
"15187",2017-06-18 20:20:58,242089.46,7634250.29
"15188",2017-06-18 20:20:58,136211.79,7770462.08
"1032",2017-06-18 20:24:15,-21771.21,7748690.87
"1033",2017-06-18 20:35:45,62855.31,7811546.18
"1034",2017-06-18 20:42:22,-62855.31,7748690.87
"15189",2017-06-18 20:42:22,93387.71,7842078.58
"1035",2017-06-18 21:07:51,68906.37,7910984.95
"15190",2017-06-18 21:07:51,13019.57,7924004.52
"1036",2017-06-18 21:10:48,-68906.37,7855098.15
"15191",2017-06-18 21:29:22,88652.22,7943750.37
"1037",2017-06-18 22:10:50,110148.38,8053898.75
"1038",2017-06-18 22:18:11,-110148.38,7943750.37
"15192",2017-06-18 22:38:14,94519.12,8038269.49
"15193",2017-06-18 22:38:14,144446.48,8182715.97
"1039",2017-06-18 22:59:47,12582.77,8195298.74
"1040",2017-06-18 23:11:49,-12582.77,8182715.97
"1041",2017-06-18 23:57:03,70459.5,8253175.47
"1042",2017-06-18 23:59:17,-70459.5,8182715.97
"15194",2017-06-19 00:06:34,70898.4,8253614.37
"1043",2017-06-19 00:48:33,17947.65,8271562.02000001
"15195",2017-06-19 00:48:33,91255.8,8362817.82
"15196",2017-06-19 00:48:33,60306.87,8423124.69000001
"1044",2017-06-19 01:10:44,-17947.65,8405177.04
"15197",2017-06-19 01:10:44,70058.68,8475235.72
"15198",2017-06-19 02:56:24,101941.37,8577177.09
"15199",2017-06-19 03:11:41,131401.28,8708578.37
"1045",2017-06-19 05:57:56,66846.99,8775425.36
"1046",2017-06-19 06:07:40,-66846.99,8708578.37
"15200",2017-06-19 07:27:05,-8708578.37,3.72529029846191e-09
"15201",2017-06-19 08:53:30,21979.38,21979.3800000037
"15202",2017-06-19 08:56:32,-21979.38,3.72529029846191e-09
"15203",2017-06-19 09:11:48,33732.82,33732.8200000037
"15204",2017-06-19 09:20:11,-33732.82,3.72529029846191e-09
"15205",2017-06-19 09:35:25,85495.27,85495.2700000037
"15206",2017-06-19 09:50:33,-85495.27,3.72529029846191e-09
"15207",2017-06-19 09:55:57,44501,44501.0000000037
"15208",2017-06-19 10:04:23,-44501,3.72529029846191e-09
"15209",2017-06-19 10:04:23,17628.7,17628.7000000037
"15210",2017-06-19 10:15:59,124534.73,142163.430000004
"15211",2017-06-19 10:15:59,-17628.7,124534.730000004
"15212",2017-06-19 10:38:40,-124534.73,3.72529029846191e-09
"1047",2017-06-19 12:36:08,70686.54,70686.5400000037
"1048",2017-06-19 13:07:11,-70686.54,3.72529029846191e-09
"15213",2017-06-19 13:50:32,88990.14,88990.1400000037
"15214",2017-06-19 13:50:32,73888.74,162878.880000004
"15215",2017-06-19 13:56:58,-162878.88,3.72529029846191e-09
"15216",2017-06-19 14:12:51,74762.65,74762.6500000037
"15217",2017-06-19 14:33:28,-74762.65,3.72529029846191e-09
"15218",2017-06-19 17:23:38,74455.58,74455.5800000037
"15219",2017-06-19 17:36:01,-74455.58,3.72529029846191e-09
"1049",2017-06-20 00:55:40,73670.63,73670.6300000037
"1050",2017-06-20 01:05:56,-73670.63,3.72529029846191e-09
"15220",2017-06-20 02:07:08,89491.95,89491.9500000037
"15221",2017-06-20 02:07:08,95363.54,184855.490000004
"15222",2017-06-20 02:11:56,-184855.49,3.72529029846191e-09
"15223",2017-06-20 02:15:00,92741.72,92741.7200000037
"15224",2017-06-20 02:20:22,-92741.72,3.72529029846191e-09
"1051",2017-06-20 03:10:48,71341.14,71341.1400000037
"1052",2017-06-20 03:12:08,-71341.14,3.72529029846191e-09
"15225",2017-06-20 04:28:28,25668.1,25668.1000000037
"15226",2017-06-20 04:31:47,-25668.1,3.72529029846191e-09
"15227",2017-06-20 04:35:41,16914.55,16914.5500000037
"15228",2017-06-20 04:54:13,-16914.55,3.72529029846191e-09
"15229",2017-06-20 05:25:12,96497.73,96497.7300000037
"15230",2017-06-20 05:25:12,86711.77,183209.500000004
"15231",2017-06-20 05:25:12,112915.84,296125.340000004
"15232",2017-06-20 05:25:12,138961.45,435086.790000004
"15233",2017-06-20 05:27:46,-435086.79,3.72529029846191e-09
"15234",2017-06-20 07:23:09,13652.15,13652.1500000037
"15235",2017-06-20 07:23:09,88654.05,102306.200000004
"15236",2017-06-20 07:33:41,-102306.2,3.72529029846191e-09
"15237",2017-06-20 09:55:12,125053.96,125053.960000004
"15238",2017-06-20 09:55:12,32971.72,158025.680000004
"15239",2017-06-20 10:02:20,-158025.68,3.72529029846191e-09
"15240",2017-06-20 10:41:51,100585.13,100585.130000004
"15241",2017-06-20 10:41:51,30729.92,131315.050000004
"15242",2017-06-20 10:46:31,-131315.05,3.72529029846191e-09
"15243",2017-06-20 11:41:13,37683.47,37683.4700000037
"15244",2017-06-20 11:41:40,132319.69,170003.160000004
"15245",2017-06-20 11:44:48,14190.52,184193.680000004
"15246",2017-06-20 11:44:48,-170003.16,14190.5200000037
"15247",2017-06-20 11:57:57,-14190.52,3.71437636204064e-09
"15248",2017-06-20 12:01:46,116379.24,116379.240000004
"15249",2017-06-20 12:08:39,-116379.24,3.71073838323355e-09
"15250",2017-06-20 12:27:44,92091.17,92091.1700000037
"15251",2017-06-20 12:27:44,94055.94,186147.110000004
"15252",2017-06-20 12:39:22,-186147.11,3.72529029846191e-09
"15253",2017-06-20 13:28:48,21961.68,21961.6800000037
"15254",2017-06-20 13:28:48,104632.06,126593.740000004
"15255",2017-06-20 13:46:15,-126593.74,3.71073838323355e-09
"15256",2017-06-20 13:46:15,74972.55,74972.5500000037
"15257",2017-06-20 13:50:34,-74972.55,3.71073838323355e-09
"15258",2017-06-20 14:44:13,108626.93,108626.930000004
"15259",2017-06-20 14:44:13,132473.54,241100.470000004
"15260",2017-06-20 14:54:21,79121.3,320221.770000004
"1053",2017-06-20 15:28:29,21331.57,341553.340000004
"15261",2017-06-20 15:29:16,103487.07,445040.410000004
"1054",2017-06-20 15:42:39,-21331.57,423708.840000004
"15262",2017-06-20 15:42:39,-423708.84,3.66708263754845e-09
"1055",2017-06-20 16:17:24,87236.44,87236.4400000037
"1056",2017-06-20 17:21:59,-87236.44,3.66708263754845e-09
"1057",2017-06-20 20:19:43,92635.89,92635.8900000037
"1058",2017-06-20 20:23:04,-92635.89,3.66708263754845e-09
"15263",2017-06-20 21:38:03,164130.62,164130.620000004
"15264",2017-06-20 22:33:59,208632.71,372763.330000004
"1059",2017-06-20 22:43:04,71922.05,444685.380000004
"1060",2017-06-20 22:46:05,-71922.05,372763.330000004
"15265",2017-06-20 23:49:13,117570.64,490333.970000004
"15266",2017-06-21 00:04:22,93399.75,583733.720000004
"15267",2017-06-21 00:04:22,124558.96,708292.680000004
"15268",2017-06-21 00:11:12,76614.6,784907.280000004
"15269",2017-06-21 00:35:55,121581.35,906488.630000004
"1061",2017-06-21 03:32:54,67113.45,973602.080000004
"1062",2017-06-21 03:32:54,72505.51,1046107.59
"1063",2017-06-21 03:38:24,-139618.96,906488.630000004
"15270",2017-06-21 06:36:29,219671.14,1126159.77
"15271",2017-06-21 06:36:29,222745.86,1348905.63
"15272",2017-06-21 06:36:29,219412.76,1568318.39
"15273",2017-06-21 06:52:02,225190.91,1793509.3
"15274",2017-06-21 07:22:20,228038.29,2021547.59
"1064",2017-06-21 07:42:11,109503.2,2131050.79
"1065",2017-06-21 07:56:09,-109503.2,2021547.59
"15275",2017-06-21 10:36:47,198483.64,2220031.23
"15276",2017-06-21 13:08:35,85927.04,2305958.27
"1066",2017-06-21 15:46:56,78287.59,2384245.86
"1067",2017-06-21 15:53:27,-78287.59,2305958.27
"15277",2017-06-21 21:26:01,-2305958.27,3.72529029846191e-09
"15278",2017-06-21 21:39:46,84825.11,84825.1100000037
"15279",2017-06-21 21:39:46,81133.86,165958.970000004
"15280",2017-06-21 21:39:46,101577.46,267536.430000004
"15281",2017-06-21 21:48:30,-267536.43,3.72529029846191e-09
"1068",2017-06-21 22:33:22,77833.11,77833.1100000037
"15282",2017-06-21 22:33:22,18183.55,96016.6600000037
"1069",2017-06-21 22:44:22,-77833.11,18183.5500000037
"1070",2017-06-21 22:44:22,126528.02,144711.570000004
"1071",2017-06-21 22:44:22,82697.72,227409.290000004
"15283",2017-06-21 22:44:22,-18183.55,209225.740000004
"15284",2017-06-21 22:44:22,752007.25,961232.990000004
"15285",2017-06-21 22:56:12,-752007.25,209225.740000004
"15286",2017-06-21 22:56:12,451923.83,661149.570000004
"1072",2017-06-21 23:15:07,-209225.74,451923.830000004
"15287",2017-06-21 23:15:07,-451923.83,3.78349795937538e-09
"1073",2017-06-21 23:16:04,87057.15,87057.1500000038
"15288",2017-06-21 23:19:14,134922.35,221979.500000004
"1074",2017-06-21 23:29:27,-87057.15,134922.350000004
"15289",2017-06-21 23:29:27,-134922.35,3.78349795937538e-09
"15290",2017-06-21 23:29:27,145982.45,145982.450000004
"15291",2017-06-21 23:38:46,-145982.45,3.78349795937538e-09
"15292",2017-06-21 23:46:59,278081.25,278081.250000004
"15293",2017-06-21 23:52:53,-278081.25,3.78349795937538e-09
"1075",2017-06-22 00:15:33,73143.21,73143.2100000038
"1076",2017-06-22 00:31:09,-73143.21,3.78349795937538e-09
"15294",2017-06-22 01:50:12,135992.73,135992.730000004
"15295",2017-06-22 02:04:50,-135992.73,3.78349795937538e-09
"1077",2017-06-22 02:46:07,15979.41,15979.4100000038
"1078",2017-06-22 02:48:57,-15979.41,3.78349795937538e-09
"1079",2017-06-22 04:05:31,68911.86,68911.8600000038
"1080",2017-06-22 04:27:53,-68911.86,3.78349795937538e-09
"15296",2017-06-22 04:48:16,221740.5,221740.500000004
"15297",2017-06-22 04:50:32,-221740.5,3.78349795937538e-09
"1081",2017-06-22 05:53:16,5467.83,5467.83000000378
"1082",2017-06-22 05:53:16,14911.34,20379.1700000038
"1083",2017-06-22 06:04:16,-20379.17,3.78349795937538e-09
"1084",2017-06-22 06:14:50,82559.8,82559.8000000038
"1085",2017-06-22 06:14:50,89773.26,172333.060000004
"15298",2017-06-22 06:14:50,299239.93,471572.990000004
"15299",2017-06-22 06:14:50,137251.07,608824.060000004
"1086",2017-06-22 07:04:39,101003.29,709827.350000004
"1087",2017-06-22 07:04:39,-172333.06,537494.290000004
"15300",2017-06-22 07:04:39,-436491,101003.290000004
"1088",2017-06-22 07:12:53,-101003.29,3.76894604414701e-09
"15301",2017-06-22 08:39:56,154200.74,154200.740000004
"15302",2017-06-22 08:39:56,190458.03,344658.770000004
"15303",2017-06-22 08:39:56,210204.4,554863.170000004
"15304",2017-06-22 08:46:43,-554863.17,3.72529029846191e-09
"15305",2017-06-22 08:46:43,169927.44,169927.440000004
"15306",2017-06-22 09:11:22,-169927.44,3.72529029846191e-09
"15307",2017-06-22 09:30:34,24896.38,24896.3800000037
"15308",2017-06-22 09:36:22,-24896.38,3.72529029846191e-09
"15309",2017-06-22 09:36:22,162325.94,162325.940000004
"15310",2017-06-22 09:36:22,88664.08,250990.020000004
"15311",2017-06-22 10:09:36,-250990.02,3.75439412891865e-09
"1089",2017-06-22 10:28:44,16829.71,16829.7100000038
"15312",2017-06-22 10:28:44,37093.48,53923.1900000038
"15313",2017-06-22 10:28:44,189043.29,242966.480000004
"15314",2017-06-22 10:28:44,229701.12,472667.600000004
"15315",2017-06-22 10:28:44,201024.57,673692.170000004
"1090",2017-06-22 10:31:34,-16829.71,656862.460000004
"15316",2017-06-22 10:31:34,-656862.46,3.84170562028885e-09
"1091",2017-06-22 13:35:57,12836.61,12836.6100000038
"1092",2017-06-22 14:03:21,-12836.61,3.84170562028885e-09
"15317",2017-06-22 14:03:21,153962.36,153962.360000004
"15318",2017-06-22 14:16:51,-153962.36,3.84170562028885e-09
"15319",2017-06-22 15:53:37,136542.59,136542.590000004
"15320",2017-06-22 16:00:50,-136542.59,3.84170562028885e-09
"15321",2017-06-22 16:45:28,107229.29,107229.290000004
"15322",2017-06-22 16:51:22,-107229.29,3.84170562028885e-09
"15323",2017-06-22 17:02:29,125840.93,125840.930000004
"15324",2017-06-22 17:32:42,-125840.93,3.84170562028885e-09
"15325",2017-06-22 18:08:07,91298.89,91298.8900000038
"15326",2017-06-22 18:13:36,-91298.89,3.84170562028885e-09
"1093",2017-06-22 21:35:38,81703.32,81703.3200000038
"1094",2017-06-22 21:53:38,-81703.32,3.84170562028885e-09
"1095",2017-06-22 23:28:53,76060.2,76060.2000000038
"1096",2017-06-22 23:35:25,-76060.2,3.84170562028885e-09
"1097",2017-06-23 02:13:03,85873.45,85873.4500000038
"1098",2017-06-23 02:26:06,88634.01,174507.460000004
"1099",2017-06-23 02:26:06,-85873.45,88634.0100000038
"1100",2017-06-23 02:29:51,-88634.01,3.84170562028885e-09
"1101",2017-06-23 02:55:17,19649.31,19649.3100000038
"1102",2017-06-23 02:56:58,-19649.31,3.84170562028885e-09
"1103",2017-06-23 03:15:48,82927.52,82927.5200000038
"1104",2017-06-23 03:21:54,-82927.52,3.84170562028885e-09
"1105",2017-06-23 04:08:24,101988.54,101988.540000004
"1106",2017-06-23 04:29:40,-101988.54,3.84170562028885e-09
"1107",2017-06-23 04:31:43,88039.52,88039.5200000038
"1108",2017-06-23 04:36:37,-88039.52,3.84170562028885e-09
"1109",2017-06-23 05:07:46,92632.22,92632.2200000038
"1110",2017-06-23 05:15:26,-92632.22,3.84170562028885e-09
"1111",2017-06-23 07:11:12,20374.88,20374.8800000038
"1112",2017-06-23 07:15:24,-20374.88,3.84170562028885e-09
"1113",2017-06-23 08:26:51,104164.37,104164.370000004
"1114",2017-06-23 08:36:10,-104164.37,3.84170562028885e-09
"1115",2017-06-23 10:02:37,15166.98,15166.9800000038
"1116",2017-06-23 10:24:38,-15166.98,3.84170562028885e-09
"1117",2017-06-23 11:26:56,92026.4,92026.4000000038
"1118",2017-06-23 11:47:18,-92026.4,3.84170562028885e-09
"1119",2017-06-23 13:31:54,74593.17,74593.1700000038
"1120",2017-06-23 13:53:30,-74593.17,3.84170562028885e-09
"1121",2017-06-23 15:01:35,98456.12,98456.1200000038
"1122",2017-06-23 15:13:52,-98456.12,3.84170562028885e-09
"15327",2017-06-23 17:03:37,39264.96,39264.9600000038
"15328",2017-06-23 17:13:58,-39264.96,3.84170562028885e-09
"15329",2017-06-23 18:05:39,117548.11,117548.110000004
"15330",2017-06-23 18:05:39,279305.96,396854.070000004
"1123",2017-06-23 18:22:46,84241.98,481096.050000004
"1124",2017-06-23 18:25:48,-84241.98,396854.070000004
"15331",2017-06-23 18:31:38,-396854.07,3.84170562028885e-09
"1125",2017-06-23 19:35:07,88298.52,88298.5200000038
"1126",2017-06-23 19:37:05,-88298.52,3.84170562028885e-09
"1127",2017-06-23 20:55:28,19889.21,19889.2100000038
"1128",2017-06-23 21:03:44,-19889.21,3.84170562028885e-09
"15332",2017-06-23 21:34:36,119556.27,119556.270000004
"15333",2017-06-23 21:34:36,123317.16,242873.430000004
"15334",2017-06-23 21:39:47,-242873.43,3.84170562028885e-09
"15335",2017-06-23 21:54:33,155352.89,155352.890000004
"15336",2017-06-23 22:17:15,-155352.89,3.84170562028885e-09
"1129",2017-06-23 23:18:20,81058.24,81058.2400000038
"1130",2017-06-23 23:25:49,-81058.24,3.84170562028885e-09
"15337",2017-06-24 00:28:29,21628.9,21628.9000000038
"15338",2017-06-24 01:03:49,-21628.9,3.84170562028885e-09
"1131",2017-06-24 01:51:28,34691.36,34691.3600000038
"1132",2017-06-24 01:53:25,-34691.36,3.84170562028885e-09
"15339",2017-06-24 04:25:56,135250.61,135250.610000004
"15340",2017-06-24 04:28:17,-135250.61,3.84170562028885e-09
"15341",2017-06-24 05:08:14,92132.27,92132.2700000038
"15342",2017-06-24 05:47:00,-92132.27,3.84170562028885e-09
"15343",2017-06-24 05:47:00,125360.45,125360.450000004
"15344",2017-06-24 05:47:00,69603.75,194964.200000004
"15345",2017-06-24 06:21:00,-194964.2,3.84170562028885e-09
"15346",2017-06-24 06:21:00,182184.22,182184.220000004
"15347",2017-06-24 06:21:00,158454.41,340638.630000004
"15348",2017-06-24 06:25:25,-340638.63,3.84170562028885e-09
"15349",2017-06-24 06:29:00,157343,157343.000000004
"15350",2017-06-24 06:37:39,-157343,3.84170562028885e-09
"1133",2017-06-24 07:03:55,15485.27,15485.2700000038
"1134",2017-06-24 07:07:45,-15485.27,3.84170562028885e-09
"15351",2017-06-24 08:24:13,81558.6,81558.6000000038
"15352",2017-06-24 08:36:51,-81558.6,3.84170562028885e-09
"15353",2017-06-24 08:59:53,100328.51,100328.510000004
"1135",2017-06-24 09:44:52,38752.45,139080.960000004
"1136",2017-06-24 10:06:17,-38752.45,100328.510000004
"15354",2017-06-24 11:24:11,153263.12,253591.630000004
"1137",2017-06-24 12:29:22,84772.63,338364.260000004
"1138",2017-06-24 12:40:00,-84772.63,253591.630000004
"1139",2017-06-24 13:44:15,82042.81,335634.440000004
"15355",2017-06-24 13:44:15,430514.16,766148.600000004
"15356",2017-06-24 13:44:15,203838.48,969987.080000004
"15357",2017-06-24 13:44:15,204218.93,1174206.01
"1140",2017-06-24 14:05:11,-82042.81,1092163.2
"1141",2017-06-24 14:05:11,84438.86,1176602.06
"15358",2017-06-24 14:05:11,308832.22,1485434.28
"15359",2017-06-24 14:05:11,315711.72,1801146
"15360",2017-06-24 14:05:11,350560.55,2151706.55
"1142",2017-06-24 14:33:02,94129.76,2245836.31
"1143",2017-06-24 14:33:02,-84438.86,2161397.45
"15361",2017-06-24 14:33:02,254104.31,2415501.76
"15362",2017-06-24 14:33:02,259095.76,2674597.52
"1144",2017-06-24 14:41:20,-94129.76,2580467.76
"1145",2017-06-24 14:49:12,89838.84,2670306.6
"15363",2017-06-24 14:49:12,137798.9,2808105.5
"1146",2017-06-24 15:09:34,-89838.84,2718266.66
"15364",2017-06-24 15:09:34,150182.82,2868449.48
"15365",2017-06-24 15:34:19,100058.33,2968507.81
"1147",2017-06-24 15:54:22,95228.51,3063736.32
"1148",2017-06-24 16:03:31,-95228.51,2968507.81
"1149",2017-06-24 16:41:23,20292.1,2988799.91
"15366",2017-06-24 16:41:23,145038.37,3133838.28
"15367",2017-06-24 16:41:23,242920.94,3376759.22
"1150",2017-06-24 17:26:15,-20292.1,3356467.12
"15368",2017-06-24 17:26:15,70058.87,3426525.99
"1151",2017-06-24 17:38:26,111869.71,3538395.7
"1152",2017-06-24 17:38:26,85763.24,3624158.94
"1153",2017-06-24 17:38:26,92532.44,3716691.38
"15369",2017-06-24 17:38:26,488925.07,4205616.45
"15370",2017-06-24 17:38:26,103975.51,4309591.96
"15371",2017-06-24 17:38:26,104662.19,4414254.15
"1154",2017-06-24 17:41:23,-290165.39,4124088.76
"15372",2017-06-24 17:51:38,164506.06,4288594.82
"1155",2017-06-24 18:23:52,94060.27,4382655.09
"1156",2017-06-24 18:32:29,217201.01,4599856.1
"1157",2017-06-24 18:32:29,-94060.27,4505795.83
"15373",2017-06-24 18:35:16,227096.77,4732892.6
"1158",2017-06-24 18:58:57,78646.36,4811538.96
"1159",2017-06-24 18:58:57,-217201.01,4594337.95
"15374",2017-06-24 18:58:57,160212.89,4754550.84
"1160",2017-06-24 19:06:07,-78646.36,4675904.48
"15375",2017-06-24 19:06:07,135853,4811757.48
"1161",2017-06-24 19:11:28,99447.13,4911204.61
"1162",2017-06-24 19:30:32,-99447.13,4811757.48
"15376",2017-06-24 19:30:32,180860.27,4992617.75
"1163",2017-06-24 22:33:27,285243.28,5277861.03
"1164",2017-06-24 22:42:02,-285243.28,4992617.75
"15377",2017-06-24 22:42:02,928682.54,5921300.29
"15378",2017-06-24 23:11:31,164366.78,6085667.07
"1165",2017-06-24 23:26:18,105024.86,6190691.93
"1166",2017-06-24 23:28:50,-105024.86,6085667.07
"15379",2017-06-24 23:42:06,170375.1,6256042.17
"1167",2017-06-25 00:02:09,79680.89,6335723.06
"1168",2017-06-25 00:06:59,-79680.89,6256042.17
"15380",2017-06-25 00:25:26,103175.91,6359218.08
"15381",2017-06-25 00:54:25,154318.31,6513536.39
"15382",2017-06-25 00:54:25,98266.61,6611803
"15383",2017-06-25 01:28:30,127977.55,6739780.55
"15384",2017-06-25 01:28:30,150435.4,6890215.95
"15385",2017-06-25 01:28:30,85510.92,6975726.87
"15386",2017-06-25 01:28:30,120486.97,7096213.84
"15387",2017-06-25 01:28:30,119103.19,7215317.03
"1169",2017-06-25 02:20:35,75830.31,7291147.34
"15388",2017-06-25 02:20:35,159107.8,7450255.14
"15389",2017-06-25 02:20:35,185910.26,7636165.4
"15390",2017-06-25 02:20:35,164045.22,7800210.62
"15391",2017-06-25 02:20:35,278402.99,8078613.61
"1170",2017-06-25 02:24:35,24301.48,8102915.09
"1171",2017-06-25 02:24:35,-75830.31,8027084.78
"1172",2017-06-25 02:43:11,21340.61,8048425.39
"1173",2017-06-25 02:43:11,-24301.48,8024123.91
"15392",2017-06-25 02:43:11,50060.09,8074184
"15393",2017-06-25 02:43:11,-8002783.3,71400.700000003
"15394",2017-06-25 02:43:11,198603.98,270004.680000003
"15395",2017-06-25 02:43:11,141643.32,411648.000000003
"15396",2017-06-25 02:43:11,154167.61,565815.610000003
"15397",2017-06-25 02:55:17,-544475,21340.6100000029
"15398",2017-06-25 02:55:17,140133.57,161474.180000003
"1174",2017-06-25 03:15:43,-21340.61,140133.570000003
"15399",2017-06-25 03:15:43,-140133.57,2.91038304567337e-09
"15400",2017-06-25 03:15:43,189753.37,189753.370000003
"15401",2017-06-25 03:24:20,-189753.37,2.91038304567337e-09
"15402",2017-06-25 03:29:27,170524.76,170524.760000003
"15403",2017-06-25 03:40:24,-170524.76,2.91038304567337e-09
"1175",2017-06-25 04:17:09,14647.23,14647.2300000029
"15404",2017-06-25 04:17:09,186840.37,201487.600000003
"15405",2017-06-25 04:17:09,118121.77,319609.370000003
"15406",2017-06-25 04:17:09,182568.42,502177.790000003
"15407",2017-06-25 04:17:09,170365.28,672543.070000003
"1176",2017-06-25 04:20:18,-14647.23,657895.840000003
"15408",2017-06-25 04:20:18,-657895.84,3.0267983675003e-09
"1177",2017-06-25 04:46:31,75434.3,75434.300000003
"1178",2017-06-25 05:11:16,-75434.3,3.0267983675003e-09
"15409",2017-06-25 06:29:54,65247.48,65247.480000003
"15410",2017-06-25 06:34:59,-65247.48,3.0267983675003e-09
"15411",2017-06-25 07:11:48,117315.89,117315.890000003
"15412",2017-06-25 07:46:31,-117315.89,3.0267983675003e-09
"15413",2017-06-25 07:46:31,151037.28,151037.280000003
"1179",2017-06-25 07:57:09,30027.71,181064.990000003
"15414",2017-06-25 07:57:09,-151037.28,30027.710000003
"15415",2017-06-25 07:57:09,123530.84,153558.550000003
"1180",2017-06-25 08:08:21,-30027.71,123530.840000003
"15416",2017-06-25 08:08:21,-123530.84,3.0267983675003e-09
"1181",2017-06-25 08:51:04,23217.58,23217.580000003
"1182",2017-06-25 09:20:00,-23217.58,3.0267983675003e-09
"15417",2017-06-25 09:20:00,150338.02,150338.020000003
"1183",2017-06-25 09:33:09,105973.72,256311.740000003
"15418",2017-06-25 09:33:09,-150338.02,105973.720000003
"1184",2017-06-25 09:35:24,-105973.72,3.0267983675003e-09
"1185",2017-06-25 10:18:56,83960.89,83960.890000003
"1186",2017-06-25 10:24:28,-83960.89,3.0267983675003e-09
"1187",2017-06-25 10:46:49,103099.11,103099.110000003
"1188",2017-06-25 10:50:39,-103099.11,3.0267983675003e-09
"1189",2017-06-25 11:21:37,93645.18,93645.180000003
"15419",2017-06-25 16:30:38,113317.88,206963.060000003
"15420",2017-06-25 16:43:58,-113317.88,93645.180000003
"15421",2017-06-25 17:15:39,89594.19,183239.370000003
"15422",2017-06-25 17:44:13,-89594.19,93645.180000003
"1190",2017-06-25 18:26:02,-93645.18,3.0267983675003e-09
"15423",2017-06-25 18:26:02,97193.71,97193.710000003
"15424",2017-06-25 18:26:02,88740.61,185934.320000003
"15425",2017-06-25 18:34:30,-185934.32,3.0267983675003e-09
"15426",2017-06-25 18:34:30,81158.43,81158.430000003
"15427",2017-06-25 18:45:41,-81158.43,3.0267983675003e-09
"1191",2017-06-25 19:54:43,90333.25,90333.250000003
"1192",2017-06-25 20:03:33,-90333.25,3.0267983675003e-09
"15428",2017-06-25 20:03:33,169407.32,169407.320000003
"1193",2017-06-25 20:11:16,96535.61,265942.930000003
"15429",2017-06-25 20:11:16,-169407.32,96535.610000003
"1194",2017-06-25 20:19:21,-96535.61,3.01224645227194e-09
"15430",2017-06-25 20:19:21,189137.34,189137.340000003
"15431",2017-06-25 20:23:53,-189137.34,2.99769453704357e-09
"15432",2017-06-25 20:36:29,297175.49,297175.490000003
"1195",2017-06-25 21:00:54,97282.97,394458.460000003
"15433",2017-06-25 21:00:54,-297175.49,97282.970000003
"15434",2017-06-25 21:00:54,128817.37,226100.340000003
"15435",2017-06-25 21:00:54,244895.86,470996.200000003
"1196",2017-06-25 21:32:03,22781.8,493778.000000003
"15436",2017-06-25 21:32:03,-373713.23,120064.770000003
"1197",2017-06-25 21:50:31,-97282.97,22781.800000003
"1198",2017-06-25 22:06:23,109410.29,132192.090000003
"1199",2017-06-25 22:06:23,-22781.8,109410.290000003
"15437",2017-06-25 22:06:23,183118.53,292528.820000003
"15438",2017-06-25 22:06:23,262254.06,554782.880000003
"15439",2017-06-25 22:06:23,215771.64,770554.520000003
"15440",2017-06-25 22:06:23,212242.49,982797.010000003
"1200",2017-06-25 22:16:59,97256.12,1080053.13
"1201",2017-06-25 22:16:59,-109410.29,970642.840000003
"15441",2017-06-25 22:16:59,-873386.72,97256.1200000029
"15442",2017-06-25 22:16:59,169895.26,267151.380000003
"1202",2017-06-25 22:21:03,-97256.12,169895.260000003
"15443",2017-06-25 22:21:03,-169895.26,2.91038304567337e-09
"1203",2017-06-25 22:42:27,123548.66,123548.660000003
"1204",2017-06-25 22:42:27,99203.63,222752.290000003
"1205",2017-06-25 22:59:01,-222752.29,2.91038304567337e-09
"15444",2017-06-25 23:35:22,244977.54,244977.540000003
"15445",2017-06-25 23:35:22,90789,335766.540000003
"1206",2017-06-25 23:56:13,22517.86,358284.400000003
"15446",2017-06-25 23:56:13,-335766.54,22517.860000003
"1207",2017-06-26 00:12:01,-22517.86,2.95403879135847e-09
"1208",2017-06-26 01:11:10,92475.09,92475.090000003
"1209",2017-06-26 01:33:54,-92475.09,2.95403879135847e-09
"1210",2017-06-26 01:33:54,85203.62,85203.6200000029
"15447",2017-06-26 01:33:54,144257.68,229461.300000003
"1211",2017-06-26 01:48:36,-85203.62,144257.680000003
"15448",2017-06-26 01:48:36,-144257.68,2.96859070658684e-09
"15449",2017-06-26 01:48:36,154265.4,154265.400000003
"15450",2017-06-26 01:55:01,-154265.4,2.96859070658684e-09
"15451",2017-06-26 01:55:01,187355.22,187355.220000003
"1212",2017-06-26 02:17:50,21671.98,209027.200000003
"15452",2017-06-26 02:17:50,-187355.22,21671.980000003
"1213",2017-06-26 02:31:41,-21671.98,2.97950464300811e-09
"1214",2017-06-26 03:13:28,83077.78,83077.780000003
"1215",2017-06-26 03:21:09,-83077.78,2.9831426218152e-09
"1216",2017-06-26 04:09:58,85480.5,85480.500000003
"1217",2017-06-26 04:11:54,-85480.5,2.9831426218152e-09
"15453",2017-06-26 04:48:09,168221.4,168221.400000003
"15454",2017-06-26 04:48:09,120442.96,288664.360000003
"15455",2017-06-26 04:48:09,130784.9,419449.260000003
"15456",2017-06-26 04:48:09,161668.08,581117.340000003
"15457",2017-06-26 05:00:09,-581117.34,3.0267983675003e-09
"15458",2017-06-26 05:01:33,163000.88,163000.880000003
"15459",2017-06-26 05:30:47,-163000.88,3.0267983675003e-09
"15460",2017-06-26 05:30:47,100498.29,100498.290000003
"15461",2017-06-26 05:47:33,-100498.29,3.0267983675003e-09
"15462",2017-06-26 06:19:47,100061.64,100061.640000003
"15463",2017-06-26 06:38:18,-100061.64,3.0267983675003e-09
"15464",2017-06-26 07:01:52,50061.85,50061.850000003
"15465",2017-06-26 07:04:30,-50061.85,3.0267983675003e-09
"1218",2017-06-26 08:12:49,328093.07,328093.070000003
"15466",2017-06-26 08:12:49,100061.84,428154.910000003
"15467",2017-06-26 08:12:49,980476.63,1408631.54
"1219",2017-06-26 08:16:53,-328093.07,1080538.47
"15468",2017-06-26 08:16:53,-1080538.47,3.0267983675003e-09
"15469",2017-06-26 08:23:44,245282.75,245282.750000003
"1220",2017-06-26 08:24:59,143912.36,389195.110000003
"1221",2017-06-26 08:32:57,-143912.36,245282.750000003
"15470",2017-06-26 08:32:57,-245282.75,3.0267983675003e-09
"15471",2017-06-26 08:32:57,158722.7,158722.700000003
"15472",2017-06-26 08:48:37,-158722.7,3.0267983675003e-09
"15473",2017-06-26 08:48:37,202248.76,202248.760000003
"1222",2017-06-26 08:52:59,77466.87,279715.630000003
"15474",2017-06-26 08:52:59,-202248.76,77466.870000003
"1223",2017-06-26 09:38:33,-77466.87,3.0267983675003e-09
"1224",2017-06-26 09:38:33,149743.92,149743.920000003
"1225",2017-06-26 09:38:33,101967.78,251711.700000003
"15475",2017-06-26 09:38:33,206107.87,457819.570000003
"15476",2017-06-26 09:38:33,234393.29,692212.860000003
"15477",2017-06-26 09:38:33,218133.36,910346.220000003
"15478",2017-06-26 09:38:33,221311.14,1131657.36
"1226",2017-06-26 10:06:23,-251711.7,879945.660000003
"1227",2017-06-26 10:06:23,79982.47,959928.130000003
"15479",2017-06-26 10:07:29,300062.49,1259990.62
"1228",2017-06-26 10:16:59,-79982.47,1180008.15
"15480",2017-06-26 10:16:59,-1180008.15,3.25962901115417e-09
"1229",2017-06-26 10:43:30,200062.52,200062.520000003
"1230",2017-06-26 10:43:30,113005.02,313067.540000003
"1231",2017-06-26 10:51:41,-313067.54,3.25962901115417e-09
"15481",2017-06-26 10:55:17,255760.91,255760.910000003
"1232",2017-06-26 11:16:41,217309.22,473070.130000003
"15482",2017-06-26 11:16:41,-255760.91,217309.220000003
"1233",2017-06-26 11:19:42,-217309.22,3.25962901115417e-09
"15483",2017-06-26 11:19:42,97278.31,97278.3100000033
"15484",2017-06-26 11:34:35,-97278.31,3.25962901115417e-09
"15485",2017-06-26 11:34:35,89339.71,89339.7100000033
"15486",2017-06-26 11:49:56,-89339.71,3.25962901115417e-09
"15487",2017-06-26 11:49:56,147226.33,147226.330000003
"15488",2017-06-26 11:52:21,-147226.33,3.25962901115417e-09
"15489",2017-06-26 12:12:24,266533.09,266533.090000003
"15490",2017-06-26 12:20:13,-266533.09,3.25962901115417e-09
"15491",2017-06-26 14:43:46,304454.35,304454.350000003
"15492",2017-06-26 14:52:39,-304454.35,3.25962901115417e-09
"1234",2017-06-26 15:59:33,331146.2,331146.200000003
"15493",2017-06-26 15:59:33,399353.94,730500.140000003
"1235",2017-06-26 16:26:02,-331146.2,399353.940000003
"15494",2017-06-26 16:26:02,-399353.94,3.25962901115417e-09
"15495",2017-06-26 16:28:12,524054.08,524054.080000003
"15496",2017-06-26 16:28:12,252027.64,776081.720000003
"15497",2017-06-26 16:28:12,213729.66,989811.380000003
"15498",2017-06-26 16:43:42,-989811.38,3.25962901115417e-09
"15499",2017-06-26 16:43:42,300062.66,300062.660000003
"15500",2017-06-26 16:52:27,-300062.66,3.25962901115417e-09
"15501",2017-06-26 17:02:04,240592.76,240592.760000003
"1236",2017-06-26 17:17:44,339401.06,579993.820000003
"15502",2017-06-26 17:17:44,-240592.76,339401.060000003
"15503",2017-06-26 17:17:44,496736.49,836137.550000003
"15504",2017-06-26 17:17:44,404620.17,1240757.72
"1237",2017-06-26 17:28:24,-339401.06,901356.660000003
"15505",2017-06-26 17:35:29,-901356.66,3.14321368932724e-09
"1238",2017-06-26 17:39:24,177839.71,177839.710000003
"1239",2017-06-26 17:45:01,-177839.71,3.14321368932724e-09
"15506",2017-06-26 17:45:01,122256.66,122256.660000003
"15507",2017-06-26 17:58:42,-122256.66,3.14321368932724e-09
"15508",2017-06-26 17:58:42,104124.53,104124.530000003
"15509",2017-06-26 17:58:42,193763.91,297888.440000003
"15510",2017-06-26 18:33:46,-297888.44,3.14321368932724e-09
"1240",2017-06-26 20:20:14,247243.38,247243.380000003
"1241",2017-06-26 20:20:14,150063.06,397306.440000003
"15511",2017-06-26 20:20:14,334706.28,732012.720000003
"15512",2017-06-26 20:20:14,300063.05,1032075.77
"15513",2017-06-26 20:20:14,772803.11,1804878.88
"1242",2017-06-26 20:45:27,-397306.44,1407572.44
"15514",2017-06-26 20:45:27,-1407572.44,3.25962901115417e-09
"1243",2017-06-26 21:02:33,160154.09,160154.090000003
"1244",2017-06-26 21:02:33,170063.11,330217.200000003
"15515",2017-06-26 21:02:33,161067.64,491284.840000003
"15516",2017-06-26 21:02:33,286460.46,777745.300000003
"15517",2017-06-26 21:02:33,451555.91,1229301.21
"1245",2017-06-26 21:07:14,-330217.2,899084.010000003
"15518",2017-06-26 21:07:14,-899084.01,3.25962901115417e-09
"15519",2017-06-26 21:07:14,300063.12,300063.120000003
"15520",2017-06-26 21:16:42,-300063.12,3.25962901115417e-09
"1246",2017-06-26 22:22:49,164819.66,164819.660000003
"15521",2017-06-26 22:22:49,175383.89,340203.550000003
"15522",2017-06-26 22:22:49,221052.66,561256.210000003
"1247",2017-06-26 22:32:28,-164819.66,396436.550000003
"15523",2017-06-26 22:32:28,-396436.55,3.31783667206764e-09
"1248",2017-06-26 22:41:20,84341.36,84341.3600000033
"1249",2017-06-26 22:46:20,-84341.36,3.31783667206764e-09
"15524",2017-06-26 23:52:35,197548.6,197548.600000003
"15525",2017-06-27 00:34:06,-197548.6,3.31783667206764e-09
"15526",2017-06-27 00:38:27,373161.11,373161.110000003
"15527",2017-06-27 00:38:27,254364.75,627525.860000003
"15528",2017-06-27 00:38:27,167694.17,795220.030000003
"15529",2017-06-27 00:42:12,-795220.03,3.37604433298111e-09
"15530",2017-06-27 00:42:12,200550.5,200550.500000003
"15531",2017-06-27 00:53:25,-200550.5,3.37604433298111e-09
"15532",2017-06-27 01:08:46,226295.54,226295.540000003
"15533",2017-06-27 01:08:46,201276.98,427572.520000003
"15534",2017-06-27 01:47:22,-427572.52,3.37604433298111e-09
"1250",2017-06-27 01:51:47,103015.28,103015.280000003
"1251",2017-06-27 01:54:55,-103015.28,3.37604433298111e-09
"15535",2017-06-27 02:12:18,168482.52,168482.520000003
"15536",2017-06-27 02:22:11,-168482.52,3.37604433298111e-09
"15537",2017-06-27 02:24:33,188794.54,188794.540000003
"15538",2017-06-27 02:49:17,-188794.54,3.37604433298111e-09
"1252",2017-06-27 02:56:51,81545.36,81545.3600000034
"1253",2017-06-27 03:43:09,-81545.36,3.37604433298111e-09
"15539",2017-06-27 03:43:09,26036.56,26036.5600000034
"15540",2017-06-27 03:47:07,-26036.56,3.37604433298111e-09
"15541",2017-06-27 04:17:14,161355.73,161355.730000003
"15542",2017-06-27 04:22:31,-161355.73,3.37604433298111e-09
"15543",2017-06-27 04:40:53,207471.57,207471.570000003
"15544",2017-06-27 05:01:30,-207471.57,3.37604433298111e-09
"1254",2017-06-27 05:33:03,112744.15,112744.150000003
"15545",2017-06-27 05:33:03,223798.1,336542.250000003
"1255",2017-06-27 05:35:58,-112744.15,223798.100000003
"15546",2017-06-27 05:35:58,-223798.1,3.37604433298111e-09
"1256",2017-06-27 06:58:26,160663.09,160663.090000003
"15547",2017-06-27 06:58:26,205665.43,366328.520000003
"15548",2017-06-27 06:58:26,848825.98,1215154.5
"1257",2017-06-27 07:39:11,19600.16,1234754.66
"1258",2017-06-27 07:39:11,-160663.09,1074091.57
"15549",2017-06-27 07:39:11,-1054491.41,19600.1600000032
"1259",2017-06-27 07:53:20,-19600.16,3.17595549859107e-09
"1260",2017-06-27 07:55:15,134825.06,134825.060000003
"15550",2017-06-27 07:55:15,411597.89,546422.950000003
"15551",2017-06-27 07:55:15,388161.44,934584.390000003
"1261",2017-06-27 08:10:23,-134825.06,799759.330000003
"15552",2017-06-27 08:10:23,-799759.33,3.14321368932724e-09
"1262",2017-06-27 08:31:17,102806.42,102806.420000003
"1263",2017-06-27 08:31:17,104299.29,207105.710000003
"15553",2017-06-27 08:31:17,148563.22,355668.930000003
"1264",2017-06-27 08:33:34,-207105.71,148563.220000003
"15554",2017-06-27 08:33:34,-148563.22,3.14321368932724e-09
"1265",2017-06-27 10:34:46,78942.08,78942.0800000031
"1266",2017-06-27 11:16:15,-78942.08,3.14321368932724e-09
"1267",2017-06-27 12:40:00,309377.7,309377.700000003
"1268",2017-06-27 13:01:14,-309377.7,3.14321368932724e-09
"1269",2017-06-27 13:44:20,153761.35,153761.350000003
"1270",2017-06-27 13:44:20,148780.24,302541.590000003
"15555",2017-06-27 13:44:20,300064.68,602606.270000003
"1271",2017-06-27 14:01:08,-302541.59,300064.680000003
"1272",2017-06-27 14:01:08,94340.52,394405.200000003
"15556",2017-06-27 14:01:08,-300064.68,94340.520000003
"15557",2017-06-27 14:01:08,300064.71,394405.230000003
"15558",2017-06-27 14:01:08,866828.46,1261233.69
"1273",2017-06-27 14:10:45,-94340.52,1166893.17
"15559",2017-06-27 14:10:45,-1166893.17,3.0267983675003e-09
"1274",2017-06-27 14:24:48,115017.39,115017.390000003
"15560",2017-06-27 14:24:48,427284.81,542302.200000003
"15561",2017-06-27 14:24:48,367966.32,910268.520000003
"1275",2017-06-27 14:32:19,17359.01,927627.530000003
"1276",2017-06-27 14:32:19,-115017.39,812610.140000003
"15562",2017-06-27 14:32:19,-795251.13,17359.010000003
"1277",2017-06-27 14:37:10,-17359.01,3.03771230392158e-09
"1278",2017-06-27 14:54:35,144823.3,144823.300000003
"15563",2017-06-27 14:54:35,350696.87,495520.170000003
"1279",2017-06-27 15:02:07,-144823.3,350696.870000003
"15564",2017-06-27 15:02:07,-350696.87,3.0267983675003e-09
"1280",2017-06-27 15:41:35,169525.6,169525.600000003
"15565",2017-06-27 15:41:35,345175.55,514701.150000003
"15566",2017-06-27 15:41:35,329614.82,844315.970000003
"15567",2017-06-27 15:41:35,191393.71,1035709.68
"1281",2017-06-27 15:43:12,-169525.6,866184.080000003
"15568",2017-06-27 15:43:12,-866184.08,3.0267983675003e-09
"1282",2017-06-27 16:05:38,16685.52,16685.520000003
"15569",2017-06-27 16:05:38,295243.66,311929.180000003
"15570",2017-06-27 16:05:38,296399.61,608328.790000003
"1283",2017-06-27 16:09:15,-16685.52,591643.270000003
"15571",2017-06-27 16:09:15,-591643.27,3.0267983675003e-09
"15572",2017-06-27 17:11:08,252199.66,252199.660000003
"15573",2017-06-27 17:11:08,231949.96,484149.620000003
"1284",2017-06-27 17:14:45,96032.38,580182.000000003
"1285",2017-06-27 17:14:45,149885.41,730067.410000003
"15574",2017-06-27 17:14:45,-484149.62,245917.790000003
"15575",2017-06-27 17:14:45,222889.5,468807.290000003
"15576",2017-06-27 17:14:45,312460.74,781268.030000003
"1286",2017-06-27 17:22:47,-245917.79,535350.240000003
"15577",2017-06-27 17:22:47,-535350.24,3.0267983675003e-09
"15578",2017-06-27 18:31:56,286491.39,286491.390000003
"15579",2017-06-27 18:37:33,-286491.39,3.0267983675003e-09
"1287",2017-06-27 19:46:36,94328.34,94328.340000003
"15580",2017-06-27 19:46:36,160374.95,254703.290000003
"15581",2017-06-27 19:46:36,340956.77,595660.060000003
"15582",2017-06-27 19:46:36,295703.4,891363.460000003
"15583",2017-06-27 19:46:36,177870.28,1069233.74
"1288",2017-06-27 20:07:44,-94328.34,974905.400000003
"15584",2017-06-27 20:07:44,-974905.4,3.0267983675003e-09
"15585",2017-06-27 20:22:01,126002.08,126002.080000003
"15586",2017-06-27 21:04:06,-126002.08,3.0267983675003e-09
"15587",2017-06-27 21:40:36,187556.97,187556.970000003
"15588",2017-06-27 21:46:12,-187556.97,3.0267983675003e-09
"1289",2017-06-27 21:52:43,108165.71,108165.710000003
"1290",2017-06-27 21:53:35,-108165.71,3.0267983675003e-09
"15589",2017-06-27 22:07:30,137754.65,137754.650000003
"15590",2017-06-27 22:09:31,-137754.65,3.0267983675003e-09
"15591",2017-06-27 22:27:02,228266.16,228266.160000003
"1291",2017-06-27 22:37:49,93030.63,321296.790000003
"15592",2017-06-27 22:37:49,-228266.16,93030.6300000031
"15593",2017-06-27 22:37:49,186624.4,279655.030000003
"1292",2017-06-27 22:42:56,-93030.63,186624.400000003
"15594",2017-06-27 22:42:56,-186624.4,3.05590219795704e-09
"1293",2017-06-27 23:19:12,86140.06,86140.0600000031
"1294",2017-06-27 23:23:59,-86140.06,3.05590219795704e-09
"15595",2017-06-27 23:54:30,189582.57,189582.570000003
"1295",2017-06-28 00:03:22,18844.2,208426.770000003
"1296",2017-06-28 00:10:51,84248.23,292675.000000003
"1297",2017-06-28 00:10:51,-18844.2,273830.800000003
"1298",2017-06-28 00:15:45,-84248.23,189582.570000003
"1299",2017-06-28 00:37:04,93810.13,283392.700000003
"1300",2017-06-28 00:38:15,-93810.13,189582.570000003
"1301",2017-06-28 01:24:16,84695.76,274278.330000003
"1302",2017-06-28 01:24:16,99072.45,373350.780000003
"15596",2017-06-28 01:24:16,255352.99,628703.770000003
"15597",2017-06-28 01:24:16,274544.02,903247.790000003
"1303",2017-06-28 01:41:03,-183768.21,719479.580000003
"1304",2017-06-28 01:59:59,142525.22,862004.800000003
"15598",2017-06-28 01:59:59,268754.49,1130759.29
"1305",2017-06-28 02:13:20,-142525.22,988234.070000003
"15599",2017-06-28 03:04:49,187981.93,1176216
"15600",2017-06-28 03:24:06,152870.19,1329086.19
"15601",2017-06-28 05:34:52,253121.45,1582207.64
"1306",2017-06-28 05:45:13,90169.93,1672377.57
"1307",2017-06-28 05:55:37,-90169.93,1582207.64
"15602",2017-06-28 06:10:20,151888.12,1734095.76
"15603",2017-06-28 06:10:20,178454.63,1912550.39
"15604",2017-06-28 07:13:55,104613.92,2017164.31
"1308",2017-06-28 10:29:45,19303.66,2036467.97
"1309",2017-06-28 10:43:24,-19303.66,2017164.31
"1310",2017-06-28 10:55:45,89562.45,2106726.76
"1311",2017-06-28 10:57:56,-89562.45,2017164.31
"1312",2017-06-28 16:56:15,20397.03,2037561.34
"15605",2017-06-28 16:56:15,144348.64,2181909.98
"15606",2017-06-28 16:56:15,171351.67,2353261.65
"15607",2017-06-28 16:56:15,200099.85,2553361.5
"1313",2017-06-28 17:16:18,-20397.03,2532964.47
"1314",2017-06-28 17:16:18,105503.65,2638468.12
"1315",2017-06-28 17:28:22,-105503.65,2532964.47
"15608",2017-06-28 17:43:41,186496.5,2719460.97
"15609",2017-06-28 17:43:41,140771.89,2860232.86
"15610",2017-06-28 18:10:09,125186.21,2985419.07
"15611",2017-06-28 19:01:17,211832.33,3197251.4
"15612",2017-06-28 19:05:11,256638.43,3453889.83
"15613",2017-06-28 19:09:08,131372.62,3585262.45
"1316",2017-06-28 20:04:47,119868.31,3705130.76
"15614",2017-06-28 20:04:47,331973.33,4037104.09
"1317",2017-06-28 20:40:16,-119868.31,3917235.78
"15615",2017-06-28 20:40:16,198350.11,4115585.89
"15616",2017-06-28 20:40:16,238784.61,4354370.5
"15617",2017-06-28 20:40:16,165584.1,4519954.6
"15618",2017-06-28 21:05:04,249258.45,4769213.05
"1318",2017-06-28 23:06:32,20270.63,4789483.68
"1319",2017-06-28 23:15:32,-20270.63,4769213.05
"1320",2017-06-28 23:17:02,105105.15,4874318.2
"1321",2017-06-28 23:24:27,-105105.15,4769213.05
"1322",2017-06-29 00:34:53,104813.58,4874026.63
"1323",2017-06-29 00:42:53,-104813.58,4769213.05
"15619",2017-06-29 01:56:34,231707.77,5000920.82
"15620",2017-06-29 02:35:20,188498.71,5189419.53
"1324",2017-06-29 03:11:24,98968.71,5288388.24
"1325",2017-06-29 03:19:27,-98968.71,5189419.53
"15621",2017-06-29 04:06:28,22929.32,5212348.85
"1326",2017-06-29 04:09:38,86744.2,5299093.05
"1327",2017-06-29 04:54:24,-86744.2,5212348.85
"1328",2017-06-29 05:40:37,118314.84,5330663.69
"1329",2017-06-29 05:43:59,-118314.84,5212348.85
"1330",2017-06-29 07:23:08,96624.59,5308973.44
"1331",2017-06-29 07:35:53,-96624.59,5212348.85
"1332",2017-06-29 08:47:11,88661.88,5301010.73
"15622",2017-06-29 08:47:11,146366.43,5447377.16
"15623",2017-06-29 08:47:11,79082.23,5526459.39
"1333",2017-06-29 08:58:38,-88661.88,5437797.51
"15624",2017-06-29 08:58:38,187256.32,5625053.83
"1334",2017-06-29 09:47:04,19154.02,5644207.85
"1335",2017-06-29 10:00:50,-19154.02,5625053.83
"1336",2017-06-29 10:00:50,119096.92,5744150.75
"1337",2017-06-29 10:00:50,116355.09,5860505.84
"15625",2017-06-29 10:00:50,272834.79,6133340.63
"15626",2017-06-29 10:00:50,245774.8,6379115.43
"1338",2017-06-29 10:14:37,-235452.01,6143663.42
"1339",2017-06-29 10:14:37,104948.43,6248611.85
"15627",2017-06-29 10:14:37,264026.67,6512638.52
"15628",2017-06-29 10:14:37,373864.04,6886502.56
"1340",2017-06-29 10:21:27,-104948.43,6781554.13
"1341",2017-06-29 10:32:48,171170.27,6952724.4
"1342",2017-06-29 10:32:48,194682.76,7147407.16
"15629",2017-06-29 10:32:48,389323.35,7536730.51
"1343",2017-06-29 10:36:41,-365853.03,7170877.48
"15630",2017-06-29 10:36:41,257472.03,7428349.51
"15631",2017-06-29 10:41:26,470381.49,7898731
"15632",2017-06-29 11:20:32,328756.3,8227487.3
"1344",2017-06-29 11:45:01,315330.14,8542817.44
"15633",2017-06-29 11:45:01,249336.83,8792154.27
"1345",2017-06-29 11:58:40,-315330.14,8476824.13
"1346",2017-06-29 12:18:04,353239.11,8830063.24
"1347",2017-06-29 12:58:55,137843.36,8967906.6
"1348",2017-06-29 12:58:55,-353239.11,8614667.49
"15634",2017-06-29 12:58:55,165024.06,8779691.55
"1349",2017-06-29 13:12:43,-137843.36,8641848.19
"15635",2017-06-29 13:15:15,114782.01,8756630.2
"1350",2017-06-29 13:29:32,33156.8,8789787
"1351",2017-06-29 13:35:49,-33156.8,8756630.2
"1352",2017-06-29 14:47:54,90962.55,8847592.75
"15636",2017-06-29 14:47:54,156659.81,9004252.56
"1353",2017-06-29 15:35:58,-90962.55,8913290.01
"15637",2017-06-29 15:43:48,233795.41,9147085.42
"15638",2017-06-29 15:43:48,262861.35,9409946.77
"1354",2017-06-29 17:10:30,109961.43,9519908.2
"1355",2017-06-29 17:12:33,-109961.43,9409946.77
"1356",2017-06-29 17:23:24,90982.02,9500928.79
"1357",2017-06-29 17:31:08,-90982.02,9409946.77
"15639",2017-06-29 17:57:49,148874.61,9558821.38
"15640",2017-06-29 18:23:33,202213.17,9761034.55
"1358",2017-06-29 18:46:45,25577.5,9786612.05
"15641",2017-06-29 18:46:45,217833.39,10004445.44
"1359",2017-06-29 18:54:10,-25577.5,9978867.94
"1360",2017-06-29 20:04:57,121693.69,10100561.63
"15642",2017-06-29 20:04:57,159834.38,10260396.01
"15643",2017-06-29 20:04:57,118055.15,10378451.16
"1361",2017-06-29 20:45:44,-121693.69,10256757.47
"15644",2017-06-29 20:47:28,108078.13,10364835.6
"15645",2017-06-29 22:06:15,96380.89,10461216.49
"15646",2017-06-29 22:15:39,215098.14,10676314.63
"1362",2017-06-29 22:52:58,110502.97,10786817.6
"1363",2017-06-29 23:29:30,-110502.97,10676314.63
"1364",2017-06-29 23:29:30,92784.03,10769098.66
"15647",2017-06-29 23:29:30,272060.85,11041159.51
"1365",2017-06-29 23:35:08,-92784.03,10948375.48
"1366",2017-06-30 00:11:53,107371.5,11055746.98
"1367",2017-06-30 00:21:37,-107371.5,10948375.48
"1368",2017-06-30 03:42:18,90788.74,11039164.22
"1369",2017-06-30 03:49:37,-90788.74,10948375.48
"15648",2017-06-30 03:49:37,246522.38,11194897.86
"15649",2017-06-30 07:34:27,-11194897.86,7.45058059692383e-09
"1371",2017-06-30 07:43:49,18217.66,18217.6600000075
"1370",2017-06-30 07:44:08,26849.56,45067.2200000075
"1372",2017-06-30 07:49:52,145506.28,190573.500000007
"1373",2017-06-30 07:49:52,-45067.22,145506.280000007
"1374",2017-06-30 08:10:27,108208.38,253714.660000007
"1375",2017-06-30 08:10:27,-145506.28,108208.380000007
"1376",2017-06-30 08:16:54,-108208.38,7.45058059692383e-09
"1377",2017-06-30 10:08:38,91459.26,91459.2600000074
"15650",2017-06-30 10:08:38,128480.34,219939.600000007
"1378",2017-06-30 10:12:49,-91459.26,128480.340000007
"15651",2017-06-30 10:12:49,-128480.34,7.43602868169546e-09
"1379",2017-06-30 11:24:34,94222.48,94222.4800000074
"1380",2017-06-30 11:43:18,-94222.48,7.43602868169546e-09
"1381",2017-06-30 11:43:18,146080.48,146080.480000007
"15652",2017-06-30 11:43:18,114159.1,260239.580000007
"1382",2017-06-30 11:53:03,-146080.48,114159.100000007
"15653",2017-06-30 11:53:03,-114159.1,7.42147676646709e-09
"15654",2017-06-30 12:11:12,189820.36,189820.360000007
"15655",2017-06-30 12:11:12,133583.87,323404.230000007
"15656",2017-06-30 12:14:16,-323404.23,7.45058059692383e-09
"15657",2017-06-30 12:39:35,145910.9,145910.900000007
"15658",2017-06-30 12:45:17,-145910.9,7.45058059692383e-09
"15659",2017-06-30 13:23:45,180573.02,180573.020000007
"15660",2017-06-30 13:53:36,-180573.02,7.45058059692383e-09
"15661",2017-06-30 13:53:36,137704.74,137704.740000007
"15662",2017-06-30 13:55:42,-137704.74,7.45058059692383e-09
"1383",2017-06-30 14:50:58,24680.51,24680.5100000074
"15663",2017-06-30 14:50:58,237390.26,262070.770000007
"1384",2017-06-30 15:07:48,-24680.51,237390.260000007
"15664",2017-06-30 15:07:48,-237390.26,7.45058059692383e-09
"1385",2017-06-30 15:58:01,111429.03,111429.030000007
"1386",2017-06-30 16:22:14,-111429.03,7.45058059692383e-09
"1387",2017-06-30 17:28:40,121783.78,121783.780000007
"1388",2017-06-30 18:09:07,-121783.78,7.45058059692383e-09
"15665",2017-06-30 22:37:05,222894.26,222894.260000007
"15666",2017-06-30 22:46:48,-222894.26,7.45058059692383e-09
"1389",2017-07-01 00:56:11,99424.85,99424.8500000075
"15667",2017-07-01 00:56:11,191710.51,291135.360000007
"15668",2017-07-01 00:56:11,115356.83,406492.190000007
"15669",2017-07-01 00:56:11,240595.98,647088.170000007
"15670",2017-07-01 00:56:11,325470.31,972558.480000007
"15671",2017-07-01 00:56:11,234669.98,1207228.46000001
"1390",2017-07-01 01:17:21,-99424.85,1107803.61000001
"15672",2017-07-01 01:17:21,-1107803.61,7.21774995326996e-09
"15673",2017-07-01 01:44:28,303124.51,303124.510000007
"15674",2017-07-01 01:44:28,232177.87,535302.380000007
"15675",2017-07-01 01:44:28,210949.58,746251.960000007
"15676",2017-07-01 01:44:28,156355.01,902606.970000007
"15677",2017-07-01 01:51:52,-902606.97,7.21774995326996e-09
"15678",2017-07-01 01:51:52,184334.84,184334.840000007
"15679",2017-07-01 01:56:28,-184334.84,7.21774995326996e-09
"15680",2017-07-01 02:07:15,208905.48,208905.480000007
"15681",2017-07-01 02:38:41,-208905.48,7.21774995326996e-09
"15682",2017-07-01 03:03:04,336188.9,336188.900000007
"15683",2017-07-01 03:03:04,236203.39,572392.290000007
"15684",2017-07-01 03:19:06,-572392.29,7.21774995326996e-09
"15685",2017-07-01 04:26:09,169421.97,169421.970000007
"15686",2017-07-01 04:44:36,-169421.97,7.21774995326996e-09
"15687",2017-07-01 13:52:04,177416.43,177416.430000007
"15688",2017-07-01 13:56:49,-177416.43,7.21774995326996e-09
"15689",2017-07-01 14:20:17,154870.18,154870.180000007
"15690",2017-07-01 14:27:31,-154870.18,7.21774995326996e-09
"15691",2017-07-01 14:51:22,263189.23,263189.230000007
"1391",2017-07-01 14:54:25,17686.25,280875.480000007
"15692",2017-07-01 14:54:25,-263189.23,17686.2500000072
"1392",2017-07-01 15:00:16,-17686.25,7.21774995326996e-09
"1393",2017-07-01 15:46:17,108788.04,108788.040000007
"1394",2017-07-01 15:52:21,94177.55,202965.590000007
"1395",2017-07-01 15:52:21,-108788.04,94177.5500000072
"1396",2017-07-01 16:02:49,-94177.55,7.21774995326996e-09
"15693",2017-07-01 16:05:32,231268,231268.000000007
"15694",2017-07-01 16:16:20,-231268,7.21774995326996e-09
"1397",2017-07-01 16:58:45,25685.49,25685.4900000072
"1398",2017-07-01 17:10:03,-25685.49,7.21774995326996e-09
"1399",2017-07-01 17:26:02,103012.01,103012.010000007
"15695",2017-07-01 18:01:03,347765.54,450777.550000007
"1400",2017-07-01 18:01:25,-103012.01,347765.540000007
"15696",2017-07-01 18:05:53,-347765.54,7.21774995326996e-09
"1401",2017-07-01 18:29:31,95117.25,95117.2500000072
"1402",2017-07-01 18:31:05,-95117.25,7.21774995326996e-09
"1403",2017-07-01 19:35:26,107539.94,107539.940000007
"15697",2017-07-01 19:35:26,302907.12,410447.060000007
"15698",2017-07-01 19:35:26,342921.44,753368.500000007
"1404",2017-07-01 20:16:48,124907.87,878276.370000007
"1405",2017-07-01 20:16:48,-107539.94,770736.430000007
"15699",2017-07-01 20:16:48,-645828.56,124907.870000007
"15700",2017-07-01 20:16:48,246836.57,371744.440000007
"1406",2017-07-01 20:19:18,-124907.87,246836.570000007
"15701",2017-07-01 20:26:15,-246836.57,7.10133463144302e-09
"15702",2017-07-01 20:26:15,251444.64,251444.640000007
"15703",2017-07-01 20:26:15,468586.01,720030.650000007
"1407",2017-07-01 20:28:20,93661.62,813692.270000007
"1408",2017-07-01 20:36:33,-93661.62,720030.650000007
"15704",2017-07-01 20:36:33,-720030.65,7.10133463144302e-09
"1409",2017-07-01 21:24:42,97804.5,97804.5000000071
"15705",2017-07-01 21:24:42,223752.03,321556.530000007
"1410",2017-07-01 21:27:37,-97804.5,223752.030000007
"15706",2017-07-01 21:27:37,-223752.03,7.13043846189976e-09
"1411",2017-07-01 22:41:14,98746.28,98746.2800000071
"1412",2017-07-01 22:48:49,-98746.28,7.13043846189976e-09
"15707",2017-07-01 22:48:49,174326.29,174326.290000007
"15708",2017-07-01 22:55:49,-174326.29,7.13043846189976e-09
"1413",2017-07-01 23:17:43,108401.13,108401.130000007
"1414",2017-07-01 23:28:06,-108401.13,7.13043846189976e-09
"1415",2017-07-02 00:32:00,93382.95,93382.9500000071
"1416",2017-07-02 00:45:26,-93382.95,7.13043846189976e-09
"15709",2017-07-02 02:49:10,209635.38,209635.380000007
"15710",2017-07-02 02:49:10,134077.33,343712.710000007
"15711",2017-07-02 03:01:30,-343712.71,7.10133463144302e-09
"15712",2017-07-02 03:01:30,240119.27,240119.270000007
"15713",2017-07-02 03:04:29,224108.65,464227.920000007
"15714",2017-07-02 03:09:07,-464227.92,7.10133463144302e-09
"15715",2017-07-02 03:14:27,181514.88,181514.880000007
"15716",2017-07-02 03:43:40,-181514.88,7.10133463144302e-09
"15717",2017-07-02 03:43:40,237554.52,237554.520000007
"15718",2017-07-02 03:52:34,-237554.52,7.10133463144302e-09
"15719",2017-07-02 06:26:44,177845.98,177845.980000007
"15720",2017-07-02 06:30:06,-177845.98,7.10133463144302e-09
"15721",2017-07-02 07:38:01,177846.67,177846.670000007
"15722",2017-07-02 07:45:16,-177846.67,7.10133463144302e-09
"15723",2017-07-02 08:17:36,50069.98,50069.9800000071
"15724",2017-07-02 08:27:56,-50069.98,7.10133463144302e-09
"15725",2017-07-02 08:34:35,50070.21,50070.2100000071
"15726",2017-07-02 08:39:50,-50070.21,7.10133463144302e-09
"1417",2017-07-02 09:15:38,254850.99,254850.990000007
"1418",2017-07-02 09:29:50,-254850.99,7.10133463144302e-09
"1419",2017-07-02 11:25:38,7699.18,7699.1800000071
"15727",2017-07-02 11:25:38,173926.22,181625.400000007
"15728",2017-07-02 11:25:38,102113.64,283739.040000007
"1420",2017-07-02 11:31:44,-7699.18,276039.860000007
"15729",2017-07-02 11:31:44,-276039.86,7.10133463144302e-09
"15730",2017-07-02 12:01:11,199620.47,199620.470000007
"15731",2017-07-02 12:23:39,-199620.47,7.10133463144302e-09
"1421",2017-07-02 13:45:59,95727.76,95727.7600000071
"1422",2017-07-02 14:18:36,-95727.76,7.10133463144302e-09
"1423",2017-07-02 15:14:33,93279.95,93279.9500000071
"1424",2017-07-02 15:14:33,90619.96,183899.910000007
"1425",2017-07-02 15:18:47,-183899.91,7.10133463144302e-09
"1426",2017-07-02 17:14:58,97111.22,97111.2200000071
"1427",2017-07-02 17:22:36,-97111.22,7.10133463144302e-09
"15732",2017-07-02 19:39:59,165024.47,165024.470000007
"15733",2017-07-02 19:43:21,-165024.47,7.10133463144302e-09
"1428",2017-07-02 20:08:05,16982.9,16982.9000000071
"1429",2017-07-02 20:11:51,-16982.9,7.10133463144302e-09
"1430",2017-07-02 21:02:01,82509,82509.0000000071
"1431",2017-07-02 21:12:00,-82509,7.10133463144302e-09
"1432",2017-07-02 22:16:22,82647.88,82647.8800000071
"1433",2017-07-02 22:21:58,-82647.88,7.10133463144302e-09
"15734",2017-07-03 00:09:22,195298.44,195298.440000007
"15735",2017-07-03 00:09:22,209658.69,404957.130000007
"15736",2017-07-03 00:30:53,-404957.13,7.10133463144302e-09
"15737",2017-07-03 00:30:53,245157.37,245157.370000007
"15738",2017-07-03 00:38:46,-245157.37,7.10133463144302e-09
"1434",2017-07-03 00:53:52,18180.66,18180.6600000071
"1435",2017-07-03 00:53:52,93852.47,112033.130000007
"15739",2017-07-03 00:53:52,258431.8,370464.930000007
"1436",2017-07-03 00:58:53,-112033.13,258431.800000007
"15740",2017-07-03 00:58:53,-258431.8,7.10133463144302e-09
"15741",2017-07-03 02:20:37,175217.33,175217.330000007
"15742",2017-07-03 02:28:32,-175217.33,7.10133463144302e-09
"15743",2017-07-03 03:06:06,231668.66,231668.660000007
"15744",2017-07-03 03:52:17,-231668.66,7.10133463144302e-09
"15745",2017-07-03 03:52:17,114554.23,114554.230000007
"15746",2017-07-03 04:34:07,-114554.23,7.10133463144302e-09
"15747",2017-07-03 05:28:00,172472.32,172472.320000007
"15748",2017-07-03 05:34:59,-172472.32,7.10133463144302e-09
"1437",2017-07-03 12:47:54,17330.19,17330.1900000071
"1438",2017-07-03 13:04:32,85200.61,102530.800000007
"1439",2017-07-03 13:04:32,-17330.19,85200.6100000071
"1440",2017-07-03 13:23:55,-85200.61,7.10133463144302e-09
"1441",2017-07-03 14:01:27,146753.32,146753.320000007
"1442",2017-07-03 14:11:57,-146753.32,7.10133463144302e-09
"1443",2017-07-03 14:19:44,127003.54,127003.540000007
"1444",2017-07-03 14:45:17,-127003.54,7.10133463144302e-09
"15749",2017-07-03 14:51:58,132454.14,132454.140000007
"15750",2017-07-03 14:56:19,-132454.14,7.10133463144302e-09
"15751",2017-07-03 15:25:19,146264.09,146264.090000007
"1445",2017-07-04 03:03:00,123257.23,269521.320000007
"1446",2017-07-04 03:07:49,-123257.23,146264.090000007
"1447",2017-07-04 04:22:40,94163.28,240427.370000007
"1448",2017-07-04 04:22:40,87625.48,328052.850000007
"1449",2017-07-04 04:32:26,-181788.76,146264.090000007
"15752",2017-07-04 15:52:57,119917.91,266182.000000007
"15753",2017-07-04 15:52:57,120620.47,386802.470000007
"1450",2017-07-04 17:00:39,41481.71,428284.180000007
"1451",2017-07-04 17:18:59,-41481.71,386802.470000007
"1452",2017-07-04 17:21:40,119879.87,506682.340000007
"1453",2017-07-04 17:26:44,-119879.87,386802.470000007
"15754",2017-07-05 08:17:49,193934.13,580736.600000007
"15755",2017-07-05 08:26:17,209236.58,789973.180000007
"15756",2017-07-05 08:26:17,204824.11,994797.290000007
"15757",2017-07-05 08:26:17,129296.88,1124094.17000001
"1454",2017-07-05 08:31:45,107439.37,1231533.54000001
"1455",2017-07-05 08:52:24,-107439.37,1124094.17000001
"1456",2017-07-05 09:01:46,128758.13,1252852.30000001
"1457",2017-07-05 09:18:40,-128758.13,1124094.17000001
"15758",2017-07-05 11:09:36,131187.57,1255281.74000001
"15759",2017-07-05 11:09:36,48242.85,1303524.59000001
"15760",2017-07-05 12:18:21,160342.54,1463867.13000001
"15761",2017-07-05 12:25:41,126123.18,1589990.31000001
"15762",2017-07-05 12:49:44,126757.47,1716747.78000001
"15763",2017-07-05 13:40:30,188027.39,1904775.17000001
"15764",2017-07-05 14:02:56,36565.82,1941340.99000001
"1458",2017-07-05 15:17:31,86582.62,2027923.61000001
"1459",2017-07-05 15:21:21,-86582.62,1941340.99000001
"15765",2017-07-05 15:30:30,195553.41,2136894.40000001
"15766",2017-07-05 15:59:23,180161.71,2317056.11000001
"15767",2017-07-05 17:46:44,302883.5,2619939.61000001
"1460",2017-07-05 19:07:17,116838.11,2736777.72000001
"15768",2017-07-05 19:07:17,155620.14,2892397.86000001
"1461",2017-07-05 19:15:14,-116838.11,2775559.75000001
"15769",2017-07-05 19:19:55,203833.34,2979393.09000001
"15770",2017-07-05 20:15:16,144667.14,3124060.23000001
"15771",2017-07-06 03:27:21,-3124060.23,6.98491930961609e-09
"1462",2017-07-06 04:14:09,91019.76,91019.760000007
"1463",2017-07-06 04:19:58,-91019.76,6.98491930961609e-09
"1464",2017-07-06 05:58:43,30275.82,30275.820000007
"1465",2017-07-06 06:07:02,-30275.82,6.98491930961609e-09
"1466",2017-07-06 06:09:10,19186.11,19186.110000007
"1467",2017-07-06 06:09:10,101170.96,120357.070000007
"1468",2017-07-06 06:25:16,19508.78,139865.850000007
"1469",2017-07-06 08:18:37,152510.95,292376.800000007
"1470",2017-07-06 08:28:02,-292376.8,7.04312697052956e-09
"15772",2017-07-06 14:16:00,185968.85,185968.850000007
"15773",2017-07-06 14:16:00,34068.18,220037.030000007
"15774",2017-07-06 15:05:09,-220037.03,7.04312697052956e-09
"1471",2017-07-06 15:12:40,19372.35,19372.350000007
"15775",2017-07-06 15:37:12,298819.49,318191.840000007
"1472",2017-07-06 15:39:20,-19372.35,298819.490000007
"15776",2017-07-06 15:56:44,-298819.49,7.04312697052956e-09
"15777",2017-07-06 23:02:15,135161.65,135161.650000007
"15778",2017-07-06 23:02:15,117974.89,253136.540000007
"15779",2017-07-06 23:28:05,-253136.54,7.01402314007282e-09
"1473",2017-07-06 23:49:03,17397.5,17397.500000007
"1474",2017-07-06 23:49:03,112005.41,129402.910000007
"15780",2017-07-06 23:49:03,91471.9,220874.810000007
"1475",2017-07-07 00:12:37,-129402.91,91471.900000007
"15781",2017-07-07 00:12:37,-91471.9,7.01402314007282e-09
"1476",2017-07-07 00:55:11,105825.17,105825.170000007
"15782",2017-07-07 00:55:11,121103.83,226929.000000007
"1477",2017-07-07 01:16:30,-105825.17,121103.830000007
"15783",2017-07-07 01:16:30,-121103.83,7.01402314007282e-09
"15784",2017-07-07 03:57:13,105662.38,105662.380000007
"15785",2017-07-07 04:03:49,-105662.38,7.01402314007282e-09
"1478",2017-07-07 04:17:14,104218.71,104218.710000007
"1479",2017-07-07 04:21:49,-104218.71,7.01402314007282e-09
"15786",2017-07-07 07:14:31,238695.27,238695.270000007
"15787",2017-07-07 07:42:13,-238695.27,7.01402314007282e-09
"1480",2017-07-07 08:05:33,91334.99,91334.990000007
"15788",2017-07-07 08:05:33,167537.05,258872.040000007
"15789",2017-07-07 08:05:33,272711.17,531583.210000007
"1481",2017-07-07 08:24:17,-91334.99,440248.220000007
"15790",2017-07-07 08:24:17,-440248.22,6.98491930961609e-09
"15791",2017-07-07 08:36:28,219496.27,219496.270000007
"15792",2017-07-07 08:41:13,-219496.27,6.98491930961609e-09
"15793",2017-07-07 08:42:40,197948.63,197948.630000007
"15794",2017-07-07 09:05:02,-197948.63,6.98491930961609e-09
"1482",2017-07-07 09:38:41,91238.87,91238.870000007
"1483",2017-07-07 10:07:09,-91238.87,6.98491930961609e-09
"15795",2017-07-07 10:07:09,203398.53,203398.530000007
"15796",2017-07-07 10:16:53,-203398.53,6.98491930961609e-09
"15797",2017-07-07 11:36:00,321040.37,321040.370000007
"1484",2017-07-07 11:56:39,96331.09,417371.460000007
"15798",2017-07-07 11:56:39,-321040.37,96331.090000007
"1485",2017-07-07 12:13:21,-96331.09,6.95581547915936e-09
"15799",2017-07-07 12:13:21,235259.52,235259.520000007
"1486",2017-07-07 12:19:58,119891.69,355151.210000007
"15800",2017-07-07 12:19:58,-235259.52,119891.690000007
"15801",2017-07-07 12:19:58,249127.88,369019.570000007
"1487",2017-07-07 12:34:41,96954.47,465974.040000007
"1488",2017-07-07 12:34:41,-119891.69,346082.350000007
"15802",2017-07-07 12:34:41,-249127.88,96954.4700000069
"15803",2017-07-07 12:34:41,292985.28,389939.750000007
"1489",2017-07-07 12:56:00,99830.22,489769.970000007
"1490",2017-07-07 12:56:00,-96954.47,392815.500000007
"15804",2017-07-07 12:56:00,-292985.28,99830.220000007
"15805",2017-07-07 12:56:00,300971.05,400801.270000007
"15806",2017-07-07 12:56:00,250420.82,651222.090000007
"15807",2017-07-07 12:56:00,285681.76,936903.850000007
"1491",2017-07-07 13:04:54,94764.02,1031667.87000001
"1492",2017-07-07 13:04:54,-99830.22,931837.650000007
"15808",2017-07-07 13:04:54,-837073.63,94764.020000007
"15809",2017-07-07 13:06:06,243769.4,338533.420000007
"1493",2017-07-07 13:15:47,-94764.02,243769.400000007
"15810",2017-07-07 13:15:47,-243769.4,7.01402314007282e-09
"1494",2017-07-07 13:24:05,120178.93,120178.930000007
"1495",2017-07-07 13:40:32,-120178.93,7.01402314007282e-09
"1496",2017-07-07 13:46:19,153709.46,153709.460000007
"15811",2017-07-07 13:46:19,302761.85,456471.310000007
"1497",2017-07-07 13:49:47,-153709.46,302761.850000007
"15812",2017-07-07 13:49:47,-302761.85,6.98491930961609e-09
"1498",2017-07-07 14:10:26,120335.69,120335.690000007
"15813",2017-07-07 14:10:26,243775.17,364110.860000007
"1499",2017-07-07 14:19:39,-120335.69,243775.170000007
"15814",2017-07-07 14:19:39,-243775.17,6.95581547915936e-09
"15815",2017-07-07 14:38:26,269606.65,269606.650000007
"15816",2017-07-07 15:14:38,-269606.65,6.98491930961609e-09
"1500",2017-07-07 15:22:06,96691.01,96691.010000007
"1501",2017-07-07 15:22:06,94551.56,191242.570000007
"15817",2017-07-07 15:22:06,249331.01,440573.580000007
"15818",2017-07-07 15:22:06,256940.68,697514.260000007
"1502",2017-07-07 15:58:20,107339.84,804854.100000007
"15819",2017-07-07 15:58:20,-506271.69,298582.410000007
"1503",2017-07-07 16:00:11,-191242.57,107339.840000007
"1504",2017-07-07 16:06:19,150073.6,257413.440000007
"1505",2017-07-07 16:06:19,95804.9,353218.340000007
"1506",2017-07-07 16:06:19,100073.59,453291.930000007
"1507",2017-07-07 16:06:19,-107339.84,345952.090000007
"15820",2017-07-07 16:06:19,181035.51,526987.600000007
"15821",2017-07-07 16:09:15,-181035.51,345952.090000007
"1508",2017-07-07 16:10:14,-345952.09,6.92671164870262e-09
"1509",2017-07-07 16:15:54,93224.32,93224.3200000069
"1510",2017-07-07 16:19:59,-93224.32,6.92671164870262e-09
"1511",2017-07-07 19:19:24,158227.45,158227.450000007
"15822",2017-07-07 19:19:24,183892.06,342119.510000007
"1512",2017-07-07 19:23:44,-158227.45,183892.060000007
"15823",2017-07-07 19:23:44,-183892.06,6.92671164870262e-09
"1513",2017-07-07 20:02:38,19924.75,19924.7500000069
"1514",2017-07-07 20:04:45,-19924.75,6.92671164870262e-09
"15824",2017-07-07 20:04:45,231913.16,231913.160000007
"15825",2017-07-07 20:19:30,-231913.16,6.92671164870262e-09
"1515",2017-07-07 20:51:21,96378.96,96378.9600000069
"1516",2017-07-07 20:51:21,145732.91,242111.870000007
"1517",2017-07-07 20:55:36,-242111.87,6.92671164870262e-09
"15826",2017-07-07 21:16:27,215612.94,215612.940000007
"15827",2017-07-07 21:44:19,-215612.94,6.92671164870262e-09
"1518",2017-07-07 22:16:11,93276.21,93276.2100000069
"15828",2017-07-07 22:16:11,235272.49,328548.700000007
"1519",2017-07-07 22:18:44,-93276.21,235272.490000007
"15829",2017-07-07 22:18:44,-235272.49,6.92671164870262e-09
"1520",2017-07-07 22:41:53,103095.26,103095.260000007
"1521",2017-07-07 22:51:14,-103095.26,6.92671164870262e-09
"1522",2017-07-07 23:05:35,134744.55,134744.550000007
"15830",2017-07-07 23:05:35,205252.7,339997.250000007
"15831",2017-07-07 23:05:35,181328.03,521325.280000007
"1523",2017-07-07 23:18:40,-134744.55,386580.730000007
"15832",2017-07-07 23:18:40,-386580.73,6.92671164870262e-09
"15833",2017-07-07 23:18:40,180925.87,180925.870000007
"15834",2017-07-08 00:02:45,-180925.87,6.92671164870262e-09
"15835",2017-07-08 00:30:42,221317.79,221317.790000007
"15836",2017-07-08 00:30:42,201496.86,422814.650000007
"15837",2017-07-08 00:30:42,173104.1,595918.750000007
"15838",2017-07-08 00:30:42,251576.58,847495.330000007
"15840",2017-07-08 00:38:42,186505.29,1034000.62000001
"15839",2017-07-08 00:38:49,-847495.33,186505.290000007
"15841",2017-07-08 00:55:38,-186505.29,6.89760781824589e-09
"15842",2017-07-08 00:55:38,210791.55,210791.550000007
"15843",2017-07-08 01:03:02,-210791.55,6.89760781824589e-09
"1524",2017-07-08 01:06:43,210022.45,210022.450000007
"1525",2017-07-08 01:20:06,-210022.45,6.89760781824589e-09
"15844",2017-07-08 01:39:35,306711.94,306711.940000007
"1526",2017-07-08 01:54:46,96818.28,403530.220000007
"15845",2017-07-08 01:54:46,-306711.94,96818.280000007
"15846",2017-07-08 01:54:46,231947.68,328765.960000007
"1527",2017-07-08 02:02:05,-96818.28,231947.680000007
"15847",2017-07-08 02:02:05,-231947.68,6.95581547915936e-09
"15848",2017-07-08 02:08:26,231292.59,231292.590000007
"1528",2017-07-08 02:22:51,93729.4,325021.990000007
"15849",2017-07-08 02:22:51,-231292.59,93729.400000007
"15850",2017-07-08 02:22:51,196953.99,290683.390000007
"1529",2017-07-08 02:44:36,-93729.4,196953.990000007
"15851",2017-07-08 02:44:36,-196953.99,7.01402314007282e-09
"15852",2017-07-08 02:44:36,220660.57,220660.570000007
"15853",2017-07-08 02:44:36,214150.86,434811.430000007
"15854",2017-07-08 02:51:32,-434811.43,7.04312697052956e-09
"15855",2017-07-08 02:51:32,221619.7,221619.700000007
"15856",2017-07-08 02:58:07,-221619.7,7.04312697052956e-09
"15857",2017-07-08 02:58:07,187962.47,187962.470000007
"15858",2017-07-08 03:03:53,-187962.47,7.04312697052956e-09
"15859",2017-07-08 03:26:21,168226.44,168226.440000007
"15860",2017-07-08 03:33:02,-168226.44,7.04312697052956e-09
"1530",2017-07-08 06:32:53,103969.58,103969.580000007
"1531",2017-07-08 06:35:01,-103969.58,7.04312697052956e-09
"15861",2017-07-08 06:40:21,106027.29,106027.290000007
"15862",2017-07-08 06:44:46,-106027.29,7.04312697052956e-09
"15863",2017-07-08 06:44:46,145521.51,145521.510000007
"15864",2017-07-08 06:53:06,-145521.51,7.04312697052956e-09
"1532",2017-07-08 07:42:16,18209.03,18209.030000007
"1533",2017-07-08 07:46:11,-18209.03,7.04312697052956e-09
"1534",2017-07-08 09:58:42,91577,91577.000000007
"1535",2017-07-08 10:22:15,-91577,7.04312697052956e-09
"15865",2017-07-08 18:58:02,126339.18,126339.180000007
"15866",2017-07-08 19:09:37,-126339.18,7.04312697052956e-09
"15867",2017-07-09 05:11:24,17897.65,17897.650000007
"15868",2017-07-09 05:29:35,-17897.65,7.04312697052956e-09
"15869",2017-07-09 05:29:35,105144.14,105144.140000007
"15870",2017-07-09 05:32:54,-105144.14,7.04312697052956e-09
"15871",2017-07-09 06:10:02,162646.61,162646.610000007
"15872",2017-07-09 06:21:01,-162646.61,7.04312697052956e-09
"15873",2017-07-09 06:28:04,190560.83,190560.830000007
"15874",2017-07-09 06:49:25,-190560.83,7.04312697052956e-09
"15875",2017-07-09 07:00:17,173845.72,173845.720000007
"15876",2017-07-09 07:15:37,-173845.72,7.04312697052956e-09
"15877",2017-07-09 09:13:09,186744.44,186744.440000007
"15878",2017-07-09 09:19:45,-186744.44,7.04312697052956e-09
"15879",2017-07-09 09:58:18,162078.96,162078.960000007
"15880",2017-07-09 10:16:29,-162078.96,7.04312697052956e-09
"1536",2017-07-09 10:51:04,90242.93,90242.930000007
"1537",2017-07-09 11:21:09,-90242.93,7.04312697052956e-09
"15881",2017-07-09 11:45:23,123488.71,123488.710000007
"15882",2017-07-09 11:48:40,-123488.71,7.04312697052956e-09
"15883",2017-07-09 11:53:26,22213.57,22213.570000007
"15884",2017-07-09 12:17:32,-22213.57,7.04312697052956e-09
"1538",2017-07-09 13:45:45,94545.81,94545.810000007
"1539",2017-07-09 14:03:30,-94545.81,7.04312697052956e-09
"1540",2017-07-09 14:17:39,133419.78,133419.780000007
"1541",2017-07-09 14:35:26,-133419.78,7.04312697052956e-09
"15885",2017-07-09 15:09:41,196692.11,196692.110000007
"15886",2017-07-09 15:17:24,-196692.11,7.04312697052956e-09
"15887",2017-07-09 15:55:21,235174.25,235174.250000007
"15888",2017-07-09 16:01:29,-235174.25,7.04312697052956e-09
"1542",2017-07-09 17:13:25,101868.92,101868.920000007
"15889",2017-07-09 17:13:25,192476.95,294345.870000007
"1543",2017-07-09 17:43:09,91702.03,386047.900000007
"15890",2017-07-09 17:43:09,-192476.95,193570.950000007
"1544",2017-07-09 18:47:27,100842.15,294413.100000007
"15891",2017-07-09 18:47:27,254512.38,548925.480000007
"1545",2017-07-09 19:04:22,106401.67,655327.150000007
"1546",2017-07-09 19:04:22,-101868.92,553458.230000007
"15892",2017-07-09 19:04:22,-254512.38,298945.850000007
"1547",2017-07-09 19:07:34,-298945.85,6.98491930961609e-09
"1548",2017-07-09 20:32:24,107708.23,107708.230000007
"1549",2017-07-09 21:03:12,-107708.23,6.98491930961609e-09
"15893",2017-07-09 21:03:12,262820.54,262820.540000007
"15894",2017-07-09 21:09:16,-262820.54,6.98491930961609e-09
"15895",2017-07-09 21:49:13,252127.05,252127.050000007
"15896",2017-07-09 21:55:52,-252127.05,6.98491930961609e-09
"15897",2017-07-09 22:51:52,266959.38,266959.380000007
"15898",2017-07-09 22:58:48,-266959.38,6.98491930961609e-09
"1550",2017-07-09 23:34:51,93034.85,93034.850000007
"1551",2017-07-09 23:38:25,-93034.85,6.98491930961609e-09
"1552",2017-07-09 23:56:36,17554.73,17554.730000007
"1553",2017-07-10 00:06:19,137851.76,155406.490000007
"1554",2017-07-10 00:06:19,-17554.73,137851.760000007
"15899",2017-07-10 00:06:19,302019.14,439870.900000007
"15900",2017-07-10 00:06:19,267768.32,707639.220000007
"1555",2017-07-10 00:11:28,-137851.76,569787.460000007
"15901",2017-07-10 00:11:28,-569787.46,6.98491930961609e-09
"15902",2017-07-10 00:43:01,288594.8,288594.800000007
"15903",2017-07-10 00:51:22,-288594.8,6.98491930961609e-09
"15904",2017-07-10 01:01:38,299082.07,299082.070000007
"15905",2017-07-10 01:06:52,-299082.07,6.98491930961609e-09
"1556",2017-07-10 01:20:13,90559.42,90559.420000007
"15906",2017-07-10 01:20:13,244645.97,335205.390000007
"1557",2017-07-10 01:29:03,-90559.42,244645.970000007
"15907",2017-07-10 01:29:03,-244645.97,7.01402314007282e-09
"15908",2017-07-10 01:53:09,322630.87,322630.870000007
"15909",2017-07-10 01:56:29,-322630.87,6.98491930961609e-09
"1558",2017-07-10 02:33:26,91525.29,91525.290000007
"15910",2017-07-10 02:33:26,249808.34,341333.630000007
"1559",2017-07-10 02:38:25,-91525.29,249808.340000007
"15911",2017-07-10 02:38:25,-249808.34,7.01402314007282e-09
"15912",2017-07-10 04:38:51,335784.36,335784.360000007
"15913",2017-07-10 05:02:16,278959.85,614744.210000007
"1560",2017-07-10 05:53:39,106505.39,721249.600000007
"1561",2017-07-10 06:11:44,-106505.39,614744.210000007
"15914",2017-07-10 06:11:44,167919.18,782663.390000007
"15915",2017-07-10 07:45:27,242047.68,1024711.07000001
"1562",2017-07-10 11:11:36,18308.92,1043019.99000001
"1563",2017-07-10 11:17:39,-18308.92,1024711.07000001
"1564",2017-07-10 11:28:32,105774.62,1130485.69000001
"1565",2017-07-10 11:31:46,-105774.62,1024711.07000001
"1566",2017-07-10 11:51:43,97982.77,1122693.84000001
"15916",2017-07-10 11:51:43,256223.35,1378917.19000001
"1567",2017-07-10 12:09:25,135835.89,1514753.08000001
"1568",2017-07-10 12:09:25,-97982.77,1416770.31000001
"15917",2017-07-10 12:09:25,325833.28,1742603.59000001
"1569",2017-07-10 12:16:01,142319.8,1884923.39000001
"1570",2017-07-10 12:16:01,-135835.89,1749087.50000001
"1571",2017-07-10 12:31:25,-142319.8,1606767.70000001
"1572",2017-07-10 12:38:04,115719.58,1722487.28000001
"15918",2017-07-10 12:38:04,345949.92,2068437.20000001
"15919",2017-07-10 12:38:04,221558.23,2289995.43000001
"1573",2017-07-10 12:42:09,113401.85,2403397.28000001
"1574",2017-07-10 12:42:09,-115719.58,2287677.70000001
"1575",2017-07-10 12:46:25,133226.24,2420903.94000001
"1576",2017-07-10 12:46:25,-113401.85,2307502.09000001
"1577",2017-07-10 12:53:08,-133226.24,2174275.85000001
"1578",2017-07-10 14:12:32,70075.48,2244351.33000001
"1579",2017-07-10 14:20:57,-70075.48,2174275.85000001
"1580",2017-07-10 14:34:18,390557.45,2564833.30000001
"1581",2017-07-10 14:40:08,-390557.45,2174275.85000001
"1582",2017-07-10 14:44:50,117021.15,2291297.00000001
"1583",2017-07-10 14:47:30,-117021.15,2174275.85000001
"1584",2017-07-10 14:59:57,184566.8,2358842.65000001
"1585",2017-07-10 15:02:56,-184566.8,2174275.85000001
"1586",2017-07-10 15:11:40,150664.43,2324940.28000001
"1587",2017-07-10 15:11:40,146310.41,2471250.69000001
"15920",2017-07-10 15:11:40,1294439.45,3765690.14000001
"1588",2017-07-10 15:14:03,-296974.84,3468715.30000001
"1589",2017-07-10 15:32:38,94337.65,3563052.95000001
"1590",2017-07-10 15:37:31,-94337.65,3468715.30000001
"1591",2017-07-10 15:45:36,104520.24,3573235.54000001
"15921",2017-07-10 15:45:36,419903.72,3993139.26000001
"1592",2017-07-10 16:05:53,95819.71,4088958.97000001
"1593",2017-07-10 16:10:16,-104520.24,3984438.73000001
"1594",2017-07-10 16:55:38,77852.99,4062291.72000001
"15922",2017-07-10 17:24:18,50076.29,4112368.01000001
"1595",2017-07-10 17:40:29,-95819.71,4016548.30000001
"1596",2017-07-10 17:47:36,-77852.99,3938695.31000001
"1597",2017-07-10 17:52:48,330933.28,4269628.59000001
"15923",2017-07-10 17:52:48,832210.98,5101839.57000001
"1598",2017-07-10 17:58:46,-330933.28,4770906.29000001
"1599",2017-07-10 18:07:25,100076.54,4870982.83000001
"15924",2017-07-10 18:07:46,252287.82,5123270.65000001
"1600",2017-07-10 18:21:53,-100076.54,5023194.11000001
"15925",2017-07-10 18:32:00,263453.68,5286647.79000001
"15926",2017-07-10 18:54:30,256101.42,5542749.21000001
"1601",2017-07-10 19:20:04,55494.99,5598244.20000001
"1602",2017-07-10 19:20:04,124648.37,5722892.57000001
"15927",2017-07-10 19:20:04,296786.72,6019679.29000001
"1603",2017-07-10 19:35:26,153610.2,6173289.49000001
"1604",2017-07-10 19:35:26,-180143.36,5993146.13000001
"1605",2017-07-10 20:01:19,-153610.2,5839535.93000001
"15928",2017-07-10 20:01:19,270061.3,6109597.23000001
"15929",2017-07-10 20:01:19,269540.54,6379137.77000001
"15930",2017-07-10 20:15:33,465256.94,6844394.71000001
"1606",2017-07-10 20:35:01,97312.98,6941707.69000001
"1607",2017-07-10 20:35:01,95385.27,7037092.96000001
"15931",2017-07-10 20:35:01,267709.46,7304802.42000001
"1608",2017-07-10 20:39:23,-192698.25,7112104.17000001
"1609",2017-07-10 20:57:38,128930.19,7241034.36000001
"15932",2017-07-10 20:57:38,196421.56,7437455.92000001
"15933",2017-07-10 20:57:38,182025.64,7619481.56000001
"15934",2017-07-10 20:57:38,329939,7949420.56000001
"1610",2017-07-10 21:02:17,-128930.19,7820490.37000001
"1611",2017-07-10 21:42:26,107207.77,7927698.14000001
"15935",2017-07-10 21:42:26,225623.92,8153322.06000001
"15936",2017-07-10 21:42:26,292284.06,8445606.12000001
"15937",2017-07-10 21:42:26,302135.21,8747741.33000001
"1612",2017-07-10 21:43:37,-107207.77,8640533.56000001
"15938",2017-07-10 21:45:32,318880.33,8959413.89000001
"1613",2017-07-10 22:00:00,121880.54,9081294.43000001
"15939",2017-07-10 22:00:00,477937.32,9559231.75000001
"1614",2017-07-10 22:03:48,-121880.54,9437351.21000001
"1615",2017-07-10 22:03:48,145856.34,9583207.55000001
"1616",2017-07-10 22:07:43,-145856.34,9437351.21000001
"1617",2017-07-10 22:15:14,219005.88,9656357.09000001
"15940",2017-07-10 22:15:14,309903.79,9966260.88000001
"1618",2017-07-10 22:17:41,-219005.88,9747255.00000001
"1619",2017-07-10 22:42:53,163959.12,9911214.12000001
"15941",2017-07-10 22:42:53,155457.25,10066671.37
"15942",2017-07-10 22:42:53,257885.13,10324556.5
"15943",2017-07-10 22:42:53,315602.67,10640159.17
"1620",2017-07-10 22:55:38,94778.71,10734937.88
"1621",2017-07-10 22:55:38,-163959.12,10570978.76
"15944",2017-07-10 22:55:38,320734.37,10891713.13
"1622",2017-07-10 23:00:30,-94778.71,10796934.42
"1623",2017-07-10 23:37:21,177854.29,10974788.71
"1624",2017-07-10 23:41:53,-177854.29,10796934.42
"1625",2017-07-11 00:07:50,351572.73,11148507.15
"15945",2017-07-11 00:07:50,866987.64,12015494.79
"1626",2017-07-11 00:11:08,-351572.73,11663922.06
"1627",2017-07-11 00:29:32,118685.73,11782607.79
"1628",2017-07-11 00:48:43,-118685.73,11663922.06
"1629",2017-07-11 01:13:28,171167.67,11835089.73
"1630",2017-07-11 01:36:26,109730.24,11944819.97
"1631",2017-07-11 01:36:26,-171167.67,11773652.3
"15946",2017-07-11 01:36:26,341983.55,12115635.85
"1632",2017-07-11 01:46:46,-109730.24,12005905.61
"1633",2017-07-11 01:53:04,147715.9,12153621.51
"1634",2017-07-11 01:58:42,-147715.9,12005905.61
"1635",2017-07-11 03:08:21,254197.38,12260102.99
"1636",2017-07-11 03:08:21,142308.09,12402411.08
"15947",2017-07-11 03:08:21,322090.32,12724501.4
"15948",2017-07-11 03:08:21,261312.44,12985813.84
"15949",2017-07-11 03:08:21,316340.31,13302154.15
"1637",2017-07-11 03:12:55,-396505.47,12905648.68
"1638",2017-07-11 03:20:07,110280.54,13015929.22
"1639",2017-07-11 03:24:28,163560.77,13179489.99
"1640",2017-07-11 03:24:28,-110280.54,13069209.45
"1641",2017-07-11 03:35:44,182039.25,13251248.7
"1642",2017-07-11 03:35:44,-163560.77,13087687.93
"15950",2017-07-11 03:35:44,261802.85,13349490.78
"1643",2017-07-11 03:42:13,-182039.25,13167451.53
"1644",2017-07-11 04:03:32,104644.29,13272095.82
"1645",2017-07-11 04:03:32,97639.09,13369734.91
"15951",2017-07-11 04:03:32,301488.52,13671223.43
"1646",2017-07-11 04:08:03,-202283.38,13468940.05
"15952",2017-07-11 04:14:39,312635.57,13781575.62
"1647",2017-07-11 04:30:07,164367.04,13945942.66
"15953",2017-07-11 04:30:07,313757.43,14259700.09
"1648",2017-07-11 04:43:57,163901.49,14423601.58
"1649",2017-07-11 04:43:57,-164367.04,14259234.54
"1650",2017-07-11 04:52:13,123019.3,14382253.84
"1651",2017-07-11 04:52:13,-163901.49,14218352.35
"15954",2017-07-11 04:52:13,335715.44,14554067.79
"1652",2017-07-11 05:00:53,-123019.3,14431048.49
"1653",2017-07-11 05:07:57,123110.74,14554159.23
"1654",2017-07-11 05:07:57,196465.29,14750624.52
"15955",2017-07-11 05:07:57,313512.03,15064136.55
"1655",2017-07-11 05:10:14,-319576.03,14744560.52
"15956",2017-07-11 05:34:16,216271.58,14960832.1
"15957",2017-07-11 05:51:19,245842.78,15206674.88
"15958",2017-07-11 06:27:07,307750.59,15514425.47
"1656",2017-07-11 07:13:26,135314.35,15649739.82
"1657",2017-07-11 07:13:26,107954.77,15757694.59
"1658",2017-07-11 07:13:26,157858.04,15915552.63
"15959",2017-07-11 07:13:26,253591.62,16169144.25
"1659",2017-07-11 07:16:47,-401127.16,15768017.09
"1660",2017-07-11 07:26:56,123593.57,15891610.66
"1661",2017-07-11 07:28:21,109905.68,16001516.34
"1662",2017-07-11 07:39:28,-123593.57,15877922.77
"1663",2017-07-11 07:47:18,152123.19,16030045.96
"1664",2017-07-11 07:47:18,-109905.68,15920140.28
"15960",2017-07-11 07:47:18,413093.57,16333233.85
"1665",2017-07-11 07:51:12,-152123.19,16181110.66
"1666",2017-07-11 08:09:54,243294.53,16424405.19
"1667",2017-07-11 08:15:47,-243294.53,16181110.66
"1668",2017-07-11 08:29:21,96924.67,16278035.33
"1669",2017-07-11 08:34:00,-96924.67,16181110.66
"1670",2017-07-11 08:38:27,110157.91,16291268.57
"1671",2017-07-11 08:42:14,-110157.91,16181110.66
"15961",2017-07-11 08:42:14,213032.01,16394142.67
"15962",2017-07-11 08:55:38,161861.35,16556004.02
"15963",2017-07-11 09:07:13,331457.13,16887461.15
"15964",2017-07-11 09:27:40,368800.39,17256261.54
"1672",2017-07-11 09:48:03,102766.71,17359028.25
"1673",2017-07-11 09:48:03,104997.51,17464025.76
"15965",2017-07-11 09:48:03,260971.11,17724996.87
"1674",2017-07-11 09:50:33,-207764.22,17517232.65
"15966",2017-07-11 12:22:19,170657.22,17687889.87
"15967",2017-07-11 12:22:41,182139.72,17870029.59
"15968",2017-07-11 12:38:26,163806.87,18033836.46
"15969",2017-07-11 12:38:26,138297.16,18172133.62
"15970",2017-07-11 12:53:58,160665.32,18332798.94
"1675",2017-07-11 13:32:46,27080.44,18359879.38
"15971",2017-07-11 13:33:22,328740.77,18688620.15
"1676",2017-07-11 13:39:17,-27080.44,18661539.71
"1677",2017-07-11 13:49:49,118868.44,18780408.15
"1678",2017-07-11 13:58:15,100523.59,18880931.74
"1679",2017-07-11 13:58:15,-118868.44,18762063.3
"1680",2017-07-11 14:03:38,-100523.59,18661539.71
"15972",2017-07-11 14:03:38,401205.4,19062745.11
"1681",2017-07-11 14:28:07,104442.23,19167187.34
"1682",2017-07-11 14:28:07,145470.05,19312657.39
"1683",2017-07-11 14:32:46,-249912.28,19062745.11
"1684",2017-07-11 14:55:44,201683.19,19264428.3
"15973",2017-07-11 14:55:44,331658.95,19596087.25
"1685",2017-07-11 15:01:01,150335.74,19746422.99
"1686",2017-07-11 15:01:01,-201683.19,19544739.8
"1687",2017-07-11 15:20:35,-150335.74,19394404.06
"1688",2017-07-11 15:21:03,247575.7,19641979.76
"1689",2017-07-11 15:25:47,-247575.7,19394404.06
"1690",2017-07-11 15:54:47,117649.89,19512053.95
"1691",2017-07-11 15:58:32,-117649.89,19394404.06
"1692",2017-07-11 16:25:10,223725.84,19618129.9
"1693",2017-07-11 16:25:10,98142.07,19716271.97
"1694",2017-07-11 16:32:06,-321867.91,19394404.06
"15974",2017-07-11 16:39:12,295898.19,19690302.25
"1695",2017-07-11 17:50:37,112685.62,19802987.87
"15975",2017-07-11 17:50:37,330299.33,20133287.2
"1696",2017-07-11 17:54:59,-112685.62,20020601.58
"15976",2017-07-11 18:05:54,377494.74,20398096.32
"1697",2017-07-11 18:30:23,111139.97,20509236.29
"1698",2017-07-11 18:42:25,97788.93,20607025.22
"1699",2017-07-11 18:42:25,-111139.97,20495885.25
"1700",2017-07-11 18:55:01,-97788.93,20398096.32
"1701",2017-07-11 19:16:38,107839.54,20505935.86
"15977",2017-07-11 19:16:38,287917.62,20793853.48
"1702",2017-07-11 19:21:59,101545.95,20895399.43
"1703",2017-07-11 19:21:59,-107839.54,20787559.89
"1704",2017-07-11 19:29:04,-101545.95,20686013.94
"1705",2017-07-11 19:51:15,18896.89,20704910.83
"1706",2017-07-11 19:51:15,117102.4,20822013.23
"15978",2017-07-11 19:51:15,326492.14,21148505.37
"1707",2017-07-11 19:51:51,-135999.29,21012506.08
"1708",2017-07-11 20:14:16,99021.32,21111527.4
"1709",2017-07-11 20:14:16,148325.41,21259852.81
"1710",2017-07-11 20:14:16,99156.46,21359009.27
"15979",2017-07-11 20:14:16,241456.7,21600465.97
"15980",2017-07-11 20:14:16,265353.14,21865819.11
"1711",2017-07-11 20:29:11,-346503.19,21519315.92
"15981",2017-07-11 20:29:11,416294.78,21935610.7
"1712",2017-07-11 20:34:44,119552.46,22055163.16
"1713",2017-07-11 20:52:09,-119552.46,21935610.7
"15982",2017-07-11 20:52:09,258034.53,22193645.23
"15983",2017-07-11 21:10:39,346435.08,22540080.31
"1714",2017-07-11 21:29:22,100529.35,22640609.66
"15984",2017-07-11 21:29:22,305908.7,22946518.36
"1715",2017-07-11 21:40:27,-100529.35,22845989.01
"1716",2017-07-11 22:20:04,131709.79,22977698.8
"15985",2017-07-11 22:20:04,291310.78,23269009.58
"15986",2017-07-11 22:20:04,266136.55,23535146.13
"1717",2017-07-11 22:28:20,98327.17,23633473.3
"1718",2017-07-11 22:28:20,-131709.79,23501763.51
"15987",2017-07-11 22:28:20,232134.97,23733898.48
"1719",2017-07-11 22:31:46,95712.12,23829610.6
"1720",2017-07-11 22:31:46,-98327.17,23731283.43
"1721",2017-07-11 22:41:00,-95712.12,23635571.31
"15988",2017-07-11 22:41:00,206125.76,23841697.07
"15989",2017-07-11 22:56:56,279530.74,24121227.81
"1722",2017-07-12 00:07:59,99357.41,24220585.22
"15990",2017-07-12 00:07:59,387964.55,24608549.77
"1723",2017-07-12 00:17:57,-99357.41,24509192.36
"1724",2017-07-12 00:23:33,156114.97,24665307.33
"1725",2017-07-12 00:42:50,-156114.97,24509192.36
"15991",2017-07-12 01:05:15,255128.14,24764320.5
"15992",2017-07-12 01:32:05,343351.4,25107671.9
"15993",2017-07-12 01:43:06,362983.93,25470655.83
"1726",2017-07-12 01:51:37,112190.07,25582845.9
"1727",2017-07-12 01:57:13,-112190.07,25470655.83
"15994",2017-07-12 02:01:56,386079.72,25856735.55
"1728",2017-07-12 02:12:05,113028.33,25969763.88
"1729",2017-07-12 02:27:28,-113028.33,25856735.55
"1730",2017-07-12 03:04:35,104579.12,25961314.67
"1731",2017-07-12 03:10:56,-104579.12,25856735.55
"15995",2017-07-12 03:10:56,368039.99,26224775.54
"1732",2017-07-12 03:40:53,155003.64,26379779.18
"1733",2017-07-12 03:46:35,-155003.64,26224775.54
"1734",2017-07-12 03:56:04,164720.13,26389495.67
"1735",2017-07-12 04:30:05,141124.14,26530619.81
"1736",2017-07-12 04:32:16,-164720.13,26365899.68
"1737",2017-07-12 05:02:16,100437.91,26466337.59
"1738",2017-07-12 05:02:16,-141124.14,26325213.45
"1739",2017-07-12 05:08:05,-100437.91,26224775.54
"1740",2017-07-12 05:13:31,103813.37,26328588.91
"1741",2017-07-12 05:19:57,-103813.37,26224775.54
"15996",2017-07-12 05:29:01,181963.12,26406738.66
"15997",2017-07-12 05:54:36,216288.76,26623027.42
"1742",2017-07-12 06:42:53,98637.09,26721664.51
"1743",2017-07-12 06:45:10,-98637.09,26623027.42
"1744",2017-07-12 06:51:51,164281.83,26787309.25
"1745",2017-07-12 06:54:26,-164281.83,26623027.42
"1746",2017-07-12 11:38:33,131266.97,26754294.39
"1747",2017-07-12 11:38:33,253131.64,27007426.03
"15998",2017-07-12 11:38:33,713371.89,27720797.92
"1748",2017-07-12 11:50:44,-384398.61,27336399.31
"1749",2017-07-12 12:50:32,141241.01,27477640.32
"1750",2017-07-12 12:57:09,-141241.01,27336399.31
"15999",2017-07-12 13:28:11,311151.94,27647551.25
"16000",2017-07-12 13:28:11,298130.58,27945681.83
"16001",2017-07-12 13:50:27,301045.48,28246727.31
"16002",2017-07-12 21:05:42,332796.64,28579523.95
"1751",2017-07-12 21:54:43,322780.4,28902304.35
"16003",2017-07-12 21:54:43,155630.27,29057934.62
"16004",2017-07-12 21:54:43,125769.45,29183704.07
"16005",2017-07-12 21:54:43,145118.64,29328822.71
"16006",2017-07-12 21:54:43,127201.93,29456024.64
"1752",2017-07-12 22:18:02,-322780.4,29133244.24
"16007",2017-07-12 22:22:35,205735.71,29338979.95
"16008",2017-07-12 22:40:33,-29338979.95,3.72529029846191e-09
"1753",2017-07-12 22:42:32,92940.15,92940.1500000037
"1754",2017-07-12 22:53:53,-92940.15,3.72529029846191e-09
"1755",2017-07-12 23:19:04,143673.31,143673.310000004
"1756",2017-07-12 23:19:04,149734.02,293407.330000004
"1757",2017-07-12 23:24:40,-293407.33,3.66708263754845e-09
"16009",2017-07-13 00:30:52,306673.92,306673.920000004
"16010",2017-07-13 00:33:51,-306673.92,3.66708263754845e-09
"1758",2017-07-13 04:34:10,111403.46,111403.460000004
"1759",2017-07-13 04:35:13,-111403.46,3.66708263754845e-09
"1760",2017-07-13 05:41:37,123528.16,123528.160000004
"16011",2017-07-13 05:41:37,387886.35,511414.510000004
"16012",2017-07-13 05:41:37,377231.86,888646.370000004
"16013",2017-07-13 05:41:37,351213.47,1239859.84
"1761",2017-07-13 05:55:18,-123528.16,1116331.68
"1762",2017-07-13 05:55:58,112763.73,1229095.41
"1763",2017-07-13 05:55:58,102650.37,1331745.78
"1764",2017-07-13 06:02:59,-215414.1,1116331.68
"1765",2017-07-13 06:19:17,118236.63,1234568.31
"16014",2017-07-13 06:19:17,326170.32,1560738.63
"1766",2017-07-13 06:25:42,-118236.63,1442502
"1767",2017-07-13 06:52:53,112013.06,1554515.06
"1768",2017-07-13 07:01:19,-112013.06,1442502
"16015",2017-07-13 07:07:43,359058.22,1801560.22
"1769",2017-07-13 07:15:36,120806.05,1922366.27
"1770",2017-07-13 07:54:47,-120806.05,1801560.22
"1771",2017-07-13 07:54:47,106399.77,1907959.99
"16016",2017-07-13 07:54:47,269430.06,2177390.05
"1772",2017-07-13 08:04:18,-106399.77,2070990.28
"16017",2017-07-13 08:07:33,439056.05,2510046.33
"1773",2017-07-13 08:35:02,157498.65,2667544.98
"1774",2017-07-13 08:35:02,127636.67,2795181.65
"1775",2017-07-13 08:37:37,-285135.32,2510046.33
"1776",2017-07-13 09:03:16,139634.84,2649681.17
"1777",2017-07-13 09:13:11,-139634.84,2510046.33
"1778",2017-07-13 09:47:15,106328.26,2616374.59
"1779",2017-07-13 09:51:57,-106328.26,2510046.33
"1780",2017-07-13 10:45:47,146946.54,2656992.87
"1781",2017-07-13 10:54:58,-146946.54,2510046.33
"1782",2017-07-13 11:13:19,140007.39,2650053.72
"1783",2017-07-13 11:19:15,-140007.39,2510046.33
"1784",2017-07-13 11:25:44,113228.46,2623274.79
"1785",2017-07-13 11:27:16,-113228.46,2510046.33
"1786",2017-07-13 11:32:38,127293.69,2637340.02
"1787",2017-07-13 11:37:05,-127293.69,2510046.33
"1788",2017-07-13 12:28:35,165841.88,2675888.21
"1789",2017-07-13 12:28:35,129323.65,2805211.86
"1790",2017-07-13 12:31:36,-295165.53,2510046.33
"16018",2017-07-13 13:38:40,277536.29,2787582.62
"1791",2017-07-13 14:38:14,119433.85,2907016.47
"16019",2017-07-13 14:38:14,301620.5,3208636.97
"1792",2017-07-13 14:43:07,-119433.85,3089203.12
"1793",2017-07-13 14:51:20,16839.79,3106042.91
"1794",2017-07-13 14:51:20,140418.84,3246461.75
"1795",2017-07-13 14:51:20,120594.9,3367056.65
"1796",2017-07-13 15:18:07,-277853.53,3089203.12
"16020",2017-07-13 15:18:07,-3089203.12,2.79396772384644e-09
"16021",2017-07-13 15:18:07,240631.92,240631.920000003
"16022",2017-07-13 15:40:20,-240631.92,2.79396772384644e-09
"16023",2017-07-13 16:20:32,100081.87,100081.870000003
"16024",2017-07-13 16:33:23,-100081.87,2.79396772384644e-09
"1797",2017-07-13 16:38:12,413171.93,413171.930000003
"1798",2017-07-13 16:50:43,-413171.93,2.79396772384644e-09
"16025",2017-07-13 16:50:43,50082.08,50082.0800000028
"16026",2017-07-13 17:09:32,-50082.08,2.79396772384644e-09
"16027",2017-07-13 17:09:32,100082.09,100082.090000003
"16028",2017-07-13 17:27:15,-100082.09,2.79396772384644e-09
"1799",2017-07-13 17:30:13,156881.07,156881.070000003
"16029",2017-07-13 17:31:57,500082.11,656963.180000003
"1800",2017-07-13 17:50:53,-156881.07,500082.110000003
"16030",2017-07-13 17:50:53,-500082.11,2.73576006293297e-09
"1801",2017-07-13 18:18:02,104569.79,104569.790000003
"1802",2017-07-13 18:18:02,104838.29,209408.080000003
"16031",2017-07-13 18:18:02,500082.12,709490.200000003
"16032",2017-07-13 18:18:02,934176.82,1643667.02
"1803",2017-07-13 18:30:14,-209408.08,1434258.94
"16033",2017-07-13 18:30:14,-1434258.94,2.79396772384644e-09
"1804",2017-07-13 18:46:52,141708.7,141708.700000003
"16034",2017-07-13 18:46:52,357871.39,499580.090000003
"1805",2017-07-13 18:56:43,-141708.7,357871.390000003
"16035",2017-07-13 18:56:43,-357871.39,2.79396772384644e-09
"1806",2017-07-13 22:10:34,200083.5,200083.500000003
"1807",2017-07-13 22:14:19,-200083.5,2.79396772384644e-09
"1808",2017-07-13 22:46:10,113987.19,113987.190000003
"1809",2017-07-13 22:46:10,182321.46,296308.650000003
"1810",2017-07-13 22:46:10,214167.04,510475.690000003
"16036",2017-07-13 22:46:10,850863.01,1361338.7
"1811",2017-07-13 22:49:58,-510475.69,850863.010000003
"16037",2017-07-13 22:49:58,-850863.01,3.0267983675003e-09
"16038",2017-07-13 23:28:14,170264.82,170264.820000003
"16039",2017-07-13 23:43:52,-170264.82,3.0267983675003e-09
"1812",2017-07-14 00:48:27,118587.68,118587.680000003
"1813",2017-07-14 00:57:15,-118587.68,3.0267983675003e-09
"16040",2017-07-14 04:34:55,449465.19,449465.190000003
"1814",2017-07-14 05:51:50,111204.11,560669.300000003
"1815",2017-07-14 06:02:28,-111204.11,449465.190000003
"16041",2017-07-14 07:05:42,433076.16,882541.350000003
"1816",2017-07-14 07:21:08,8744.67,891286.020000003
"1817",2017-07-14 07:23:29,-8744.67,882541.350000003
"1818",2017-07-14 07:35:00,134449.16,1016990.51
"1819",2017-07-14 07:43:07,-134449.16,882541.350000003
"1820",2017-07-14 09:46:39,111824.48,994365.830000003
"1821",2017-07-14 10:14:33,-111824.48,882541.350000003
"16042",2017-07-14 11:41:43,271191.18,1153732.53
"16043",2017-07-14 12:47:53,210035.72,1363768.25
"16044",2017-07-14 12:47:53,234963.21,1598731.46
"1822",2017-07-14 13:30:11,105823.31,1704554.77
"1823",2017-07-14 13:38:53,-105823.31,1598731.46
"1824",2017-07-14 14:24:59,22359.89,1621091.35
"16045",2017-07-14 14:24:59,390496.7,2011588.05
"1825",2017-07-14 14:58:38,-22359.89,1989228.16
"1826",2017-07-14 14:58:38,110224.19,2099452.35
"1827",2017-07-14 14:58:38,117770.58,2217222.93
"16046",2017-07-14 14:58:38,353048.22,2570271.15
"1828",2017-07-14 15:29:59,109561.07,2679832.22
"1829",2017-07-14 15:29:59,-227994.77,2451837.45
"1830",2017-07-14 15:33:17,-109561.07,2342276.38
"16047",2017-07-14 16:07:00,355454.08,2697730.46
"16048",2017-07-14 16:15:19,554958.73,3252689.19
"16049",2017-07-14 17:35:31,267633.28,3520322.47
"1831",2017-07-14 17:53:55,109028.39,3629350.86
"16050",2017-07-14 17:53:55,360638.32,3989989.18
"1832",2017-07-14 17:55:45,-109028.39,3880960.79
"1833",2017-07-14 18:17:43,115884.89,3996845.68
"1834",2017-07-14 18:33:49,-115884.89,3880960.79
"16051",2017-07-14 18:33:49,334421.66,4215382.45
"1835",2017-07-14 19:14:19,166817.02,4382199.47
"1836",2017-07-14 19:31:39,-166817.02,4215382.45
"16052",2017-07-14 19:38:09,422600.21,4637982.66
"1837",2017-07-14 20:38:21,111268.23,4749250.89
"1838",2017-07-14 20:45:05,-111268.23,4637982.66
"1839",2017-07-14 20:51:16,187927.43,4825910.09
"1840",2017-07-14 21:20:41,-187927.43,4637982.66
"1841",2017-07-14 22:42:10,287798.68,4925781.34
"16053",2017-07-14 22:43:50,273324,5199105.34
"1842",2017-07-14 22:52:02,-287798.68,4911306.66
"1843",2017-07-14 23:28:29,210768.32,5122074.98
"16054",2017-07-14 23:28:29,220630.27,5342705.25
"16055",2017-07-14 23:28:29,257754.64,5600459.89
"1844",2017-07-14 23:55:03,-210768.32,5389691.57
"16056",2017-07-15 04:32:52,-5389691.57,1.86264514923096e-09
"1845",2017-07-15 05:28:21,113251.58,113251.580000002
"1846",2017-07-15 05:28:21,110604.23,223855.810000002
"1847",2017-07-15 05:42:00,-223855.81,1.86264514923096e-09
"1848",2017-07-15 05:42:00,120365.11,120365.110000002
"1849",2017-07-15 05:58:17,-120365.11,1.86264514923096e-09
"1850",2017-07-15 06:57:46,106937.7,106937.700000002
"1851",2017-07-15 07:05:30,-106937.7,1.86264514923096e-09
"1852",2017-07-15 08:20:47,141945.23,141945.230000002
"1853",2017-07-15 08:33:47,-141945.23,1.86264514923096e-09
"1854",2017-07-15 09:00:52,131188.46,131188.460000002
"1855",2017-07-15 09:09:26,-131188.46,1.86264514923096e-09
"1856",2017-07-15 09:18:39,178432.94,178432.940000002
"1857",2017-07-15 10:21:08,108188.99,286621.930000002
"1858",2017-07-15 10:21:08,-178432.94,108188.990000002
"1859",2017-07-15 10:56:27,-108188.99,1.84809323400259e-09
"16057",2017-07-15 12:31:46,323802.34,323802.340000002
"16058",2017-07-15 12:36:22,-323802.34,1.86264514923096e-09
"1860",2017-07-15 13:42:30,135782.48,135782.480000002
"1861",2017-07-15 13:42:30,120535.08,256317.560000002
"16059",2017-07-15 13:42:30,356403.74,612721.300000002
"1862",2017-07-15 13:57:51,-256317.56,356403.740000002
"16060",2017-07-15 13:57:51,-356403.74,1.92085281014442e-09
"1863",2017-07-15 14:01:41,260041.11,260041.110000002
"1864",2017-07-15 14:03:13,-260041.11,1.92085281014442e-09
"16061",2017-07-15 14:24:42,205629.33,205629.330000002
"16062",2017-07-15 14:24:42,211374.65,417003.980000002
"16063",2017-07-15 14:26:58,-417003.98,1.92085281014442e-09
"16064",2017-07-15 14:26:58,244413.7,244413.700000002
"1865",2017-07-15 14:46:50,111325.1,355738.800000002
"1866",2017-07-15 14:46:50,187002.59,542741.390000002
"16065",2017-07-15 14:46:50,-244413.7,298327.690000002
"16066",2017-07-15 14:46:50,360459.76,658787.450000002
"16067",2017-07-15 14:46:50,285952.33,944739.780000002
"1867",2017-07-15 14:49:12,-298327.69,646412.090000002
"16068",2017-07-15 14:49:12,-646412.09,1.97906047105789e-09
"1868",2017-07-15 15:00:28,114577.47,114577.470000002
"1869",2017-07-15 15:06:19,-114577.47,1.97906047105789e-09
"1870",2017-07-15 16:13:01,137816.58,137816.580000002
"1871",2017-07-15 16:13:01,112207.79,250024.370000002
"1872",2017-07-15 16:13:01,141252.34,391276.710000002
"16069",2017-07-15 16:13:01,463227.8,854504.510000002
"16070",2017-07-15 16:13:01,309425.65,1163930.16
"1873",2017-07-15 16:22:13,-391276.71,772653.450000002
"1874",2017-07-15 17:38:32,109656.79,882310.240000002
"16071",2017-07-15 17:38:32,342877.59,1225187.83
"1875",2017-07-15 17:59:28,-109656.79,1115531.04
"16072",2017-07-15 20:40:41,292076.18,1407607.22
"16073",2017-07-15 20:40:41,260376.41,1667983.63
"16074",2017-07-15 21:29:51,344130.32,2012113.95
"16075",2017-07-15 21:40:08,309517.35,2321631.3
"1876",2017-07-15 22:35:46,108190.79,2429822.09
"1877",2017-07-15 22:54:30,-108190.79,2321631.3
"16076",2017-07-15 22:54:30,244643.66,2566274.96
"1878",2017-07-16 00:12:00,112586,2678860.96
"1879",2017-07-16 00:19:03,-112586,2566274.96
"16077",2017-07-16 00:56:29,300102.79,2866377.75
"1880",2017-07-16 01:43:04,115158.02,2981535.77
"1881",2017-07-16 01:53:00,-115158.02,2866377.75
"1882",2017-07-16 02:14:56,109057.6,2975435.35
"1883",2017-07-16 02:16:32,-109057.6,2866377.75
"1884",2017-07-16 07:35:46,109700.94,2976078.69
"1885",2017-07-16 07:40:17,-109700.94,2866377.75
"1886",2017-07-16 08:13:27,134084.49,3000462.24
"1887",2017-07-16 08:16:28,-134084.49,2866377.75
"1888",2017-07-16 09:00:19,166000.1,3032377.85
"1889",2017-07-16 09:12:02,-166000.1,2866377.75
"1890",2017-07-16 09:36:09,134711.01,3001088.76
"1891",2017-07-16 09:43:30,-134711.01,2866377.75
"1892",2017-07-16 10:13:10,115105,2981482.75
"1893",2017-07-16 10:23:13,-115105,2866377.75
"16078",2017-07-16 10:23:13,304736.07,3171113.82
"1894",2017-07-16 11:15:11,116681.29,3287795.11
"1895",2017-07-16 11:23:46,-116681.29,3171113.82
"1896",2017-07-16 11:38:45,114164.68,3285278.5
"1897",2017-07-16 12:11:46,121676.38,3406954.88
"1898",2017-07-16 12:11:46,120526.47,3527481.35
"1899",2017-07-16 12:11:46,-114164.68,3413316.67
"1900",2017-07-16 12:44:06,124249.7,3537566.37
"1901",2017-07-16 12:44:06,117065.46,3654631.83
"1902",2017-07-16 12:45:38,-242202.85,3412428.98
"1903",2017-07-16 12:51:35,-241315.16,3171113.82
"1904",2017-07-16 13:42:29,147798.99,3318912.81
"1905",2017-07-16 14:11:47,-147798.99,3171113.82
"1906",2017-07-16 14:58:43,288252.55,3459366.37
"1907",2017-07-16 14:58:43,155173.67,3614540.04
"16079",2017-07-16 14:58:43,365202.8,3979742.84
"1908",2017-07-16 15:20:34,137861.96,4117604.8
"1909",2017-07-16 15:20:34,-443426.22,3674178.58
"16080",2017-07-16 15:20:34,272985.49,3947164.07
"1910",2017-07-16 15:30:44,-137861.96,3809302.11
"1911",2017-07-16 16:07:10,142655.91,3951958.02
"1912",2017-07-16 16:27:31,157209.98,4109168
"1913",2017-07-16 16:27:31,-142655.91,3966512.09
"1914",2017-07-16 16:33:30,-157209.98,3809302.11
"1915",2017-07-16 16:59:11,139728.08,3949030.19
"1916",2017-07-16 17:07:49,-139728.08,3809302.11
"16081",2017-07-16 18:39:45,428231.27,4237533.38
"1917",2017-07-16 19:02:08,192794.98,4430328.36
"1918",2017-07-16 19:07:21,-192794.98,4237533.38
"1919",2017-07-16 19:26:16,128965.81,4366499.19
"1920",2017-07-16 19:39:06,119223.33,4485722.52
"1921",2017-07-16 19:39:06,-128965.81,4356756.71
"16082",2017-07-16 19:39:06,340182.43,4696939.14
"1922",2017-07-16 19:51:23,-119223.33,4577715.81
"16083",2017-07-16 20:16:17,321812.53,4899528.34
"1923",2017-07-16 20:41:12,148780.57,5048308.91
"1924",2017-07-16 20:47:15,-148780.57,4899528.34
"16084",2017-07-16 21:02:00,389765.98,5289294.32
"1925",2017-07-16 21:24:57,143282.75,5432577.07
"1926",2017-07-16 21:36:26,-143282.75,5289294.32
"1927",2017-07-16 23:03:50,138520.87,5427815.19
"1928",2017-07-16 23:15:09,111529.52,5539344.71
"1929",2017-07-16 23:15:09,-138520.87,5400823.84
"1930",2017-07-16 23:21:10,123116.35,5523940.19
"1931",2017-07-16 23:44:44,-111529.52,5412410.67
"1932",2017-07-17 00:15:48,-123116.35,5289294.32
"1933",2017-07-17 04:38:37,17683.37,5306977.69
"1934",2017-07-17 04:44:41,-17683.37,5289294.32
"16085",2017-07-17 06:55:48,277830.3,5567124.62
"16086",2017-07-17 08:14:04,220031.12,5787155.74
"16087",2017-07-17 08:58:41,188409.17,5975564.91
"16088",2017-07-17 10:17:55,387188.81,6362753.72
"1935",2017-07-17 10:40:28,142313.52,6505067.24
"1936",2017-07-17 10:40:28,139494.15,6644561.39
"16089",2017-07-17 10:40:28,490595.68,7135157.07
"16090",2017-07-17 10:40:28,286533.23,7421690.3
"1937",2017-07-17 10:52:47,-281807.67,7139882.63
"1938",2017-07-17 11:26:56,123020.13,7262902.76
"1939",2017-07-17 11:32:22,-123020.13,7139882.63
"1940",2017-07-17 12:11:04,115165.82,7255048.45
"16091",2017-07-17 12:11:04,453894.43,7708942.88
"1941",2017-07-17 12:24:36,142528.96,7851471.84
"1942",2017-07-17 12:24:36,-115165.82,7736306.02
"1943",2017-07-17 12:45:28,117963.45,7854269.47
"1944",2017-07-17 12:45:28,-142528.96,7711740.51
"1945",2017-07-17 13:10:18,-117963.45,7593777.06
"16092",2017-07-17 14:51:10,256620.05,7850397.11
"16093",2017-07-17 14:51:10,329516.39,8179913.5
"16094",2017-07-17 15:07:14,201976.69,8381890.19
"16095",2017-07-17 16:23:21,-8381890.19,-1.86264514923096e-09
"1946",2017-07-17 17:21:07,189886.91,189886.909999998
"1947",2017-07-17 17:55:00,-189886.91,-1.86264514923096e-09
"1948",2017-07-17 17:55:00,255554.14,255554.139999998
"16096",2017-07-17 17:55:00,394928.15,650482.289999998
"1949",2017-07-17 18:00:28,-255554.14,394928.149999998
"16097",2017-07-17 18:00:28,-394928.15,-1.86264514923096e-09
"1950",2017-07-17 18:07:59,290695.23,290695.229999998
"1951",2017-07-17 18:10:16,-290695.23,-1.86264514923096e-09
"1952",2017-07-17 18:23:59,159376.12,159376.119999998
"16098",2017-07-17 18:23:59,135156.07,294532.189999998
"16099",2017-07-17 18:23:59,184722.95,479255.139999998
"1953",2017-07-17 18:39:27,-159376.12,319879.019999998
"16100",2017-07-17 18:39:27,-319879.02,-1.86264514923096e-09
"16101",2017-07-17 18:39:27,215647.63,215647.629999998
"16102",2017-07-17 18:45:07,-215647.63,-1.86264514923096e-09
"1954",2017-07-17 18:47:54,179656.14,179656.139999998
"1955",2017-07-17 19:07:31,-179656.14,-1.86264514923096e-09
"16103",2017-07-17 19:07:31,169120.91,169120.909999998
"16104",2017-07-17 19:07:31,180868.63,349989.539999998
"16105",2017-07-17 19:14:03,-349989.54,-1.80443748831749e-09
"1956",2017-07-17 19:20:30,145606.79,145606.789999998
"1957",2017-07-17 19:27:08,-145606.79,-1.80443748831749e-09
"16106",2017-07-17 22:47:25,171643.2,171643.199999998
"16107",2017-07-17 23:12:50,-171643.2,-1.80443748831749e-09
"16108",2017-07-17 23:12:50,212325.94,212325.939999998
"16109",2017-07-17 23:27:20,-212325.94,-1.80443748831749e-09
"16110",2017-07-18 02:48:53,77867.12,77867.1199999982
"16111",2017-07-18 02:52:18,-77867.12,-1.80443748831749e-09
"1958",2017-07-18 03:32:04,502407.63,502407.629999998
"16112",2017-07-18 03:32:04,77004.59,579412.219999998
"16113",2017-07-18 03:32:04,777867.58,1357279.8
"16114",2017-07-18 03:32:04,777867.57,2135147.37
"1959",2017-07-18 03:43:01,-502407.63,1632739.74
"16115",2017-07-18 03:43:01,-1632739.74,-1.62981450557709e-09
"1960",2017-07-18 05:41:17,121024.11,121024.109999998
"1961",2017-07-18 05:52:46,-121024.11,-1.62981450557709e-09
"16116",2017-07-18 05:52:46,278024.35,278024.349999998
"16117",2017-07-18 06:01:02,-278024.35,-1.62981450557709e-09
"1962",2017-07-18 06:44:21,135689.22,135689.219999998
"1963",2017-07-18 06:59:49,-135689.22,-1.62981450557709e-09
"1964",2017-07-18 09:55:10,119302.99,119302.989999998
"1965",2017-07-18 10:05:40,-119302.99,-1.62981450557709e-09
"1966",2017-07-18 15:55:01,12262.68,12262.6799999984
"1967",2017-07-18 15:58:02,-12262.68,-1.62981450557709e-09
"1968",2017-07-18 16:31:09,143636.67,143636.669999998
"1969",2017-07-18 16:46:49,-143636.67,-1.62981450557709e-09
"1970",2017-07-18 17:15:40,132916.16,132916.159999998
"1971",2017-07-18 17:15:40,114379.96,247296.119999998
"1972",2017-07-18 17:15:40,149242.68,396538.799999998
"16118",2017-07-18 17:15:40,379488.77,776027.569999998
"16119",2017-07-18 17:57:36,512851.93,1288879.5
"16120",2017-07-18 17:57:36,319320.41,1608199.91
"1973",2017-07-18 18:13:15,-396538.8,1211661.11
"16121",2017-07-18 18:31:06,299881.9,1511543.01
"16122",2017-07-18 18:55:51,329845.81,1841388.82
"16123",2017-07-18 18:55:51,255715.46,2097104.28
"16124",2017-07-18 19:10:50,274806.61,2371910.89
"16125",2017-07-18 19:23:57,353130.23,2725041.12
"16126",2017-07-18 19:31:34,170162.89,2895204.01
"1974",2017-07-18 21:48:48,111189.86,3006393.87
"1975",2017-07-18 22:04:27,-111189.86,2895204.01
"1976",2017-07-18 22:04:27,130651.77,3025855.78
"1977",2017-07-18 22:09:34,-130651.77,2895204.01
"1978",2017-07-18 22:47:00,138714.62,3033918.63
"1979",2017-07-18 22:50:37,-138714.62,2895204.01
"1980",2017-07-18 23:02:25,118657.64,3013861.65
"1981",2017-07-18 23:02:25,150398.71,3164260.36
"1982",2017-07-18 23:02:25,126059.36,3290319.72
"16127",2017-07-18 23:02:25,247376.56,3537696.28
"1983",2017-07-18 23:06:08,-395115.71,3142580.57
"1984",2017-07-18 23:30:26,216557.88,3359138.45
"1985",2017-07-18 23:37:10,-216557.88,3142580.57
"16128",2017-07-18 23:37:10,184926.7,3327507.27
"16129",2017-07-18 23:50:56,407739.71,3735246.98
"16130",2017-07-18 23:50:56,193296.66,3928543.64
"16131",2017-07-18 23:55:48,411223.54,4339767.18
"1986",2017-07-18 23:59:35,130691.11,4470458.29
"1987",2017-07-19 00:01:32,-130691.11,4339767.18
"16132",2017-07-19 00:01:32,313220.95,4652988.13
"1988",2017-07-19 00:50:27,129723.03,4782711.16
"1989",2017-07-19 00:50:27,126732.67,4909443.83
"1990",2017-07-19 00:51:44,-256455.7,4652988.13
"1991",2017-07-19 01:49:58,154789.76,4807777.89
"16133",2017-07-19 01:49:58,332125.7,5139903.59
"1992",2017-07-19 01:53:44,-154789.76,4985113.83
"1993",2017-07-19 02:09:15,187399.2,5172513.03
"1994",2017-07-19 02:27:35,-187399.2,4985113.83
"16134",2017-07-19 02:50:40,305572.4,5290686.23
"16135",2017-07-19 03:22:23,272382.54,5563068.77
"16136",2017-07-19 03:47:48,247077.92,5810146.69
"16137",2017-07-19 04:02:03,329361.77,6139508.46
"1995",2017-07-19 06:13:21,155940.75,6295449.21
"1996",2017-07-19 06:18:12,-155940.75,6139508.46
"1997",2017-07-19 06:59:07,141697,6281205.46
"1998",2017-07-19 07:02:09,-141697,6139508.46
"1999",2017-07-19 09:57:24,121408.69,6260917.15
"2000",2017-07-19 09:57:24,124964.16,6385881.31
"16138",2017-07-19 09:57:24,204109.08,6589990.39
"2001",2017-07-19 10:07:38,-246372.85,6343617.54
"2002",2017-07-19 10:43:12,158975.45,6502592.99
"2003",2017-07-19 10:43:12,135202.53,6637795.52
"2004",2017-07-19 10:45:33,-294177.98,6343617.54
"2005",2017-07-19 11:43:41,127639.52,6471257.06
"2006",2017-07-19 11:45:30,-127639.52,6343617.54
"2007",2017-07-19 13:19:38,134086.28,6477703.82
"2008",2017-07-19 13:22:07,-134086.28,6343617.54
"2009",2017-07-19 13:53:21,145333.31,6488950.85
"2010",2017-07-19 13:53:21,169316.69,6658267.54
"2011",2017-07-19 13:53:21,206882,6865149.54
"16139",2017-07-19 13:53:21,391996.04,7257145.58
"16140",2017-07-19 13:53:21,278376.89,7535522.47
"2012",2017-07-19 14:10:15,-521532,7013990.47
"16141",2017-07-19 14:10:15,361256.75,7375247.22
"2013",2017-07-19 14:19:35,156675.98,7531923.2
"2014",2017-07-19 14:23:04,144259.88,7676183.08
"2015",2017-07-19 14:23:04,-156675.98,7519507.1
"2016",2017-07-19 14:34:26,-144259.88,7375247.22
"2017",2017-07-19 14:56:24,153688.37,7528935.59
"2018",2017-07-19 15:04:15,-153688.37,7375247.22
"2019",2017-07-19 15:35:46,142667.94,7517915.16
"2020",2017-07-19 15:41:46,-142667.94,7375247.22
"2021",2017-07-19 15:49:24,120058.63,7495305.85
"16142",2017-07-19 15:49:24,391167.67,7886473.52
"2022",2017-07-19 15:54:01,-120058.63,7766414.89
"2023",2017-07-19 16:05:08,128534.75,7894949.64
"2024",2017-07-19 16:08:04,-128534.75,7766414.89
"2025",2017-07-19 17:58:43,148028.86,7914443.75
"2026",2017-07-19 18:26:25,130538.12,8044981.87
"2027",2017-07-19 18:49:24,135551.68,8180533.55
"2028",2017-07-19 18:50:14,-148028.86,8032504.69
"2029",2017-07-19 19:00:31,-266089.8,7766414.89
"2030",2017-07-19 19:44:38,125562.94,7891977.83
"2031",2017-07-19 19:44:38,134695.9,8026673.73
"2032",2017-07-19 19:44:38,283509.75,8310183.48
"2033",2017-07-19 19:51:24,-543768.59,7766414.89
"2034",2017-07-19 20:04:53,228044.51,7994459.4
"16143",2017-07-19 20:04:53,407072.27,8401531.67
"2035",2017-07-19 20:10:57,9866.34,8411398.01
"2036",2017-07-19 20:10:57,224300.58,8635698.59
"2037",2017-07-19 20:10:57,-228044.51,8407654.08
"2038",2017-07-19 20:15:47,-234166.92,8173487.16
"16144",2017-07-19 20:15:47,463631.97,8637119.13
"16145",2017-07-19 20:21:10,377273.88,9014393.01
"16146",2017-07-19 20:28:06,311522.03,9325915.04
"2039",2017-07-19 20:38:10,260914.85,9586829.89
"2040",2017-07-19 20:38:10,129552.43,9716382.32
"2041",2017-07-19 20:54:56,133329.37,9849711.69
"2042",2017-07-19 20:54:56,-390467.28,9459244.41
"2043",2017-07-19 21:09:05,171481.55,9630725.96
"2044",2017-07-19 21:09:05,-133329.37,9497396.59
"16147",2017-07-19 21:09:05,356278.06,9853674.65
"2045",2017-07-19 21:23:59,-171481.55,9682193.1
"2046",2017-07-19 22:10:19,137537.13,9819730.23
"2047",2017-07-19 22:17:19,128783.83,9948514.06
"2048",2017-07-19 22:17:19,-137537.13,9810976.93
"2049",2017-07-19 22:33:59,-128783.83,9682193.1
"16148",2017-07-19 22:33:59,385471.29,10067664.39
"2050",2017-07-19 23:45:43,150990.17,10218654.56
"2051",2017-07-19 23:45:43,121498.71,10340153.27
"16149",2017-07-19 23:45:43,437218.1,10777371.37
"16150",2017-07-19 23:45:43,338583.93,11115955.3
"2052",2017-07-19 23:50:13,-272488.88,10843466.42
"2053",2017-07-20 03:01:57,377870.91,11221337.33
"2054",2017-07-20 03:05:05,-377870.91,10843466.42
"2055",2017-07-20 07:18:01,438989.44,11282455.86
"2056",2017-07-20 07:25:08,-438989.44,10843466.42
"16151",2017-07-20 07:56:40,246239.37,11089705.79
"16152",2017-07-20 08:38:31,224963.86,11314669.65
"2057",2017-07-20 12:13:37,143380.08,11458049.73
"2058",2017-07-20 12:13:37,13560.93,11471610.66
"2059",2017-07-20 12:13:37,216813.62,11688424.28
"2060",2017-07-20 12:23:59,-373754.63,11314669.65
"2061",2017-07-20 13:43:24,169911,11484580.65
"2062",2017-07-20 13:47:12,-169911,11314669.65
"16153",2017-07-20 14:00:31,271769.37,11586439.02
"16154",2017-07-20 14:00:31,281392.98,11867832
"16155",2017-07-20 18:15:34,427049.27,12294881.27
"2063",2017-07-20 18:33:04,155810.84,12450692.11
"2064",2017-07-20 18:53:33,135005.97,12585698.08
"2065",2017-07-20 18:53:33,-155810.84,12429887.24
"2066",2017-07-20 19:15:20,-135005.97,12294881.27
"2067",2017-07-20 19:20:16,189771.61,12484652.88
"2068",2017-07-20 19:30:01,-189771.61,12294881.27
"2069",2017-07-20 20:52:02,175932.09,12470813.36
"2070",2017-07-20 21:10:15,-175932.09,12294881.27
"16156",2017-07-20 22:25:10,162049.13,12456930.4
"16157",2017-07-20 23:20:49,359732.24,12816662.64
"2071",2017-07-20 23:28:20,206220.28,13022882.92
"2072",2017-07-20 23:32:09,-206220.28,12816662.64
"16158",2017-07-20 23:38:10,308766.18,13125428.82
"2073",2017-07-21 00:03:06,122850.25,13248279.07
"16159",2017-07-21 00:03:06,277136.89,13525415.96
"2074",2017-07-21 00:06:48,-122850.25,13402565.71
"2075",2017-07-21 00:18:07,157641.98,13560207.69
"2076",2017-07-21 00:31:21,-157641.98,13402565.71
"2077",2017-07-21 01:33:57,154824.02,13557389.73
"2078",2017-07-21 01:33:57,126238.4,13683628.13
"2079",2017-07-21 01:33:57,136185.41,13819813.54
"16160",2017-07-21 01:33:57,359954.69,14179768.23
"16161",2017-07-21 01:33:57,420719.02,14600487.25
"2080",2017-07-21 01:38:43,-417247.83,14183239.42
"16162",2017-07-21 02:24:37,198939.19,14382178.61
"16163",2017-07-21 05:50:09,311948.09,14694126.7
"16164",2017-07-21 06:16:45,162883.58,14857010.28
"16165",2017-07-21 06:16:45,252329,15109339.28
"2081",2017-07-21 06:52:17,184087.92,15293427.2
"16166",2017-07-21 06:52:17,-15109339.28,184087.919999998
"2082",2017-07-21 07:05:07,-184087.92,-1.94995664060116e-09
"2083",2017-07-21 07:45:09,10919.43,10919.4299999981
"2084",2017-07-21 07:50:45,-10919.43,-1.94995664060116e-09
"16167",2017-07-21 11:53:13,160705.11,160705.109999998
"16168",2017-07-21 11:53:13,58212.91,218918.019999998
"16169",2017-07-21 12:37:51,173870.14,392788.159999998
"16170",2017-07-21 12:37:51,-218918.02,173870.139999998
"16171",2017-07-21 12:51:26,-173870.14,-1.94995664060116e-09
"16172",2017-07-21 13:34:18,239272.99,239272.989999998
"16173",2017-07-21 13:45:09,-239272.99,-1.94995664060116e-09
"16174",2017-07-21 14:36:57,170313.65,170313.649999998
"16175",2017-07-21 14:47:11,-170313.65,-1.94995664060116e-09
"2085",2017-07-21 17:13:15,237346.42,237346.419999998
"2086",2017-07-21 17:23:36,-237346.42,-1.94995664060116e-09
"2087",2017-07-21 17:47:57,168596.87,168596.869999998
"2088",2017-07-21 17:52:36,-168596.87,-1.94995664060116e-09
"2089",2017-07-21 21:08:13,164074.51,164074.509999998
"2090",2017-07-21 21:12:10,-164074.51,-1.94995664060116e-09
"2091",2017-07-21 21:58:46,168698.66,168698.659999998
"2092",2017-07-21 22:03:49,-168698.66,-1.94995664060116e-09
"2093",2017-07-21 23:16:21,11560.21,11560.209999998
"2094",2017-07-21 23:16:21,152378.59,163938.799999998
"2095",2017-07-21 23:18:55,-163938.8,-1.94995664060116e-09
"16176",2017-07-22 01:40:03,186769.9,186769.899999998
"16177",2017-07-22 01:45:36,-186769.9,-1.94995664060116e-09
"16178",2017-07-22 02:42:22,293924.98,293924.979999998
"16179",2017-07-22 02:56:01,-293924.98,-1.97906047105789e-09
"2096",2017-07-22 10:41:59,216844.27,216844.269999998
"2097",2017-07-22 11:36:44,-216844.27,-1.97906047105789e-09
"2098",2017-07-22 11:36:44,175248.3,175248.299999998
"16180",2017-07-22 11:36:44,364226.12,539474.419999998
"16181",2017-07-22 11:36:44,483623.23,1023097.65
"2099",2017-07-22 11:44:04,-175248.3,847849.349999998
"16182",2017-07-22 11:44:04,-847849.35,-1.97906047105789e-09
"16183",2017-07-22 11:59:29,310084.27,310084.269999998
"16184",2017-07-22 12:06:34,-310084.27,-1.97906047105789e-09
"16185",2017-07-22 22:02:12,273990.29,273990.289999998
"16186",2017-07-22 22:35:55,345290.27,619280.559999998
"16187",2017-07-23 07:23:56,464440.15,1083720.71
"16188",2017-07-23 08:40:29,376167.24,1459887.95
"16189",2017-07-23 12:46:30,276145.9,1736033.85
"16190",2017-07-23 13:07:28,269947.14,2005980.99
"16191",2017-07-23 13:25:50,370943.12,2376924.11
"16192",2017-07-23 14:06:51,236417.29,2613341.4
"16193",2017-07-23 14:29:18,297145.25,2910486.65
"16194",2017-07-23 14:59:21,280118.8,3190605.45
"2100",2017-07-23 20:50:01,25871.11,3216476.56
"2101",2017-07-23 20:55:25,-25871.11,3190605.45
"2102",2017-07-24 01:02:19,142069.34,3332674.79
"2103",2017-07-24 01:14:29,-142069.34,3190605.45
"16195",2017-07-24 11:59:22,306877.69,3497483.14
"2104",2017-07-24 13:43:20,29266.75,3526749.89
"2105",2017-07-24 13:43:20,135241.18,3661991.07
"2106",2017-07-24 13:48:45,-164507.93,3497483.14
"2107",2017-07-24 14:08:57,149177.96,3646661.1
"2108",2017-07-24 14:12:45,-149177.96,3497483.14
"2109",2017-07-24 14:24:30,144999.24,3642482.38
"2110",2017-07-24 14:26:51,-144999.24,3497483.14
"2111",2017-07-25 06:59:50,21347.89,3518831.03
"2112",2017-07-25 06:59:50,177261.25,3696092.28
"2113",2017-07-25 07:03:34,-198609.14,3497483.14
"2114",2017-07-25 07:21:21,9488.27,3506971.41
"2115",2017-07-25 07:21:21,232597.12,3739568.53
"16196",2017-07-25 07:21:21,492944.36,4232512.89
"2116",2017-07-25 07:24:20,-242085.39,3990427.5
"2117",2017-07-25 07:34:01,149113.05,4139540.55
"2118",2017-07-25 07:41:40,-149113.05,3990427.5
"16197",2017-07-25 07:41:40,466813.72,4457241.22
"2119",2017-07-25 07:50:29,169071.87,4626313.09
"2120",2017-07-25 08:07:57,-169071.87,4457241.22
"16198",2017-07-25 08:07:57,526965.04,4984206.26
"16199",2017-07-25 08:07:57,380531.45,5364737.71
"2121",2017-07-25 08:58:20,164119.67,5528857.38
"16200",2017-07-25 08:58:20,456206.83,5985064.21
"16201",2017-07-25 08:58:20,435483.97,6420548.18
"2122",2017-07-25 09:01:22,-164119.67,6256428.51
"2123",2017-07-25 09:17:59,169533.46,6425961.97
"2124",2017-07-25 09:23:00,-169533.46,6256428.51
"2125",2017-07-25 10:14:46,187538.57,6443967.08
"2126",2017-07-25 10:28:37,219199.66,6663166.74
"2127",2017-07-25 10:28:37,-187538.57,6475628.17
"2128",2017-07-25 10:33:01,151833.65,6627461.82
"2129",2017-07-25 10:33:01,-219199.66,6408262.16
"2130",2017-07-25 11:05:56,-151833.65,6256428.51
"16202",2017-07-25 11:05:56,520255.75,6776684.26
"2131",2017-07-25 11:33:51,193326.35,6970010.61
"16203",2017-07-25 11:33:51,514470.42,7484481.03
"2132",2017-07-25 11:36:43,184607.39,7669088.42
"2133",2017-07-25 11:42:36,-193326.35,7475762.07
"16204",2017-07-25 11:44:33,748492.22,8224254.29
"2134",2017-07-25 12:00:33,133592.03,8357846.32
"2135",2017-07-25 12:00:33,-184607.39,8173238.93
"16205",2017-07-25 12:00:33,537282.39,8710521.32
"2136",2017-07-25 12:24:39,-133592.03,8576929.29
"16206",2017-07-25 12:42:58,557513.67,9134442.96
"2137",2017-07-25 12:54:03,9386.36,9143829.32
"16207",2017-07-25 12:54:03,658185.11,9802014.43
"2138",2017-07-25 13:17:49,367081.85,10169096.28
"2139",2017-07-25 13:17:49,-9386.36,10159709.92
"2140",2017-07-25 13:27:34,214761.2,10374471.12
"2141",2017-07-25 13:27:34,-367081.85,10007389.27
"16208",2017-07-25 13:31:21,390822.99,10398212.26
"2142",2017-07-25 13:41:29,-214761.2,10183451.06
"16209",2017-07-25 13:54:47,473144.74,10656595.8
"2143",2017-07-25 14:13:13,166176.24,10822772.04
"2144",2017-07-25 14:13:13,143662.48,10966434.52
"2145",2017-07-25 14:21:09,-309838.72,10656595.8
"2146",2017-07-25 16:26:00,185339.05,10841934.85
"16210",2017-07-25 16:26:00,386209.52,11228144.37
"2147",2017-07-25 16:43:21,157299.9,11385444.27
"2148",2017-07-25 16:43:21,-185339.05,11200105.22
"16211",2017-07-25 16:47:41,480125.79,11680231.01
"2149",2017-07-25 17:03:13,176957.75,11857188.76
"2150",2017-07-25 17:19:28,170101.35,12027290.11
"2151",2017-07-25 17:19:28,-334257.65,11693032.46
"2152",2017-07-25 17:34:10,-170101.35,11522931.11
"2153",2017-07-25 18:54:08,180515.56,11703446.67
"2154",2017-07-25 18:58:42,-180515.56,11522931.11
"2155",2017-07-25 19:24:10,173023.04,11695954.15
"2156",2017-07-25 19:24:10,136764.9,11832719.05
"2157",2017-07-25 19:31:31,-309787.94,11522931.11
"16212",2017-07-25 19:31:31,562085.46,12085016.57
"16213",2017-07-25 19:44:30,593484.25,12678500.82
"16214",2017-07-25 20:06:24,433947.84,13112448.66
"16215",2017-07-25 20:06:24,445569.03,13558017.69
"2158",2017-07-25 20:15:44,177878.44,13735896.13
"2159",2017-07-25 20:25:36,-177878.44,13558017.69
"16216",2017-07-25 20:25:36,482057.6,14040075.29
"16217",2017-07-25 20:39:23,368852.56,14408927.85
"2160",2017-07-25 20:58:05,17757.03,14426684.88
"2161",2017-07-25 20:58:05,142038.39,14568723.27
"16218",2017-07-25 20:58:05,538986.21,15107709.48
"16219",2017-07-25 20:58:05,378135.65,15485845.13
"2162",2017-07-25 21:12:08,135480.8,15621325.93
"2163",2017-07-25 21:12:08,-159795.42,15461530.51
"16220",2017-07-25 21:12:08,449449.64,15910980.15
"2164",2017-07-25 21:16:51,200623.49,16111603.64
"2165",2017-07-25 21:16:51,-135480.8,15976122.84
"2166",2017-07-25 21:38:09,-200623.49,15775499.35
"16221",2017-07-25 23:30:20,255803.57,16031302.92
"2167",2017-07-26 05:35:30,148872.73,16180175.65
"2168",2017-07-26 05:40:03,-148872.73,16031302.92
"16222",2017-07-26 06:18:30,411437.36,16442740.28
"2169",2017-07-26 06:31:53,152048.36,16594788.64
"2170",2017-07-26 06:43:31,-152048.36,16442740.28
"2171",2017-07-26 07:08:57,156631.2,16599371.48
"16223",2017-07-26 07:08:57,358953.55,16958325.03
"2172",2017-07-26 07:19:17,-156631.2,16801693.83
"2173",2017-07-26 08:43:19,168806.08,16970499.91
"2174",2017-07-26 08:58:32,-168806.08,16801693.83
"2175",2017-07-26 17:01:57,189073.43,16990767.26
"2176",2017-07-26 17:19:35,-189073.43,16801693.83
"2177",2017-07-26 17:51:24,222495.1,17024188.93
"16224",2017-07-26 17:51:24,345570.59,17369759.52
"2178",2017-07-26 18:21:39,-222495.1,17147264.42
"2179",2017-07-26 21:13:11,140674.48,17287938.9
"2180",2017-07-26 21:22:01,-140674.48,17147264.42
"2181",2017-07-26 23:16:41,185458.36,17332722.78
"16225",2017-07-26 23:16:41,383174.19,17715896.97
"2182",2017-07-26 23:26:41,-185458.36,17530438.61
"2183",2017-07-26 23:40:41,141776.2,17672214.81
"2184",2017-07-26 23:45:16,-141776.2,17530438.61
"16226",2017-07-27 00:20:40,390698.56,17921137.17
"2185",2017-07-27 01:02:25,141593.64,18062730.81
"16227",2017-07-27 01:02:25,235034.51,18297765.32
"2186",2017-07-27 01:05:31,-141593.64,18156171.68
"16228",2017-07-27 02:00:41,212462.06,18368633.74
"16229",2017-07-27 09:00:58,201346.54,18569980.28
"16230",2017-07-27 09:32:29,248742.8,18818723.08
"16231",2017-07-27 09:50:18,316241.72,19134964.8
"16232",2017-07-27 10:44:14,222625.41,19357590.21
"16233",2017-07-27 10:46:19,218871.65,19576461.86
"16234",2017-07-27 14:57:52,423500.09,19999961.95
"2187",2017-07-27 17:19:28,58345.93,20058307.88
"2188",2017-07-27 17:23:10,-58345.93,19999961.95
"16235",2017-07-27 21:10:52,275844.22,20275806.17
"2189",2017-07-27 22:04:43,117001.13,20392807.3
"2190",2017-07-27 22:04:43,125876.86,20518684.16
"16236",2017-07-27 22:04:43,266932.38,20785616.54
"2191",2017-07-27 22:15:43,-242877.99,20542738.55
"2192",2017-07-27 22:49:00,19297.17,20562035.72
"2193",2017-07-27 22:59:22,128838.27,20690873.99
"2194",2017-07-27 22:59:22,-19297.17,20671576.82
"2195",2017-07-27 23:03:43,-128838.27,20542738.55
"2196",2017-07-28 16:55:14,182930.43,20725668.98
"2197",2017-07-28 16:57:50,-182930.43,20542738.55
"16237",2017-07-28 17:39:10,-20542738.55,-7.45058059692383e-09
"2198",2017-07-28 19:53:51,21673.81,21673.8099999926
"2199",2017-07-28 20:17:21,-21673.81,-7.45058059692383e-09
"2200",2017-07-29 00:15:10,130352.78,130352.779999993
"2201",2017-07-29 00:30:07,-130352.78,-7.45058059692383e-09
"2202",2017-07-29 03:47:04,129149.27,129149.269999993
"2203",2017-07-29 03:55:33,-129149.27,-7.45058059692383e-09
"2204",2017-07-29 08:30:58,124014.62,124014.619999993
"2205",2017-07-29 08:51:06,-124014.62,-7.45058059692383e-09
"16238",2017-07-29 11:31:50,153579.68,153579.679999993
"16239",2017-07-29 11:38:46,-153579.68,-7.45058059692383e-09
"16240",2017-07-29 12:06:45,107247.75,107247.749999993
"16241",2017-07-29 12:06:45,212627.77,319875.519999993
"16242",2017-07-29 12:06:45,125786.44,445661.959999993
"16243",2017-07-29 12:08:43,-445661.96,-7.45058059692383e-09
"2206",2017-07-29 12:36:45,32477.41,32477.4099999925
"2207",2017-07-29 12:47:56,-32477.41,-7.45058059692383e-09
"2208",2017-07-29 12:56:55,102763.92,102763.919999993
"2209",2017-07-29 13:14:06,-102763.92,-7.45058059692383e-09
"2210",2017-07-29 17:28:34,13884.69,13884.6899999925
"16244",2017-07-29 17:28:34,263608.9,277493.589999993
"16245",2017-07-29 18:06:11,-263608.9,13884.6899999926
"2211",2017-07-29 18:18:00,137598.69,151483.379999993
"2212",2017-07-29 18:18:00,-13884.69,137598.689999993
"2213",2017-07-29 18:25:09,-137598.69,-7.45058059692383e-09
"16246",2017-07-29 18:55:36,178595.11,178595.109999993
"16247",2017-07-29 19:04:38,-178595.11,-7.45058059692383e-09
"16248",2017-07-29 19:04:38,272722.44,272722.439999993
"16249",2017-07-29 19:07:25,-272722.44,-7.45058059692383e-09
"16250",2017-07-29 19:28:54,219460.07,219460.069999993
"16251",2017-07-29 19:33:07,-219460.07,-7.45058059692383e-09
"16252",2017-07-29 20:17:13,380132.91,380132.909999993
"2214",2017-07-29 20:41:35,136042.66,516175.569999992
"2215",2017-07-29 20:53:04,-136042.66,380132.909999992
"16253",2017-07-29 23:25:06,367343.33,747476.239999993
"2216",2017-07-29 23:37:24,145894.21,893370.449999993
"16254",2017-07-29 23:37:24,412833.18,1306203.62999999
"2217",2017-07-29 23:48:40,-145894.21,1160309.41999999
"16255",2017-07-29 23:48:40,438719.66,1599029.07999999
"2218",2017-07-30 01:55:39,174208.44,1773237.51999999
"2219",2017-07-30 02:03:30,-174208.44,1599029.07999999
"2220",2017-07-30 05:17:07,18909.48,1617938.55999999
"2221",2017-07-30 05:17:07,161497.05,1779435.60999999
"2222",2017-07-30 05:42:01,-180406.53,1599029.07999999
"2223",2017-07-30 08:11:47,22309.23,1621338.30999999
"2224",2017-07-30 08:16:45,-22309.23,1599029.07999999
"2225",2017-07-30 10:44:46,122710.01,1721739.08999999
"2226",2017-07-30 11:08:12,-122710.01,1599029.07999999
"2227",2017-07-30 13:36:43,13436.22,1612465.29999999
"2228",2017-07-30 13:47:09,-13436.22,1599029.07999999
"16256",2017-07-30 17:29:18,121994.54,1721023.61999999
"2229",2017-07-30 18:06:35,100057.01,1821080.62999999
"2230",2017-07-30 19:24:50,-100057.01,1721023.61999999
"16257",2017-07-30 19:24:50,181031.55,1902055.16999999
"2231",2017-07-30 20:06:13,84828.43,1986883.59999999
"2232",2017-07-30 20:09:25,-84828.43,1902055.16999999
"2233",2017-07-30 20:18:35,17743.22,1919798.38999999
"2234",2017-07-30 20:23:04,-17743.22,1902055.16999999
"2235",2017-07-30 23:45:44,98139.59,2000194.75999999
"2236",2017-07-31 00:11:01,-98139.59,1902055.16999999
"2237",2017-07-31 04:49:43,15131.65,1917186.81999999
"2238",2017-07-31 05:16:07,-15131.65,1902055.16999999
"16258",2017-07-31 05:31:03,220801.95,2122857.11999999
"2239",2017-07-31 06:56:18,93147.16,2216004.27999999
"2240",2017-07-31 07:26:35,-93147.16,2122857.11999999
"2241",2017-07-31 18:32:32,122782.28,2245639.39999999
"2242",2017-07-31 18:37:43,-122782.28,2122857.11999999
"2243",2017-07-31 21:17:16,108974.57,2231831.68999999
"2244",2017-07-31 21:25:55,-108974.57,2122857.11999999
"2245",2017-08-01 00:27:31,97621.68,2220478.79999999
"2246",2017-08-01 00:32:09,-97621.68,2122857.11999999
"2247",2017-08-01 00:38:35,119487.68,2242344.79999999
"2248",2017-08-01 00:40:54,-119487.68,2122857.11999999
"2249",2017-08-01 00:49:33,116349.46,2239206.57999999
"2250",2017-08-01 00:58:38,-116349.46,2122857.11999999
"2251",2017-08-01 01:13:47,145967.47,2268824.58999999
"2252",2017-08-01 01:16:04,-145967.47,2122857.11999999
"16259",2017-08-01 04:29:28,221074.58,2343931.69999999
"16260",2017-08-01 04:29:28,199268.23,2543199.92999999
"16261",2017-08-01 08:17:28,352286.95,2895486.87999999
"16262",2017-08-01 10:08:40,343194.41,3238681.28999999
"16263",2017-08-01 10:16:16,339747.02,3578428.30999999
"16264",2017-08-01 12:37:28,393830.7,3972259.00999999
"16265",2017-08-01 15:04:43,91786.15,4064045.15999999
"2253",2017-08-01 18:58:57,24011.21,4088056.36999999
"2254",2017-08-01 19:00:44,-24011.21,4064045.15999999
"2255",2017-08-01 19:54:53,121549.64,4185594.79999999
"2256",2017-08-01 20:01:09,-121549.64,4064045.15999999
"2257",2017-08-01 20:24:01,187515.36,4251560.51999999
"2258",2017-08-01 20:24:01,224943.07,4476503.58999999
"2259",2017-08-01 20:26:28,-412458.43,4064045.15999999
"2260",2017-08-02 05:34:28,155464.44,4219509.59999999
"16266",2017-08-02 05:34:28,-4064045.16,155464.439999993
"2261",2017-08-02 05:40:08,-155464.44,-7.04312697052956e-09
"2262",2017-08-02 06:17:52,162766.95,162766.949999993
"2263",2017-08-02 06:19:49,154498.17,317265.119999993
"2264",2017-08-02 06:19:49,357418.31,674683.429999993
"2265",2017-08-02 06:23:37,-162766.95,511916.479999993
"2266",2017-08-02 06:29:09,-511916.48,-7.04312697052956e-09
"2267",2017-08-02 07:44:12,146573.7,146573.699999993
"2268",2017-08-02 07:57:04,-146573.7,-7.04312697052956e-09
"2269",2017-08-02 12:11:18,170861.4,170861.399999993
"2270",2017-08-02 12:24:51,-170861.4,-7.04312697052956e-09
"2271",2017-08-02 12:59:25,178693.61,178693.609999993
"2272",2017-08-02 13:06:15,-178693.61,-7.04312697052956e-09
"2273",2017-08-02 15:25:26,19340.03,19340.029999993
"2274",2017-08-02 15:32:15,-19340.03,-7.04312697052956e-09
"2275",2017-08-02 15:48:23,10147.83,10147.829999993
"2276",2017-08-02 15:51:36,-10147.83,-7.04312697052956e-09
"2277",2017-08-02 15:53:03,134567.25,134567.249999993
"2278",2017-08-02 15:59:03,-134567.25,-7.04312697052956e-09
"2279",2017-08-03 03:39:15,139818.65,139818.649999993
"2280",2017-08-03 03:39:15,9357.21,149175.859999993
"2281",2017-08-03 03:39:15,141574.68,290750.539999993
"2282",2017-08-03 03:39:15,88994.5,379745.039999993
"2283",2017-08-03 04:22:14,121592.55,501337.589999993
"2284",2017-08-03 04:46:54,-379745.04,121592.549999993
"2285",2017-08-03 04:55:16,-121592.55,-7.05767888575792e-09
"2286",2017-08-03 06:09:18,90158.15,90158.1499999929
"2287",2017-08-03 06:09:18,18753.97,108912.119999993
"2288",2017-08-03 06:23:49,-108912.12,-7.05767888575792e-09
"16267",2017-08-03 09:47:04,266267.33,266267.329999993
"16268",2017-08-03 21:09:00,376640.11,642907.439999993
"16269",2017-08-04 02:26:49,239763.24,882670.679999993
"2289",2017-08-04 12:21:57,55488.6,938159.279999993
"2290",2017-08-04 12:29:11,-55488.6,882670.679999993
"2291",2017-08-04 13:58:31,122509.19,1005179.86999999
"2292",2017-08-04 14:09:01,-122509.19,882670.679999993
"2293",2017-08-04 14:35:00,13625.79,896296.469999993
"2294",2017-08-04 14:35:00,131228.8,1027525.26999999
"2295",2017-08-04 14:42:32,-144854.59,882670.679999993
"2296",2017-08-04 14:53:28,12084.85,894755.529999993
"2297",2017-08-04 14:53:28,123425.82,1018181.34999999
"2298",2017-08-04 14:56:24,-135510.67,882670.679999993
"2299",2017-08-04 15:25:37,108059.91,990730.589999993
"2300",2017-08-04 15:28:52,-108059.91,882670.679999993
"2301",2017-08-04 16:13:23,137254.43,1019925.10999999
"2302",2017-08-04 16:18:24,-137254.43,882670.679999993
"2303",2017-08-04 17:27:43,103496.16,986166.839999993
"2304",2017-08-04 17:31:15,-103496.16,882670.679999993
"2305",2017-08-05 01:40:17,128940.71,1011611.38999999
"2306",2017-08-05 01:45:09,-128940.71,882670.679999993
"16270",2017-08-05 02:35:43,415818.42,1298489.09999999
"2307",2017-08-05 02:40:21,298952.01,1597441.10999999
"2308",2017-08-05 02:46:40,153526.06,1750967.16999999
"2309",2017-08-05 02:46:40,-298952.01,1452015.15999999
"2310",2017-08-05 02:52:36,-153526.06,1298489.09999999
"2311",2017-08-05 03:06:48,377884.12,1676373.21999999
"2312",2017-08-05 03:20:05,-377884.12,1298489.09999999
"2313",2017-08-05 04:03:47,182830.04,1481319.13999999
"16271",2017-08-05 04:03:47,432970.32,1914289.45999999
"16272",2017-08-05 04:03:47,291378.12,2205667.57999999
"16273",2017-08-05 04:03:47,155842.56,2361510.13999999
"16274",2017-08-05 04:03:47,336516.46,2698026.59999999
"16275",2017-08-05 04:03:47,235998.89,2934025.48999999
"2314",2017-08-05 04:11:56,147066.76,3081092.24999999
"2315",2017-08-05 04:11:56,149263.9,3230356.14999999
"2316",2017-08-05 04:11:56,-182830.04,3047526.10999999
"2317",2017-08-05 04:35:29,-296330.66,2751195.44999999
"16276",2017-08-05 04:35:29,462935.33,3214130.77999999
"16277",2017-08-05 04:35:29,627184.65,3841315.42999999
"2318",2017-08-05 04:38:49,300107.23,4141422.65999999
"2319",2017-08-05 04:43:25,-300107.23,3841315.42999999
"2320",2017-08-05 06:08:54,88995.31,3930310.73999999
"2321",2017-08-05 06:32:36,77884.24,4008194.97999999
"2322",2017-08-05 06:32:36,264684.18,4272879.15999999
"2323",2017-08-05 06:32:36,198992.68,4471871.83999999
"16278",2017-08-05 06:32:36,498115.34,4969987.17999999
"16279",2017-08-05 06:32:36,287456.3,5257443.47999999
"16280",2017-08-05 06:32:36,270079.06,5527522.53999999
"16281",2017-08-05 06:32:36,486539.25,6014061.78999999
"2324",2017-08-05 07:06:53,-88995.31,5925066.47999999
"2325",2017-08-05 07:13:55,-541561.1,5383505.37999999
"2326",2017-08-05 08:27:34,441254.16,5824759.53999999
"2327",2017-08-05 08:37:35,-441254.16,5383505.37999999
"16282",2017-08-05 09:11:17,366570.02,5750075.39999999
"2328",2017-08-05 09:54:46,141140.49,5891215.88999999
"2329",2017-08-05 09:59:31,-141140.49,5750075.39999999
"2330",2017-08-05 10:02:01,143566.49,5893641.88999999
"2331",2017-08-05 10:14:12,-143566.49,5750075.39999999
"2332",2017-08-05 11:56:45,153459.92,5903535.31999999
"2333",2017-08-05 12:03:05,-153459.92,5750075.39999999
"16283",2017-08-05 13:31:26,273944.03,6024019.42999999
"16284",2017-08-05 15:02:26,568101.3,6592120.72999999
"16285",2017-08-05 16:55:17,448745.1,7040865.82999999
"16286",2017-08-05 16:55:17,457641.92,7498507.74999999
"2334",2017-08-05 17:49:33,14973.36,7513481.10999999
"2335",2017-08-05 17:49:33,182096,7695577.10999999
"2336",2017-08-05 18:11:35,-197069.36,7498507.74999999
"2337",2017-08-05 18:28:04,194697.03,7693204.77999999
"2338",2017-08-05 19:23:10,-194697.03,7498507.74999999
"2339",2017-08-05 21:33:29,224329.79,7722837.53999999
"2340",2017-08-05 21:44:33,-224329.79,7498507.74999999
"2341",2017-08-06 00:17:21,36093.69,7534601.43999999
"2342",2017-08-06 00:20:12,-36093.69,7498507.74999999
"2343",2017-08-06 01:21:50,179531.81,7678039.55999999
"2344",2017-08-06 01:36:45,186831.45,7864871.00999999
"2345",2017-08-06 01:36:45,-179531.81,7685339.19999999
"16287",2017-08-06 01:36:45,591123.27,8276462.46999999
"2346",2017-08-06 01:42:47,-186831.45,8089631.01999999
"16288",2017-08-06 02:14:13,322370.8,8412001.81999999
"2347",2017-08-06 03:26:55,276063.86,8688065.67999999
"2348",2017-08-06 03:26:55,12978.58,8701044.25999999
"2349",2017-08-06 03:26:55,144462.88,8845507.13999999
"2350",2017-08-06 03:41:59,183579.9,9029087.03999999
"2351",2017-08-06 03:41:59,300107.66,9329194.69999999
"2352",2017-08-06 03:41:59,-433505.32,8895689.37999999
"2353",2017-08-06 04:02:44,426813.9,9322503.27999999
"2354",2017-08-06 04:02:44,-483687.56,8838815.71999999
"2355",2017-08-06 04:23:43,-426813.9,8412001.81999999
"2356",2017-08-06 04:51:54,263612.82,8675614.63999999
"2357",2017-08-06 05:19:24,-263612.82,8412001.81999999
"2358",2017-08-06 07:06:06,342073.4,8754075.21999999
"2359",2017-08-06 07:29:11,-342073.4,8412001.81999999
"16289",2017-08-06 08:00:09,138852.23,8550854.04999999
"16290",2017-08-06 08:18:34,12775.78,8563629.82999999
"16291",2017-08-06 08:27:21,139102.77,8702732.59999999
"16292",2017-08-06 08:27:21,424111.35,9126843.94999999
"16293",2017-08-06 09:26:09,394813.37,9521657.31999999
"16294",2017-08-06 10:34:34,344833.45,9866490.76999999
"16295",2017-08-06 18:23:46,311334.76,10177825.53
"16296",2017-08-06 19:40:49,239129.12,10416954.65
"16297",2017-08-06 19:40:49,231374.76,10648329.41
"16298",2017-08-06 19:44:27,315636.8,10963966.21
"16299",2017-08-06 20:17:13,270048.92,11234015.13
"16300",2017-08-06 20:33:02,263004.98,11497020.11
"16301",2017-08-06 21:01:10,265305.7,11762325.81
"2360",2017-08-07 02:40:14,295039.62,12057365.43
"2361",2017-08-07 02:51:05,-295039.62,11762325.81
"16302",2017-08-07 04:07:07,371104.39,12133430.2
"16303",2017-08-07 11:24:34,462268.64,12595698.84
"16304",2017-08-07 11:35:10,496162.18,13091861.02
"16305",2017-08-07 11:36:13,478820.05,13570681.07
"2362",2017-08-07 12:12:47,460331.17,14031012.24
"2363",2017-08-07 12:33:43,-460331.17,13570681.07
"16306",2017-08-07 12:33:43,402707.27,13973388.34
"2364",2017-08-07 14:40:57,255465.17,14228853.51
"2365",2017-08-07 14:50:48,-255465.17,13973388.34
"2366",2017-08-07 15:12:18,408109.37,14381497.71
"2367",2017-08-07 15:23:40,-408109.37,13973388.34
"2368",2017-08-07 23:21:11,13705.39,13987093.73
"16307",2017-08-07 23:21:11,-13973388.34,13705.3899999913
"2369",2017-08-08 01:06:05,-13705.39,-8.71659722179174e-09
"2370",2017-08-08 06:43:10,127011.73,127011.729999991
"2371",2017-08-08 06:46:38,-127011.73,-8.71659722179174e-09
"16308",2017-08-08 08:17:20,199410.61,199410.609999991
"16309",2017-08-08 08:21:44,-199410.61,-8.73114913702011e-09
"16310",2017-08-08 08:32:54,128236.53,128236.529999991
"16311",2017-08-08 08:45:42,-128236.53,-8.73114913702011e-09
"16312",2017-08-08 08:58:19,288401.54,288401.539999991
"16313",2017-08-08 09:03:23,-288401.54,-8.73114913702011e-09
"16314",2017-08-08 09:06:37,317776.79,317776.789999991
"16315",2017-08-08 09:11:17,-317776.79,-8.73114913702011e-09
"16316",2017-08-08 09:11:17,328466.34,328466.339999991
"16317",2017-08-08 09:20:51,-328466.34,-8.73114913702011e-09
"2372",2017-08-08 10:12:47,269701.81,269701.809999991
"2373",2017-08-08 10:18:39,-269701.81,-8.73114913702011e-09
"2374",2017-08-08 11:29:36,191572.12,191572.119999991
"2375",2017-08-08 11:57:36,-191572.12,-8.73114913702011e-09
"2376",2017-08-08 15:08:40,284256.51,284256.509999991
"2377",2017-08-08 15:13:04,-284256.51,-8.73114913702011e-09
"2378",2017-08-08 17:55:34,196987.58,196987.579999991
"2379",2017-08-08 18:03:03,-196987.58,-8.73114913702011e-09
"16318",2017-08-08 19:05:58,160213.74,160213.739999991
"16319",2017-08-08 19:39:33,-160213.74,-8.73114913702011e-09
"16320",2017-08-08 19:39:33,158359.27,158359.269999991
"16321",2017-08-08 19:46:03,-158359.27,-8.73114913702011e-09
"16322",2017-08-08 20:10:42,243307.31,243307.309999991
"16323",2017-08-08 20:21:41,-243307.31,-8.73114913702011e-09
"16324",2017-08-08 20:21:41,242337.69,242337.689999991
"16325",2017-08-08 20:24:50,-242337.69,-8.73114913702011e-09
"16326",2017-08-08 20:36:41,202486.67,202486.669999991
"16327",2017-08-08 20:53:53,-202486.67,-8.73114913702011e-09
"16328",2017-08-08 21:22:13,221474.64,221474.639999991
"16329",2017-08-08 21:36:51,-221474.64,-8.73114913702011e-09
"16330",2017-08-08 21:36:51,169182.02,169182.019999991
"16331",2017-08-08 21:55:37,-169182.02,-8.73114913702011e-09
"16332",2017-08-08 21:55:37,143166.85,143166.849999991
"16333",2017-08-08 22:20:12,-143166.85,-8.73114913702011e-09
"16334",2017-08-08 22:20:12,164705.24,164705.239999991
"16335",2017-08-08 22:59:29,-164705.24,-8.73114913702011e-09
"16336",2017-08-08 23:13:40,166996.57,166996.569999991
"16337",2017-08-08 23:26:18,-166996.57,-8.73114913702011e-09
"16338",2017-08-09 00:01:19,217609.18,217609.179999991
"16339",2017-08-09 00:15:31,-217609.18,-8.73114913702011e-09
"16340",2017-08-09 00:52:31,278228.14,278228.139999991
"16341",2017-08-09 01:20:16,-278228.14,-8.73114913702011e-09
"16342",2017-08-09 05:42:22,184838.33,184838.329999991
"16343",2017-08-09 06:17:49,198637.61,383475.939999991
"16344",2017-08-09 07:58:41,131791.16,515267.099999991
"16345",2017-08-09 08:07:14,117749.67,633016.769999991
"16346",2017-08-09 08:23:01,115225.56,748242.329999991
"16347",2017-08-09 08:38:40,145427.39,893669.719999991
"2380",2017-08-09 08:58:43,106075.09,999744.809999991
"2381",2017-08-09 09:49:47,281726.13,1281470.93999999
"2382",2017-08-09 09:49:47,-106075.09,1175395.84999999
"16348",2017-08-09 09:49:47,48145.58,1223541.42999999
"16349",2017-08-09 09:49:47,111521.59,1335063.01999999
"2383",2017-08-09 10:04:28,-281726.13,1053336.88999999
"16350",2017-08-09 10:24:47,260780.72,1314117.60999999
"16351",2017-08-09 10:24:47,206629.26,1520746.86999999
"2384",2017-08-09 10:45:56,334960.61,1855707.47999999
"16352",2017-08-09 10:45:56,232372.44,2088079.91999999
"2385",2017-08-09 10:55:57,184758.61,2272838.52999999
"2386",2017-08-09 10:55:57,-334960.61,1937877.91999999
"16353",2017-08-09 10:55:57,342981.42,2280859.33999999
"2387",2017-08-09 11:10:21,-184758.61,2096100.72999999
"16354",2017-08-09 11:10:21,437356,2533456.72999999
"16355",2017-08-09 11:53:48,142642.14,2676098.86999999
"16356",2017-08-09 12:06:00,180951.21,2857050.07999999
"16357",2017-08-09 12:06:00,174024.64,3031074.71999999
"2388",2017-08-09 12:50:58,375024.74,3406099.45999999
"2389",2017-08-09 13:08:34,-375024.74,3031074.71999999
"16358",2017-08-09 13:08:34,182130.55,3213205.26999999
"16359",2017-08-09 14:10:43,459546.82,3672752.08999999
"2390",2017-08-09 14:40:14,408282.46,4081034.54999999
"2391",2017-08-09 14:47:10,-408282.46,3672752.08999999
"16360",2017-08-09 14:51:31,55171.21,3727923.29999999
"2392",2017-08-09 15:17:14,322048.43,4049971.72999999
"16361",2017-08-09 15:17:14,387539.58,4437511.30999999
"16362",2017-08-09 15:17:14,263911.3,4701422.60999999
"16363",2017-08-09 15:48:42,30598.35,4732020.95999999
"16364",2017-08-09 15:48:42,156901.2,4888922.15999999
"2393",2017-08-09 15:52:07,-322048.43,4566873.72999999
"16365",2017-08-09 18:16:54,131758.53,4698632.25999999
"16366",2017-08-09 21:16:46,155316.1,4853948.35999999
"16367",2017-08-10 08:14:53,243410.52,5097358.87999999
"2394",2017-08-10 09:22:06,120793.45,5218152.32999999
"2395",2017-08-10 09:36:10,-120793.45,5097358.87999999
"2396",2017-08-11 00:38:29,96116.76,5193475.63999999
"2397",2017-08-11 00:38:29,206532.98,5400008.61999999
"16368",2017-08-11 00:38:29,-5097358.88,302649.739999991
"2398",2017-08-11 00:38:51,127687.36,430337.099999991
"2399",2017-08-11 01:52:00,412568.92,842906.019999991
"2400",2017-08-11 01:55:00,-430337.1,412568.919999991
"2401",2017-08-11 02:13:24,-412568.92,-9.02218744158745e-09
"2402",2017-08-11 04:10:50,157169.92,157169.919999991
"2403",2017-08-11 04:21:33,-157169.92,-9.02218744158745e-09
"2404",2017-08-11 05:54:13,391152.25,391152.249999991
"16369",2017-08-11 05:54:13,254319.82,645472.069999991
"16370",2017-08-11 05:54:13,266719.18,912191.249999991
"2405",2017-08-11 05:58:33,-391152.25,521038.999999991
"16371",2017-08-11 05:58:33,-521039,-9.08039510250092e-09
"2406",2017-08-11 08:06:22,163620.22,163620.219999991
"2407",2017-08-11 08:22:10,-163620.22,-9.08039510250092e-09
"2408",2017-08-11 12:30:52,188270.25,188270.249999991
"2409",2017-08-11 13:03:06,-188270.25,-9.08039510250092e-09
"2410",2017-08-11 18:10:35,332305.07,332305.069999991
"2411",2017-08-11 18:16:42,-332305.07,-9.08039510250092e-09
"2412",2017-08-11 19:24:08,192472.42,192472.419999991
"2413",2017-08-11 19:26:29,-192472.42,-9.08039510250092e-09
"2414",2017-08-11 21:52:30,259632.64,259632.639999991
"2415",2017-08-11 22:07:12,38437.09,298069.729999991
"2416",2017-08-11 22:07:12,112804.39,410874.119999991
"2417",2017-08-11 22:07:12,-259632.64,151241.479999991
"2418",2017-08-11 22:14:17,-151241.48,-9.10949893295765e-09
"2419",2017-08-11 22:17:10,191606.62,191606.619999991
"2420",2017-08-11 22:48:32,-191606.62,-9.10949893295765e-09
"2421",2017-08-11 22:48:32,340204.63,340204.629999991
"16372",2017-08-11 22:48:32,229283.9,569488.529999991
"16373",2017-08-11 23:08:56,17845.13,587333.659999991
"16374",2017-08-11 23:08:56,138793.63,726127.289999991
"16375",2017-08-11 23:08:56,256650.6,982777.889999991
"16376",2017-08-11 23:08:56,122090.75,1104868.63999999
"16377",2017-08-11 23:08:56,157764.13,1262632.76999999
"16378",2017-08-11 23:08:56,223558.24,1486191.00999999
"2422",2017-08-11 23:10:32,-340204.63,1145986.37999999
"2423",2017-08-11 23:22:18,182617.66,1328604.03999999
"2424",2017-08-11 23:25:45,-182617.66,1145986.37999999
"2425",2017-08-11 23:57:50,13961.08,1159947.45999999
"2426",2017-08-11 23:57:50,90704.99,1250652.44999999
"2427",2017-08-11 23:57:50,191574.47,1442226.91999999
"2428",2017-08-11 23:57:50,103149.44,1545376.35999999
"2429",2017-08-12 00:03:29,-399389.98,1145986.37999999
"2430",2017-08-12 00:17:15,265691.68,1411678.05999999
"2431",2017-08-12 00:25:36,-265691.68,1145986.37999999
"16379",2017-08-12 00:25:36,120883.14,1266869.51999999
"16380",2017-08-12 00:38:53,246391.93,1513261.44999999
"16381",2017-08-12 00:49:49,344702.99,1857964.43999999
"2432",2017-08-12 01:02:05,284402.87,2142367.30999999
"2433",2017-08-12 02:00:32,-284402.87,1857964.43999999
"2434",2017-08-12 05:22:16,137737.58,1995702.01999999
"2435",2017-08-12 05:22:16,101498.48,2097200.49999999
"2436",2017-08-12 05:39:21,-239236.06,1857964.43999999
"2437",2017-08-12 07:20:29,9833.07,1867797.50999999
"2438",2017-08-12 07:20:29,93550.41,1961347.91999999
"16382",2017-08-12 07:20:29,9483.88,1970831.79999999
"16383",2017-08-12 07:20:29,89208.48,2060040.27999999
"16384",2017-08-12 07:35:02,242624.71,2302664.98999999
"2439",2017-08-12 07:39:25,-103383.48,2199281.50999999
"16385",2017-08-12 08:47:24,70110.36,2269391.86999999
"2440",2017-08-12 11:01:37,135203.65,2404595.51999999
"16386",2017-08-12 11:01:37,182593.4,2587188.91999999
"2441",2017-08-12 11:06:35,-135203.65,2451985.26999999
"2442",2017-08-12 11:06:35,129014.97,2581000.23999999
"2443",2017-08-12 11:14:43,-129014.97,2451985.26999999
"2444",2017-08-12 13:12:58,100060.97,2552046.23999999
"2445",2017-08-12 13:18:37,-100060.97,2451985.26999999
"2446",2017-08-12 13:51:58,231008.55,2682993.81999999
"16387",2017-08-12 13:51:58,226797.04,2909790.85999999
"2447",2017-08-12 14:53:07,247347.79,3157138.64999999
"16388",2017-08-12 14:53:07,79975.53,3237114.17999999
"16389",2017-08-12 14:53:07,177888.08,3415002.25999999
"16390",2017-08-12 14:53:07,160016.24,3575018.49999999
"16391",2017-08-12 14:53:07,277141.58,3852160.07999999
"16392",2017-08-12 14:53:07,250758.84,4102918.91999999
"2448",2017-08-12 15:01:14,-231008.55,3871910.36999999
"2449",2017-08-12 15:14:45,202830.9,4074741.26999999
"2450",2017-08-12 15:40:14,144692.8,4219434.06999999
"2451",2017-08-12 15:40:14,-247347.79,3972086.27999999
"2452",2017-08-12 16:05:56,-347523.7,3624562.57999999
"2453",2017-08-12 16:54:50,10685.16,3635247.73999999
"2454",2017-08-12 16:54:50,127532.86,3762780.59999999
"2455",2017-08-12 16:54:50,130378.43,3893159.02999999
"2456",2017-08-12 16:54:50,160853.97,4054012.99999999
"16393",2017-08-12 16:54:50,320563.6,4374576.59999999
"2457",2017-08-12 17:12:21,-429450.42,3945126.17999999
"16394",2017-08-12 18:17:46,570601.43,4515727.60999999
"2458",2017-08-12 18:38:14,473385.74,4989113.34999999
"16395",2017-08-12 18:38:14,315133.97,5304247.31999999
"2459",2017-08-12 18:45:08,-473385.74,4830861.57999999
"16396",2017-08-12 19:00:19,235243.29,5066104.86999999
"16397",2017-08-12 19:29:18,279673.19,5345778.05999999
"2460",2017-08-12 19:38:07,100267.63,5446045.68999999
"2461",2017-08-12 19:50:21,-100267.63,5345778.05999999
"2462",2017-08-12 20:17:04,207901.9,5553679.95999999
"2463",2017-08-12 20:22:07,-207901.9,5345778.05999999
"2464",2017-08-12 20:36:19,152732.09,5498510.14999999
"2465",2017-08-12 20:36:19,159395.93,5657906.07999999
"2466",2017-08-12 20:36:19,210949.55,5868855.62999999
"2467",2017-08-12 20:52:01,390688.29,6259543.91999999
"2468",2017-08-12 20:52:01,-523077.57,5736466.34999999
"2469",2017-08-12 21:13:54,300111.3,6036577.64999999
"2470",2017-08-12 21:13:54,175150.43,6211728.07999999
"2471",2017-08-12 21:13:54,-390688.29,5821039.78999999
"16398",2017-08-12 21:13:54,250523.21,6071562.99999999
"2472",2017-08-12 21:22:56,-475261.73,5596301.26999999
"16399",2017-08-12 22:00:48,360553.27,5956854.53999999
"2473",2017-08-12 23:32:39,344297.09,6301151.62999999
"2474",2017-08-12 23:49:26,-344297.09,5956854.53999999
"2475",2017-08-13 00:12:21,149103.8,6105958.33999999
"2476",2017-08-13 00:34:36,-149103.8,5956854.53999999
"16400",2017-08-13 00:34:36,193147.6,6150002.13999999
"16401",2017-08-13 00:34:36,183197.25,6333199.38999999
"16402",2017-08-13 00:44:31,136731.94,6469931.32999999
"16403",2017-08-13 01:10:27,315936.87,6785868.19999999
"16404",2017-08-13 01:55:11,160805.52,6946673.71999999
"2477",2017-08-13 02:11:50,145235,7091908.71999999
"16405",2017-08-13 02:11:50,42069.11,7133977.82999999
"2478",2017-08-13 02:19:54,-145235,6988742.82999999
"2479",2017-08-13 02:39:42,153830.95,7142573.77999999
"2480",2017-08-13 02:39:42,189508.99,7332082.76999999
"2481",2017-08-13 02:54:37,-343339.94,6988742.82999999
"2482",2017-08-13 03:07:53,309929.94,7298672.76999999
"2483",2017-08-13 03:16:25,-309929.94,6988742.82999999
"2484",2017-08-13 04:03:25,253245.53,7241988.35999999
"2485",2017-08-13 04:07:34,-253245.53,6988742.82999999
"2486",2017-08-13 04:33:04,289212.42,7277955.24999999
"2487",2017-08-13 05:19:58,245126.38,7523081.62999999
"2488",2017-08-13 05:19:58,-289212.42,7233869.20999999
"16406",2017-08-13 05:19:58,158578.59,7392447.79999999
"2489",2017-08-13 05:30:33,-245126.38,7147321.41999999
"2490",2017-08-13 07:09:18,269823.85,7417145.26999999
"16407",2017-08-13 07:09:18,288739.74,7705885.00999999
"2491",2017-08-13 07:23:20,-269823.85,7436061.15999999
"2492",2017-08-13 08:03:00,201440.26,7637501.41999999
"2493",2017-08-13 08:13:11,-201440.26,7436061.15999999
"2494",2017-08-13 08:28:18,170330.54,7606391.69999999
"2495",2017-08-13 08:39:24,163156.04,7769547.73999999
"2496",2017-08-13 08:39:24,168977.4,7938525.13999999
"16408",2017-08-13 08:39:24,-7436061.16,502463.979999988
"16409",2017-08-13 08:39:24,472733.48,975197.459999988
"2497",2017-08-13 08:52:58,-170330.54,804866.919999988
"16410",2017-08-13 08:52:58,-472733.48,332133.439999988
"2498",2017-08-13 09:13:09,-332133.44,-1.16997398436069e-08
"16411",2017-08-13 10:19:30,171472.15,171472.149999988
"16412",2017-08-13 10:19:30,137359.42,308831.569999988
"16413",2017-08-13 10:19:30,139700.07,448531.639999988
"16414",2017-08-13 10:19:30,157360.73,605892.369999988
"16415",2017-08-13 10:25:25,-605892.37,-1.16415321826935e-08
"16416",2017-08-13 10:25:25,134170.56,134170.559999988
"16417",2017-08-13 10:39:02,-134170.56,-1.16415321826935e-08
"16418",2017-08-13 10:39:02,481977.09,481977.089999988
"16419",2017-08-13 10:39:02,249925.49,731902.579999988
"16420",2017-08-13 10:47:21,-731902.58,-1.15251168608665e-08
"16421",2017-08-13 11:28:45,329958.94,329958.939999988
"16422",2017-08-13 11:28:45,219368.53,549327.469999988
"16423",2017-08-13 11:42:37,-549327.47,-1.15251168608665e-08
"2499",2017-08-13 12:00:48,148105.48,148105.479999988
"2500",2017-08-13 12:09:28,-148105.48,-1.15251168608665e-08
"2501",2017-08-13 12:26:18,39216.94,39216.9399999885
"16424",2017-08-13 12:26:18,332329.09,371546.029999989
"2502",2017-08-13 12:34:49,-39216.94,332329.089999989
"16425",2017-08-13 12:34:49,-332329.09,-1.15251168608665e-08
"2503",2017-08-13 12:37:44,234798.19,234798.189999988
"2504",2017-08-13 12:40:07,-234798.19,-1.15251168608665e-08
"2505",2017-08-13 12:48:47,214489.48,214489.479999988
"2506",2017-08-13 12:55:45,-214489.48,-1.15251168608665e-08
"2507",2017-08-13 13:38:02,310407.12,310407.119999988
"2508",2017-08-13 13:43:28,-310407.12,-1.15251168608665e-08
"2509",2017-08-13 14:46:45,171836.48,171836.479999988
"2510",2017-08-13 15:00:07,-171836.48,-1.15251168608665e-08
"2511",2017-08-13 15:28:36,250131.13,250131.129999988
"2512",2017-08-13 15:46:38,-250131.13,-1.15251168608665e-08
"2513",2017-08-13 16:05:09,168900.16,168900.159999988
"2514",2017-08-13 16:14:02,-168900.16,-1.15251168608665e-08
"2515",2017-08-13 16:16:00,224476.86,224476.859999988
"2516",2017-08-13 16:38:29,236796.53,461273.389999988
"2517",2017-08-13 16:38:29,-224476.86,236796.529999989
"16426",2017-08-13 16:51:38,141781.34,378577.869999988
"16427",2017-08-13 16:51:38,139319.4,517897.269999988
"2518",2017-08-13 17:03:30,-236796.53,281100.739999988
"16428",2017-08-13 17:03:30,-281100.74,-1.15251168608665e-08
"2519",2017-08-13 18:20:55,269388.63,269388.629999988
"2520",2017-08-13 18:33:15,-269388.63,-1.15251168608665e-08
"2521",2017-08-13 18:48:10,323390.57,323390.569999988
"2522",2017-08-13 18:55:30,-323390.57,-1.15251168608665e-08
"16429",2017-08-13 18:55:30,132772.49,132772.489999988
"16430",2017-08-13 18:58:20,-132772.49,-1.15251168608665e-08
"16431",2017-08-13 19:03:02,203727.93,203727.929999988
"16432",2017-08-13 19:09:28,-203727.93,-1.15251168608665e-08
"2523",2017-08-13 20:15:48,172550.3,172550.299999988
"2524",2017-08-13 20:15:48,162524.49,335074.789999988
"16433",2017-08-13 20:15:48,372664.41,707739.199999988
"2525",2017-08-13 20:29:47,-335074.79,372664.409999988
"16434",2017-08-13 20:29:47,-372664.41,-1.15251168608665e-08
"2526",2017-08-13 20:58:23,178371.33,178371.329999988
"2527",2017-08-13 21:02:10,-178371.33,-1.15251168608665e-08
"2528",2017-08-13 21:37:12,488037.58,488037.579999988
"16435",2017-08-13 21:37:12,383497.41,871534.989999988
"16436",2017-08-13 21:37:12,156265.18,1027800.16999999
"2529",2017-08-13 21:41:40,-488037.58,539762.589999988
"16437",2017-08-13 21:41:40,-539762.59,-1.15251168608665e-08
"16438",2017-08-13 22:01:34,215748.82,215748.819999988
"16439",2017-08-13 22:01:34,356700.75,572449.569999988
"2530",2017-08-13 22:11:07,256436.13,828885.699999988
"16440",2017-08-13 22:11:07,-572449.57,256436.129999988
"2531",2017-08-13 22:14:57,-256436.13,-1.15251168608665e-08
"16441",2017-08-13 22:14:57,323327.14,323327.139999988
"16442",2017-08-13 22:39:35,-323327.14,-1.15251168608665e-08
"16443",2017-08-13 22:56:44,369629.89,369629.889999988
"16444",2017-08-13 23:34:23,-369629.89,-1.15251168608665e-08
"16445",2017-08-13 23:34:23,273693.82,273693.819999988
"16446",2017-08-13 23:40:58,-273693.82,-1.15251168608665e-08
"16447",2017-08-14 00:02:31,220032.65,220032.649999988
"16448",2017-08-14 00:14:50,-220032.65,-1.15251168608665e-08
"2532",2017-08-14 10:13:53,344515.34,344515.339999989
"2533",2017-08-14 10:58:11,-344515.34,-1.15251168608665e-08
"2534",2017-08-14 12:21:46,436080.23,436080.229999988
"2535",2017-08-14 13:02:48,-436080.23,-1.15251168608665e-08
"16449",2017-08-14 21:18:56,29164.51,29164.5099999885
"16450",2017-08-14 22:12:13,97555.87,126720.379999988
"16451",2017-08-14 22:56:17,122633.11,249353.489999988
"16452",2017-08-14 23:03:08,132271.72,381625.209999988
"16453",2017-08-14 23:57:04,10889.73,392514.939999988
"16454",2017-08-14 23:57:04,136454.03,528968.969999988
"16455",2017-08-14 23:57:04,95980.04,624949.009999988
"16456",2017-08-15 00:25:02,151935.34,776884.349999988
"16457",2017-08-15 00:49:19,155285.08,932169.429999988
"16458",2017-08-15 02:45:28,251863.53,1184032.95999999
"2536",2017-08-15 03:09:01,172179.49,1356212.44999999
"2537",2017-08-15 03:15:48,-172179.49,1184032.95999999
"2538",2017-08-15 04:49:13,239791.23,1423824.18999999
"2539",2017-08-15 04:56:57,123296.79,1547120.97999999
"2540",2017-08-15 04:56:57,-239791.23,1307329.74999999
"2541",2017-08-15 05:08:20,-123296.79,1184032.95999999
"2542",2017-08-15 06:34:35,173465.16,1357498.11999999
"2543",2017-08-15 06:34:35,195568.73,1553066.84999999
"2544",2017-08-15 06:46:53,178773.71,1731840.55999999
"2545",2017-08-15 06:46:53,165129.41,1896969.96999999
"2546",2017-08-15 06:46:53,-369033.89,1527936.07999999
"2547",2017-08-15 06:53:30,147255.12,1675191.19999999
"2548",2017-08-15 06:53:30,-343903.12,1331288.07999999
"2549",2017-08-15 07:03:53,133027.51,1464315.58999999
"2550",2017-08-15 07:03:53,-147255.12,1317060.46999999
"2551",2017-08-15 07:13:12,-133027.51,1184032.95999999
"2552",2017-08-15 07:53:44,84935.42,1268968.37999999
"2553",2017-08-15 08:14:42,-84935.42,1184032.95999999
"2554",2017-08-15 08:14:42,159518.04,1343550.99999999
"2555",2017-08-15 08:21:19,-159518.04,1184032.95999999
"2556",2017-08-15 08:24:18,175202.88,1359235.83999999
"2557",2017-08-15 08:41:42,-175202.88,1184032.95999999
"2558",2017-08-15 08:59:39,95504.67,1279537.62999999
"16459",2017-08-15 08:59:39,206002.29,1485539.91999999
"2559",2017-08-15 09:15:28,260784.56,1746324.47999999
"2560",2017-08-15 09:15:28,132581.19,1878905.66999999
"2561",2017-08-15 09:15:28,116705.65,1995611.31999999
"2562",2017-08-15 09:15:28,-95504.67,1900106.64999999
"2563",2017-08-15 09:24:06,-510071.4,1390035.24999999
"16460",2017-08-15 09:24:06,210625.3,1600660.54999999
"2564",2017-08-15 09:31:27,82537.75,1683198.29999999
"2565",2017-08-15 09:53:58,90563.08,1773761.37999999
"2566",2017-08-15 09:53:58,280929.09,2054690.46999999
"2567",2017-08-15 09:53:58,111814.34,2166504.80999999
"2568",2017-08-15 09:53:58,316635.62,2483140.42999999
"2569",2017-08-15 09:53:58,-82537.75,2400602.67999999
"16461",2017-08-15 09:53:58,111365.22,2511967.89999999
"2570",2017-08-15 10:04:59,-799942.13,1712025.76999999
"16462",2017-08-15 10:04:59,70403.1,1782428.86999999
"16463",2017-08-15 10:07:08,154197.64,1936626.50999999
"16464",2017-08-15 10:09:57,258487.16,2195113.66999999
"2571",2017-08-15 10:33:16,14945.09,2210058.75999999
"2572",2017-08-15 10:33:16,204654.01,2414712.76999999
"2573",2017-08-15 10:33:16,162879.01,2577591.77999999
"2574",2017-08-15 10:33:16,327063.07,2904654.84999999
"16465",2017-08-15 10:33:16,10903.25,2915558.09999999
"16466",2017-08-15 10:33:16,237922.16,3153480.25999999
"2575",2017-08-15 10:49:04,-709541.18,2443939.07999999
"2576",2017-08-15 11:42:39,220293.59,2664232.66999999
"2577",2017-08-15 11:49:02,-220293.59,2443939.07999999
"2578",2017-08-15 12:44:20,222514.19,2666453.26999999
"2579",2017-08-15 12:44:20,287331.07,2953784.33999999
"2580",2017-08-15 12:44:20,255524.59,3209308.92999999
"16467",2017-08-15 12:44:20,236741.97,3446050.89999999
"16468",2017-08-15 12:44:20,391366.3,3837417.19999999
"16469",2017-08-15 12:44:20,191542.45,4028959.64999999
"2581",2017-08-15 12:48:03,-765369.85,3263589.79999999
"2582",2017-08-15 12:56:13,269242.86,3532832.65999999
"2583",2017-08-15 13:02:56,-269242.86,3263589.79999999
"2584",2017-08-15 13:02:56,216812.23,3480402.02999999
"2585",2017-08-15 13:02:56,117478.25,3597880.27999999
"2586",2017-08-15 13:14:08,68351.5,3666231.77999999
"2587",2017-08-15 13:14:08,133176.93,3799408.70999999
"2588",2017-08-15 13:14:08,-334290.48,3465118.22999999
"16470",2017-08-15 13:14:08,50113.28,3515231.50999999
"2589",2017-08-15 13:29:14,121919.6,3637151.10999999
"2590",2017-08-15 13:29:14,-201528.43,3435622.67999999
"16471",2017-08-15 13:29:14,201128.75,3636751.42999999
"16472",2017-08-15 13:29:14,182382.7,3819134.12999999
"16473",2017-08-15 13:29:14,217381.95,4036516.07999999
"2591",2017-08-15 13:44:52,-121919.6,3914596.47999999
"2592",2017-08-15 13:44:52,211570.66,4126167.13999999
"2593",2017-08-15 13:51:06,106037.74,4232204.87999999
"2594",2017-08-15 13:51:06,126500.95,4358705.82999999
"2595",2017-08-15 14:13:19,211592.97,4570298.79999999
"2596",2017-08-15 14:13:19,71194.68,4641493.47999999
"2597",2017-08-15 14:13:19,-211570.66,4429922.81999999
"16474",2017-08-15 14:16:35,173977.65,4603900.46999999
"16475",2017-08-15 14:19:33,116844.75,4720745.21999999
"2598",2017-08-15 14:24:53,124215.58,4844960.79999999
"2599",2017-08-15 14:24:53,-515326.34,4329634.45999999
"16476",2017-08-15 14:24:53,22828.73,4352463.18999999
"2600",2017-08-15 14:41:45,-124215.58,4228247.60999999
"16477",2017-08-15 14:41:45,62273.99,4290521.59999999
"2601",2017-08-15 15:07:57,293645.6,4584167.19999999
"2602",2017-08-15 15:07:57,360947.6,4945114.79999999
"2603",2017-08-15 15:07:57,262472.98,5207587.77999999
"2604",2017-08-15 15:07:57,162486.05,5370073.82999999
"16478",2017-08-15 15:07:57,383104.09,5753177.91999999
"16479",2017-08-15 15:07:57,285635.92,6038813.83999999
"16480",2017-08-15 15:07:57,116593.26,6155407.09999999
"16481",2017-08-15 15:07:57,267180.09,6422587.18999999
"2605",2017-08-15 15:23:52,362528.93,6785116.11999999
"2606",2017-08-15 15:23:52,-1079552.23,5705563.88999999
"16482",2017-08-15 15:23:52,255194.26,5960758.14999999
"2607",2017-08-15 15:39:09,-362528.93,5598229.21999999
"2608",2017-08-15 16:12:53,15090.4,5613319.61999999
"2609",2017-08-15 16:12:53,275530.88,5888850.49999999
"16483",2017-08-15 16:12:53,208505.13,6097355.62999999
"2610",2017-08-15 16:22:57,-290621.28,5806734.34999999
"2611",2017-08-15 16:42:33,177439.65,5984173.99999999
"2612",2017-08-15 16:58:27,-177439.65,5806734.34999999
"2613",2017-08-15 16:58:27,94495.02,5901229.36999999
"2614",2017-08-15 16:58:27,88700.92,5989930.28999999
"2615",2017-08-15 17:11:47,96785.19,6086715.47999999
"2616",2017-08-15 17:11:47,-183195.94,5903519.53999999
"2617",2017-08-15 17:47:40,262993.44,6166512.97999999
"2618",2017-08-15 17:55:56,-96785.19,6069727.78999999
"16484",2017-08-15 17:55:56,231579.49,6301307.27999999
"2619",2017-08-15 18:12:50,202947.06,6504254.33999999
"2620",2017-08-15 18:12:50,-262993.44,6241260.89999999
"16485",2017-08-15 18:12:50,200810.25,6442071.14999999
"2621",2017-08-15 18:17:20,-202947.06,6239124.08999999
"2622",2017-08-15 18:33:32,12019.38,6251143.46999999
"2623",2017-08-15 18:51:48,-12019.38,6239124.08999999
"16486",2017-08-15 18:58:51,184610.37,6423734.45999999
"16487",2017-08-15 19:33:21,112340.09,6536074.54999999
"16488",2017-08-15 20:04:04,152487.66,6688562.20999999
"2624",2017-08-15 20:33:02,230485.61,6919047.81999999
"16489",2017-08-15 20:33:02,273563.75,7192611.56999999
"2625",2017-08-15 20:36:56,163408.9,7356020.46999999
"2626",2017-08-15 20:41:01,-230485.61,7125534.85999999
"2627",2017-08-15 21:00:30,-163408.9,6962125.95999999
"16490",2017-08-15 21:00:30,121704.78,7083830.73999999
"16491",2017-08-15 21:00:30,119342.34,7203173.07999999
"16492",2017-08-15 21:40:17,122041.53,7325214.60999999
"16493",2017-08-15 21:40:17,198753.07,7523967.67999999
"16494",2017-08-15 21:40:17,116590.88,7640558.55999999
"16495",2017-08-15 21:47:42,130726.64,7771285.19999999
"16496",2017-08-15 21:59:56,140298.46,7911583.65999999
"16497",2017-08-15 21:59:56,116429.14,8028012.79999999
"2628",2017-08-15 23:24:36,126516.51,8154529.30999999
"16498",2017-08-15 23:24:36,257690.14,8412219.44999999
"2629",2017-08-15 23:40:11,104411.07,8516630.51999999
"2630",2017-08-15 23:40:11,-126516.51,8390114.00999999
"2631",2017-08-15 23:47:43,-104411.07,8285702.93999999
"16499",2017-08-16 00:28:12,147617.52,8433320.45999999
"16500",2017-08-16 00:28:12,136384.97,8569705.42999999
"16501",2017-08-16 00:42:00,126593.26,8696298.68999999
"2632",2017-08-16 01:49:33,105247.32,8801546.00999999
"2633",2017-08-16 01:58:05,-105247.32,8696298.68999999
"2634",2017-08-16 03:33:05,140221.05,8836519.73999999
"2635",2017-08-16 03:40:50,-140221.05,8696298.68999999
"16502",2017-08-16 04:56:40,248060.55,8944359.23999999
"2636",2017-08-16 06:35:13,221019.11,9165378.34999999
"2637",2017-08-16 06:35:13,88515.62,9253893.96999999
"2638",2017-08-16 06:53:20,156048.21,9409942.17999999
"2639",2017-08-16 07:15:39,-309534.73,9100407.44999999
"16503",2017-08-16 07:15:39,252353.92,9352761.36999999
"2640",2017-08-16 08:15:22,196825.82,9549587.18999999
"16504",2017-08-16 08:15:22,222236.53,9771823.71999999
"16505",2017-08-16 08:15:22,228788.31,10000612.03
"16506",2017-08-16 08:15:22,116093.74,10116705.77
"16507",2017-08-16 08:15:22,187947.92,10304653.69
"2641",2017-08-16 08:18:23,-156048.21,10148605.48
"16508",2017-08-16 08:52:54,144224.17,10292829.65
"2642",2017-08-16 09:30:56,-196825.82,10096003.83
"2643",2017-08-16 09:30:56,306847.89,10402851.72
"2644",2017-08-16 09:30:56,263470.66,10666322.38
"16509",2017-08-16 09:30:56,104649.2,10770971.58
"16510",2017-08-16 09:30:56,204862.38,10975833.96
"16511",2017-08-16 09:30:56,236995.93,11212829.89
"16512",2017-08-16 09:30:56,127767.9,11340597.79
"2645",2017-08-16 09:52:22,-570318.55,10770279.24
"16513",2017-08-16 09:59:19,216897.53,10987176.77
"16514",2017-08-16 11:01:19,184736.93,11171913.7
"2646",2017-08-16 15:38:09,250146.89,11422060.59
"16515",2017-08-16 15:38:09,183731.68,11605792.27
"2647",2017-08-16 15:41:12,-250146.89,11355645.38
"16516",2017-08-16 15:50:03,298766.65,11654412.03
"16517",2017-08-16 16:03:08,170199.7,11824611.73
"16518",2017-08-16 16:12:10,113384.75,11937996.48
"16519",2017-08-16 16:24:15,167118.47,12105114.95
"2648",2017-08-16 17:24:47,147738.99,12252853.94
"2649",2017-08-16 17:24:47,154378.56,12407232.5
"2650",2017-08-16 17:24:47,315445.92,12722678.42
"2651",2017-08-16 17:24:47,134015.59,12856694.01
"16520",2017-08-16 17:24:47,284573.74,13141267.75
"2652",2017-08-16 17:58:12,-751579.06,12389688.69
"2653",2017-08-16 18:24:42,150499.86,12540188.55
"2654",2017-08-16 18:50:47,-150499.86,12389688.69
"2655",2017-08-16 18:50:47,155412.61,12545101.3
"2656",2017-08-16 18:50:47,138421,12683522.3
"2657",2017-08-16 18:50:47,149209.56,12832731.86
"2658",2017-08-16 18:50:47,117616.59,12950348.45
"16521",2017-08-16 18:50:47,233835.55,13184184
"2659",2017-08-16 19:07:47,-560659.76,12623524.24
"2660",2017-08-16 19:07:47,130488.73,12754012.97
"2661",2017-08-16 19:07:47,198613.1,12952626.07
"2662",2017-08-16 19:30:34,-329101.83,12623524.24
"16522",2017-08-16 20:08:57,140521.52,12764045.76
"16523",2017-08-16 21:09:56,141344.64,12905390.4
"16524",2017-08-16 21:28:00,173657.18,13079047.58
"16525",2017-08-16 23:30:55,195241.58,13274289.16
"16526",2017-08-16 23:34:29,126427.85,13400717.01
"16527",2017-08-16 23:46:02,15230.04,13415947.05
"16528",2017-08-16 23:46:02,330991.18,13746938.23
"16529",2017-08-17 00:27:32,500371.13,14247309.36
"2663",2017-08-17 00:48:58,251513.74,14498823.1
"16530",2017-08-17 00:48:58,140160.83,14638983.93
"2664",2017-08-17 00:58:29,-251513.74,14387470.19
"2665",2017-08-17 03:51:48,173239.62,14560709.81
"2666",2017-08-17 03:51:48,251298.79,14812008.6
"2667",2017-08-17 07:07:08,-424538.41,14387470.19
"16531",2017-08-17 07:49:11,155980.05,14543450.24
"16532",2017-08-17 07:49:11,154760.31,14698210.55
"16533",2017-08-17 07:49:11,145143.23,14843353.78
"16534",2017-08-17 07:51:53,162819.56,15006173.34
"16535",2017-08-17 08:01:39,367638.27,15373811.61
"16536",2017-08-17 08:01:39,125855.38,15499666.99
"16537",2017-08-17 08:22:18,289588.85,15789255.84
"16538",2017-08-17 08:33:11,264151.89,16053407.73
"16539",2017-08-17 09:27:43,162198.35,16215606.08
"16540",2017-08-17 09:27:43,331971,16547577.08
"16541",2017-08-17 09:27:43,329256.95,16876834.03
"16542",2017-08-17 09:42:28,482324.93,17359158.96
"16543",2017-08-17 09:53:14,397545.56,17756704.52
"16544",2017-08-17 10:06:13,436853.37,18193557.89
"2668",2017-08-17 16:47:08,217139.88,18410697.77
"2669",2017-08-17 16:53:54,-217139.88,18193557.89
"16545",2017-08-17 20:18:56,8980.62,18202538.51
"16546",2017-08-17 20:18:56,-18193557.89,8980.61999998614
"2670",2017-08-17 20:23:00,137824.92,146805.539999986
"2671",2017-08-17 20:23:00,71061.16,217866.699999986
"2672",2017-08-17 20:30:05,68855.38,286722.079999986
"2673",2017-08-17 20:30:05,-208886.08,77835.9999999862
"16547",2017-08-17 20:30:05,-8980.62,68855.3799999862
"2674",2017-08-17 20:35:33,66385.74,135241.119999986
"2675",2017-08-17 20:41:38,106251.95,241493.069999986
"2676",2017-08-17 20:41:38,87050.31,328543.379999986
"2677",2017-08-17 20:41:38,-68855.38,259687.999999986
"2678",2017-08-17 20:58:51,-259688,-1.37952156364918e-08
"16548",2017-08-17 20:58:51,72506.19,72506.1899999862
"2679",2017-08-17 21:37:36,140891.79,213397.979999986
"2680",2017-08-17 21:39:55,-140891.79,72506.1899999862
"16549",2017-08-17 22:49:51,39987.83,112494.019999986
"16550",2017-08-17 23:04:13,5839.94,118333.959999986
"16551",2017-08-17 23:04:13,34724.47,153058.429999986
"16552",2017-08-17 23:14:45,-153058.43,-1.37952156364918e-08
"2681",2017-08-17 23:48:00,62596.26,62596.2599999862
"2682",2017-08-17 23:48:00,15612.22,78208.4799999862
"16553",2017-08-17 23:48:00,86060.64,164269.119999986
"2683",2017-08-17 23:52:48,-78208.48,86060.6399999862
"16554",2017-08-17 23:52:48,79646.01,165706.649999986
"16555",2017-08-17 23:54:58,-165706.65,-1.37952156364918e-08
"2684",2017-08-18 00:32:06,6189.63,6189.6299999862
"2685",2017-08-18 00:32:06,73153.28,79342.9099999862
"2686",2017-08-18 00:32:06,36504.87,115847.779999986
"2687",2017-08-18 00:43:27,-115847.78,-1.37952156364918e-08
"16556",2017-08-18 00:47:55,24880.48,24880.4799999862
"2688",2017-08-18 00:50:34,5238.58,30119.0599999862
"2689",2017-08-18 01:09:52,127004.62,157123.679999986
"2690",2017-08-18 01:09:52,-5238.58,151885.099999986
"16557",2017-08-18 01:09:52,-24880.48,127004.619999986
"2691",2017-08-18 01:21:33,-127004.62,-1.37806637212634e-08
"16558",2017-08-18 01:21:33,86878.31,86878.3099999862
"2692",2017-08-18 02:03:20,84228.62,171106.929999986
"2693",2017-08-18 02:03:20,63821.15,234928.079999986
"2694",2017-08-18 02:03:20,69503.84,304431.919999986
"2695",2017-08-18 02:03:20,48878.49,353310.409999986
"16559",2017-08-18 02:03:20,-86878.31,266432.099999986
"16560",2017-08-18 02:03:20,185411.05,451843.149999986
"16561",2017-08-18 02:03:20,105422.77,557265.919999986
"16562",2017-08-18 02:03:20,101673.65,658939.569999986
"2696",2017-08-18 02:06:44,67097.58,726037.149999986
"16563",2017-08-18 02:06:44,-392507.47,333529.679999986
"2697",2017-08-18 02:16:58,52161.41,385691.089999986
"2698",2017-08-18 02:16:58,-266432.1,119258.989999986
"16564",2017-08-18 02:16:58,76341.8,195600.789999986
"2699",2017-08-18 02:26:01,-119258.99,76341.7999999862
"16565",2017-08-18 02:26:01,-76341.8,-1.3766111806035e-08
"16566",2017-08-18 02:51:57,11861.74,11861.7399999862
"16567",2017-08-18 03:18:36,-11861.74,-1.3766111806035e-08
"16568",2017-08-18 03:29:02,89196.64,89196.6399999862
"16569",2017-08-18 03:58:42,-89196.64,-1.3766111806035e-08
"2700",2017-08-18 04:38:06,54794.72,54794.7199999862
"2701",2017-08-18 04:42:12,-54794.72,-1.3766111806035e-08
"16570",2017-08-18 06:14:26,29761.17,29761.1699999862
"2702",2017-08-18 07:05:36,76490,106251.169999986
"2703",2017-08-18 07:21:05,-76490,29761.1699999862
"2704",2017-08-18 07:55:31,55164.13,84925.2999999862
"16571",2017-08-18 07:55:31,139039.12,223964.419999986
"2705",2017-08-18 08:17:01,-55164.13,168800.289999986
"16572",2017-08-18 08:26:40,54102.24,222902.529999986
"16573",2017-08-18 08:26:40,47770.94,270673.469999986
"16574",2017-08-18 08:31:46,92791.14,363464.609999986
"2706",2017-08-18 09:10:27,71308.44,434773.049999986
"16575",2017-08-18 09:55:31,72109.45,506882.499999986
"16576",2017-08-18 10:16:16,149058.58,655941.079999986
"2707",2017-08-18 10:28:24,62229.84,718170.919999986
"2708",2017-08-18 10:28:24,-71308.44,646862.479999986
"16577",2017-08-18 10:28:24,58685.19,705547.669999986
"16578",2017-08-18 10:31:00,121610.23,827157.899999986
"2709",2017-08-18 10:37:27,-62229.84,764928.059999986
"2710",2017-08-18 11:04:08,135665.51,900593.569999986
"2711",2017-08-18 11:04:08,80401.56,980995.129999986
"2712",2017-08-18 11:08:56,-216067.07,764928.059999986
"2713",2017-08-18 12:38:32,109946.65,874874.709999986
"2714",2017-08-18 12:43:30,-109946.65,764928.059999986
"2715",2017-08-18 13:21:47,87044.41,851972.469999986
"2716",2017-08-18 13:40:59,-87044.41,764928.059999986
"2717",2017-08-18 14:46:07,85979.16,850907.219999986
"2718",2017-08-18 15:00:53,-85979.16,764928.059999986
"2719",2017-08-18 15:00:53,98856.12,863784.179999986
"2720",2017-08-18 15:25:32,-98856.12,764928.059999986
"2721",2017-08-18 15:39:35,108978.25,873906.309999986
"2722",2017-08-18 15:39:35,92809.2,966715.509999986
"2723",2017-08-18 15:53:41,-201787.45,764928.059999986
"2724",2017-08-18 16:42:59,60632.34,825560.399999986
"16579",2017-08-18 16:42:59,141665.43,967225.829999986
"2725",2017-08-18 16:55:37,67735.47,1034961.29999999
"2726",2017-08-18 16:55:37,48538.7,1083499.99999999
"2727",2017-08-18 16:55:37,-60632.34,1022867.65999999
"16580",2017-08-18 16:55:37,197332.81,1220200.46999999
"2728",2017-08-18 17:01:58,-116274.17,1103926.29999999
"2729",2017-08-18 18:02:25,173268.12,1277194.41999999
"2730",2017-08-18 18:02:25,138943.03,1416137.44999999
"2731",2017-08-18 18:02:25,62838.32,1478975.76999999
"16581",2017-08-18 18:02:25,115942.87,1594918.63999999
"16582",2017-08-18 18:02:25,60005.88,1654924.51999999
"16583",2017-08-18 18:02:25,200984.86,1855909.37999999
"2732",2017-08-18 18:09:51,-375049.47,1480859.90999999
"2733",2017-08-18 18:09:51,59977.57,1540837.47999999
"16584",2017-08-18 18:09:51,73898.66,1614736.13999999
"2734",2017-08-18 18:19:32,-59977.57,1554758.56999999
"16585",2017-08-18 18:19:32,75007.26,1629765.82999999
"16586",2017-08-18 18:19:32,58287.43,1688053.25999999
"16587",2017-08-18 18:19:32,114501.11,1802554.36999999
"16588",2017-08-18 18:34:10,112625.75,1915180.11999999
"16589",2017-08-18 18:34:10,112882.09,2028062.20999999
"2735",2017-08-18 18:45:47,19910.6,2047972.80999999
"2736",2017-08-18 18:45:47,56445.6,2104418.40999999
"2737",2017-08-18 18:49:06,-76356.2,2028062.20999999
"2738",2017-08-18 18:58:34,373447.3,2401509.50999999
"2739",2017-08-18 19:04:06,-373447.3,2028062.20999999
"2740",2017-08-18 19:13:25,156097.39,2184159.59999999
"16590",2017-08-18 19:13:25,55265.8,2239425.39999999
"2741",2017-08-18 19:21:00,-156097.39,2083328.00999999
"2742",2017-08-18 19:21:00,134025.33,2217353.33999999
"16591",2017-08-18 19:21:00,268371.77,2485725.10999999
"2743",2017-08-18 19:35:03,137893.95,2623619.05999999
"2744",2017-08-18 19:35:03,49695.44,2673314.49999999
"2745",2017-08-18 19:35:03,-134025.33,2539289.16999999
"2746",2017-08-18 19:47:32,-187589.39,2351699.77999999
"2747",2017-08-18 19:52:59,105050.4,2456750.17999999
"2748",2017-08-18 20:02:42,-105050.4,2351699.77999999
"2749",2017-08-18 20:02:42,95872.36,2447572.13999999
"2750",2017-08-18 20:02:42,147472.14,2595044.27999999
"2751",2017-08-18 20:02:42,127428.69,2722472.96999999
"2752",2017-08-18 20:02:42,62123.84,2784596.80999999
"2753",2017-08-18 20:15:03,-432897.03,2351699.77999999
"2754",2017-08-18 20:33:28,132853.42,2484553.19999999
"2755",2017-08-18 20:39:14,-132853.42,2351699.77999999
"2756",2017-08-18 20:39:14,288724.88,2640424.65999999
"2757",2017-08-18 20:53:52,17282.54,2657707.19999999
"2758",2017-08-18 20:53:52,151741.05,2809448.24999999
"2759",2017-08-18 20:53:52,-288724.88,2520723.36999999
"16592",2017-08-18 20:53:52,130869.97,2651593.33999999
"2760",2017-08-18 21:08:33,-169023.59,2482569.74999999
"2761",2017-08-18 21:14:56,140541.77,2623111.51999999
"2762",2017-08-18 21:23:00,-140541.77,2482569.74999999
"16593",2017-08-18 21:23:00,190262.13,2672831.87999999
"2763",2017-08-18 21:36:13,95503.41,2768335.28999999
"2764",2017-08-18 21:36:13,164497.14,2932832.42999999
"2765",2017-08-18 22:07:51,-260000.55,2672831.87999999
"16594",2017-08-18 22:50:38,308430.56,2981262.43999999
"2766",2017-08-18 23:02:40,104130.58,3085393.01999999
"2767",2017-08-18 23:02:40,99112.94,3184505.95999999
"2768",2017-08-18 23:02:40,102758.1,3287264.05999999
"2769",2017-08-18 23:02:40,129001.07,3416265.12999999
"16595",2017-08-18 23:02:40,107968.59,3524233.71999999
"2770",2017-08-18 23:22:50,-435002.69,3089231.02999999
"16596",2017-08-18 23:22:50,115652.85,3204883.87999999
"16597",2017-08-18 23:45:41,125853.54,3330737.41999999
"16598",2017-08-19 00:01:06,106736.17,3437473.58999999
"2771",2017-08-19 00:15:58,183471.41,3620944.99999999
"2772",2017-08-19 00:45:06,-183471.41,3437473.58999999
"16599",2017-08-19 00:45:06,105767.75,3543241.33999999
"16600",2017-08-19 00:45:06,97463.93,3640705.26999999
"16601",2017-08-19 01:06:50,105679.06,3746384.32999999
"16602",2017-08-19 01:18:21,144144.51,3890528.83999999
"2773",2017-08-19 01:46:01,128837.11,4019365.94999999
"2774",2017-08-19 01:52:06,-128837.11,3890528.83999999
"2775",2017-08-19 02:22:07,110111.11,4000639.94999999
"16603",2017-08-19 02:22:07,115232.65,4115872.59999999
"2776",2017-08-19 02:50:44,159639.66,4275512.25999999
"2777",2017-08-19 02:50:44,-110111.11,4165401.14999999
"2778",2017-08-19 03:04:36,-159639.66,4005761.48999999
"16604",2017-08-19 03:54:39,186396.88,4192158.36999999
"16605",2017-08-19 04:27:40,148071.69,4340230.05999999
"2779",2017-08-19 05:51:13,177712.34,4517942.39999999
"2780",2017-08-19 05:52:58,196620.79,4714563.18999999
"2781",2017-08-19 05:52:58,-177712.34,4536850.84999999
"2782",2017-08-19 06:06:11,-196620.79,4340230.05999999
"16606",2017-08-19 06:06:11,-4340230.06,-1.39698386192322e-08
"2783",2017-08-19 06:59:07,186048.7,186048.699999986
"2784",2017-08-19 07:01:44,-186048.7,-1.39698386192322e-08
"16607",2017-08-19 07:34:05,266991.81,266991.809999986
"16608",2017-08-19 07:38:06,-266991.81,-1.39698386192322e-08
"16609",2017-08-19 07:49:41,221400.25,221400.249999986
"16610",2017-08-19 07:49:41,167815.88,389216.129999986
"16611",2017-08-19 08:00:54,-389216.13,-1.39698386192322e-08
"16612",2017-08-19 08:38:55,275211.98,275211.979999986
"16613",2017-08-19 09:00:18,-275211.98,-1.39698386192322e-08
"2785",2017-08-19 09:21:13,155150.73,155150.729999986
"2786",2017-08-19 09:35:00,-155150.73,-1.39698386192322e-08
"2787",2017-08-19 09:58:44,235885.74,235885.739999986
"16614",2017-08-19 09:58:44,233373,469258.739999986
"2788",2017-08-19 10:09:40,-235885.74,233372.999999986
"16615",2017-08-19 10:09:40,-233373,-1.39698386192322e-08
"2789",2017-08-19 10:39:59,16472.49,16472.489999986
"16616",2017-08-19 10:39:59,223943.58,240416.069999986
"2790",2017-08-19 11:02:30,-16472.49,223943.579999986
"16617",2017-08-19 11:02:30,-223943.58,-1.39698386192322e-08
"16618",2017-08-19 11:02:30,129419.21,129419.209999986
"16619",2017-08-19 11:15:20,-129419.21,-1.39698386192322e-08
"16620",2017-08-19 11:48:36,15076.04,15076.039999986
"16621",2017-08-19 12:00:29,-15076.04,-1.39698386192322e-08
"16622",2017-08-19 12:53:03,215019.29,215019.289999986
"2791",2017-08-19 13:08:57,156529.96,371549.249999986
"16623",2017-08-19 13:08:57,-215019.29,156529.959999986
"16624",2017-08-19 13:08:57,300118.01,456647.969999986
"2792",2017-08-19 13:24:00,363292.29,819940.259999986
"2793",2017-08-19 13:24:00,203424.9,1023365.15999999
"2794",2017-08-19 13:24:00,-156529.96,866835.199999986
"16625",2017-08-19 13:24:00,-300118.01,566717.189999986
"2795",2017-08-19 13:31:16,-566717.19,-1.38534232974052e-08
"2796",2017-08-19 13:49:17,213922.4,213922.399999986
"16626",2017-08-19 13:49:17,316943.14,530865.539999986
"2797",2017-08-19 14:21:20,24445.29,555310.829999986
"2798",2017-08-19 14:21:20,208282.62,763593.449999986
"2799",2017-08-19 14:21:20,-213922.4,549671.049999986
"16627",2017-08-19 14:21:20,-316943.14,232727.909999986
"2800",2017-08-19 14:39:05,-232727.91,-1.38243194669485e-08
"2801",2017-08-19 14:39:05,211601.76,211601.759999986
"16628",2017-08-19 14:39:05,221098.34,432700.099999986
"2802",2017-08-19 14:52:01,-211601.76,221098.339999986
"16629",2017-08-19 14:52:01,-221098.34,-1.38243194669485e-08
"16630",2017-08-19 14:52:01,416467.31,416467.309999986
"2803",2017-08-19 15:07:54,234553.75,651021.059999986
"16631",2017-08-19 15:07:54,-416467.31,234553.749999986
"16632",2017-08-19 15:07:54,402276.93,636830.679999986
"2804",2017-08-19 15:10:02,-234553.75,402276.929999986
"16633",2017-08-19 15:21:49,-402276.93,-1.37952156364918e-08
"16634",2017-08-19 16:01:18,260907.45,260907.449999986
"16635",2017-08-19 16:26:34,-260907.45,-1.37952156364918e-08
"16636",2017-08-19 16:56:23,304931.29,304931.289999986
"16637",2017-08-19 17:00:15,-304931.29,-1.37952156364918e-08
"16638",2017-08-19 17:00:15,350812.32,350812.319999986
"16639",2017-08-19 17:08:04,-350812.32,-1.37952156364918e-08
"16640",2017-08-19 17:21:02,298972.01,298972.009999986
"16641",2017-08-19 17:33:06,-298972.01,-1.37952156364918e-08
"16642",2017-08-19 17:33:06,317564.83,317564.829999986
"16643",2017-08-19 17:38:40,-317564.83,-1.37952156364918e-08
"16644",2017-08-19 18:27:00,254975.42,254975.419999986
"16645",2017-08-19 18:27:00,250903.18,505878.599999986
"16646",2017-08-19 18:31:07,-505878.6,-1.37370079755783e-08
"16647",2017-08-19 18:49:59,225804.02,225804.019999986
"16648",2017-08-19 19:02:19,-225804.02,-1.37370079755783e-08
"16649",2017-08-19 19:02:19,199583.23,199583.229999986
"16650",2017-08-19 19:13:48,-199583.23,-1.37370079755783e-08
"16651",2017-08-19 21:34:34,263075.2,263075.199999986
"16652",2017-08-19 21:34:34,300118.5,563193.699999986
"16653",2017-08-19 22:07:02,-563193.7,-1.37370079755783e-08
"16654",2017-08-20 00:17:25,575081.83,575081.829999986
"16655",2017-08-20 00:22:02,347580.11,922661.939999986
"16656",2017-08-20 00:31:16,24969.98,947631.919999986
"2805",2017-08-20 00:52:44,212593.34,1160225.25999999
"2806",2017-08-20 00:56:54,-212593.34,947631.919999986
"16657",2017-08-20 01:55:42,290146.22,1237778.13999999
"2807",2017-08-20 01:57:49,202254.51,1440032.64999999
"2808",2017-08-20 02:11:57,-202254.51,1237778.13999999
"16658",2017-08-20 02:36:57,229079.63,1466857.76999999
"16659",2017-08-20 03:09:21,228798.67,1695656.43999999
"2809",2017-08-20 04:05:48,189895.22,1885551.65999999
"2810",2017-08-20 04:49:15,-189895.22,1695656.43999999
"16660",2017-08-20 04:49:15,172044.06,1867700.49999999
"16661",2017-08-20 08:46:37,466281.06,2333981.55999999
"16662",2017-08-20 08:46:37,512462.52,2846444.07999999
"16663",2017-08-20 16:54:06,258991.07,3105435.14999999
"16664",2017-08-20 17:48:17,324861.97,3430297.11999999
"16665",2017-08-20 20:33:51,479098.96,3909396.07999999
"16666",2017-08-20 20:43:06,332526.19,4241922.26999999
"2811",2017-08-21 08:57:35,367651.65,4609573.91999999
"2812",2017-08-21 09:36:44,-367651.65,4241922.26999999
"16667",2017-08-21 11:09:33,306401.04,4548323.30999999
"16668",2017-08-21 12:26:15,330545.44,4878868.74999999
"16669",2017-08-21 13:10:16,602894.15,5481762.89999999
"16670",2017-08-21 20:15:48,576045.14,6057808.03999999
"16671",2017-08-21 23:29:00,106114.64,6163922.67999999
"16672",2017-08-21 23:29:00,177895.32,6341817.99999999
"16673",2017-08-21 23:29:00,157489.02,6499307.01999999
"16674",2017-08-21 23:29:00,287632.33,6786939.34999999
"16675",2017-08-21 23:29:00,112041.34,6898980.68999999
"16676",2017-08-22 02:09:50,-6898980.69,-1.39698386192322e-08
"2813",2017-08-22 02:20:34,318837.84,318837.839999986
"2814",2017-08-22 02:20:34,428415.73,747253.569999986
"2815",2017-08-22 02:28:45,-747253.57,-1.38534232974052e-08
"16677",2017-08-22 02:40:06,447665.82,447665.819999986
"16678",2017-08-22 02:54:44,-447665.82,-1.38534232974052e-08
"2816",2017-08-22 04:35:50,480235.75,480235.749999986
"16679",2017-08-22 04:55:54,411733.42,891969.169999986
"2817",2017-08-22 05:04:46,-480235.75,411733.419999986
"2818",2017-08-22 05:04:46,385675.82,797409.239999986
"16680",2017-08-22 05:04:46,-411733.42,385675.819999986
"2819",2017-08-22 05:46:12,-385675.82,-1.37370079755783e-08
"16681",2017-08-22 05:46:12,283948.19,283948.189999986
"2820",2017-08-22 06:22:03,179588.42,463536.609999986
"16682",2017-08-22 06:22:03,-283948.19,179588.419999986
"2821",2017-08-22 06:43:00,-179588.42,-1.3766111806035e-08
"16683",2017-08-22 06:43:00,154905.89,154905.889999986
"2822",2017-08-22 07:00:31,84956.37,239862.259999986
"16684",2017-08-22 07:00:31,-154905.89,84956.3699999862
"2823",2017-08-22 07:17:53,-84956.37,-1.3766111806035e-08
"16685",2017-08-22 07:32:01,194973.97,194973.969999986
"16686",2017-08-22 07:32:01,181681.15,376655.119999986
"16687",2017-08-22 07:45:04,-376655.12,-1.37370079755783e-08
"16688",2017-08-22 10:17:40,157450.04,157450.039999986
"2824",2017-08-22 10:22:20,186787.93,344237.969999986
"16689",2017-08-22 10:22:20,-157450.04,186787.929999986
"16690",2017-08-22 10:22:20,300120.57,486908.499999986
"2825",2017-08-22 10:45:18,-186787.93,300120.569999986
"16691",2017-08-22 10:45:18,-300120.57,-1.37370079755783e-08
"16692",2017-08-22 10:45:18,188456.93,188456.929999986
"16693",2017-08-22 10:55:44,-188456.93,-1.37370079755783e-08
"16694",2017-08-22 18:50:52,200120.65,200120.649999986
"16695",2017-08-22 19:18:11,150120.69,350241.339999986
"16696",2017-08-22 19:18:11,-200120.65,150120.689999986
"16697",2017-08-22 20:00:35,100120.7,250241.389999986
"16698",2017-08-22 21:19:26,-250241.39,-1.37952156364918e-08
"16699",2017-08-22 21:24:44,50120.72,50120.7199999862
"16700",2017-08-22 21:39:07,-50120.72,-1.37952156364918e-08
"16701",2017-08-22 22:31:59,300120.73,300120.729999986
"16702",2017-08-22 22:36:01,-300120.73,-1.37952156364918e-08
"16703",2017-08-22 22:48:34,110082.92,110082.919999986
"16704",2017-08-22 22:48:34,113827.48,223910.399999986
"16705",2017-08-22 23:22:32,158625.86,382536.259999986
"16706",2017-08-22 23:22:32,101053.81,483590.069999986
"16707",2017-08-22 23:30:45,275515.73,759105.799999986
"16708",2017-08-22 23:39:38,298194.9,1057300.69999999
"16709",2017-08-22 23:39:38,-223910.4,833390.299999986
"16710",2017-08-22 23:39:38,-759105.8,74284.4999999861
"16711",2017-08-22 23:50:12,365993.2,440277.699999986
"16712",2017-08-22 23:50:12,-74284.5,365993.199999986
"16713",2017-08-22 23:50:12,155083.3,521076.499999986
"16714",2017-08-22 23:50:12,300120.67,821197.169999986
"16715",2017-08-22 23:50:12,205290.7,1026487.86999999
"16716",2017-08-22 23:50:12,300120.68,1326608.54999999
"2826",2017-08-22 23:51:14,140736.92,1467345.46999999
"16717",2017-08-22 23:57:42,-1326608.55,140736.919999986
"16718",2017-08-23 00:04:13,495961.34,636698.259999986
"2827",2017-08-23 00:23:56,183944.86,820643.119999986
"2828",2017-08-23 00:23:56,137600.61,958243.729999986
"16719",2017-08-23 00:23:56,440637.5,1398881.22999999
"16720",2017-08-23 00:23:56,-495961.34,902919.889999986
"2829",2017-08-23 00:42:46,-140736.92,762182.969999986
"16721",2017-08-23 00:42:46,185826.57,948009.539999986
"16722",2017-08-23 00:42:46,-440637.5,507372.039999986
"2830",2017-08-23 00:56:57,-321545.47,185826.569999986
"16723",2017-08-23 00:56:57,145341.16,331167.729999986
"16724",2017-08-23 00:56:57,246929.67,578097.399999986
"16725",2017-08-23 00:56:57,-185826.57,392270.829999986
"16726",2017-08-23 01:01:59,120928.24,513199.069999986
"16727",2017-08-23 01:01:59,-392270.83,120928.239999986
"16728",2017-08-23 01:17:05,175580.06,296508.299999986
"16729",2017-08-23 01:17:05,184611.22,481119.519999986
"16730",2017-08-23 01:37:56,189690.07,670809.589999986
"16731",2017-08-23 01:41:04,165960.27,836769.859999986
"16732",2017-08-23 02:13:33,198469.22,1035239.07999999
"16733",2017-08-23 02:13:33,209365.82,1244604.89999999
"16734",2017-08-23 02:22:08,176984.73,1421589.62999999
"16735",2017-08-23 03:19:18,292341.88,1713931.50999999
"16736",2017-08-23 03:31:25,159995.19,1873926.69999999
"16737",2017-08-23 03:44:00,191264.61,2065191.30999999
"16738",2017-08-23 03:52:43,218577,2283768.30999999
"16739",2017-08-23 06:55:12,205872.14,2489640.44999999
"16740",2017-08-23 08:11:00,241093.43,2730733.87999999
"2831",2017-08-23 09:31:08,511547.53,3242281.40999999
"16741",2017-08-23 09:31:08,393788.83,3636070.23999999
"16742",2017-08-23 09:31:08,643245.72,4279315.95999999
"16743",2017-08-23 09:48:43,315073.32,4594389.27999999
"2832",2017-08-23 10:01:05,-511547.53,4082841.74999999
"16744",2017-08-23 10:42:57,346230.7,4429072.44999999
"16745",2017-08-23 11:09:21,293956.05,4723028.49999999
"16746",2017-08-23 12:55:36,393340.65,5116369.14999999
"2833",2017-08-23 13:00:24,28788.88,5145158.02999999
"2834",2017-08-23 13:06:04,-28788.88,5116369.14999999
"2835",2017-08-23 13:16:07,333061.14,5449430.28999999
"2836",2017-08-23 13:20:59,-333061.14,5116369.14999999
"2837",2017-08-23 13:38:25,264110.34,5380479.48999999
"2838",2017-08-23 13:41:50,-264110.34,5116369.14999999
"2839",2017-08-23 13:55:52,443592.9,5559962.04999999
"2840",2017-08-23 14:16:47,-443592.9,5116369.14999999
"16747",2017-08-23 14:16:47,245758.67,5362127.81999999
"16748",2017-08-23 15:43:46,246134.96,5608262.77999999
"16749",2017-08-23 16:30:24,261193.32,5869456.09999999
"16750",2017-08-23 16:52:31,279882.77,6149338.86999999
"16751",2017-08-24 05:29:35,95565.41,6244904.27999999
"16752",2017-08-24 06:08:09,498368.35,6743272.62999999
"16753",2017-08-24 11:32:08,217243.51,6960516.13999999
"16754",2017-08-24 12:09:18,299548.08,7260064.21999999
"16755",2017-08-24 13:53:19,385239.52,7645303.73999999
"16756",2017-08-24 14:27:50,411510.23,8056813.96999999
"2841",2017-08-24 15:26:45,479510.85,8536324.81999999
"2842",2017-08-24 15:45:40,-479510.85,8056813.96999999
"2843",2017-08-24 23:20:54,327771.43,8384585.39999999
"16757",2017-08-24 23:20:54,432521.89,8817107.28999999
"16758",2017-08-24 23:20:54,270070.69,9087177.97999999
"2844",2017-08-24 23:46:06,555630.86,9642808.83999998
"2845",2017-08-24 23:46:06,-327771.43,9315037.40999999
"2846",2017-08-24 23:52:29,-555630.86,8759406.54999999
"16759",2017-08-25 00:24:38,-8759406.55,-1.49011611938477e-08
"2847",2017-08-25 00:49:31,508806.19,508806.189999985
"2848",2017-08-25 00:52:33,-508806.19,-1.49011611938477e-08
"16760",2017-08-25 00:52:33,438127.8,438127.799999985
"16761",2017-08-25 00:56:24,-438127.8,-1.49011611938477e-08
"16762",2017-08-25 03:21:14,422030.48,422030.479999985
"16763",2017-08-25 05:02:35,377034.54,799065.019999985
"16764",2017-08-25 05:08:33,-799065.02,-1.49011611938477e-08
"16765",2017-08-25 05:26:41,272325.45,272325.449999985
"16766",2017-08-25 05:44:39,-272325.45,-1.49011611938477e-08
"2849",2017-08-25 06:09:21,438445.14,438445.139999985
"2850",2017-08-25 06:18:24,-438445.14,-1.49011611938477e-08
"16767",2017-08-25 07:10:54,258829.83,258829.829999985
"16768",2017-08-25 07:18:32,-258829.83,-1.49011611938477e-08
"2851",2017-08-25 16:14:20,287857.6,287857.599999985
"2852",2017-08-25 16:14:20,364261.48,652119.079999985
"16769",2017-08-25 16:14:20,656836.53,1308955.60999998
"16770",2017-08-25 16:14:20,253310.81,1562266.41999999
"2853",2017-08-25 16:42:11,-652119.08,910147.339999985
"16771",2017-08-25 17:30:20,388879.97,1299027.30999999
"16772",2017-08-25 19:46:42,-1299027.31,-1.49011611938477e-08
"2854",2017-08-25 20:12:04,322902.58,322902.579999985
"2855",2017-08-25 20:25:09,-322902.58,-1.49011611938477e-08
"16773",2017-08-25 20:25:09,235353.57,235353.569999985
"16774",2017-08-25 20:27:07,16389.83,251743.399999985
"2856",2017-08-25 20:34:51,248239.52,499982.919999985
"16775",2017-08-25 20:34:51,304394.39,804377.309999985
"16776",2017-08-25 20:34:51,-251743.4,552633.909999985
"16777",2017-08-25 20:34:51,-251743.4,300890.509999985
"2857",2017-08-25 20:48:43,-248239.52,52650.9899999851
"16778",2017-08-26 03:32:12,170046.13,222697.119999985
"16779",2017-08-26 03:32:12,18964.55,241661.669999985
"16780",2017-08-26 08:01:33,118964.79,360626.459999985
"16781",2017-08-26 18:12:47,77907.83,438534.289999985
"16782",2017-08-26 18:12:47,89018.86,527553.149999985
"16783",2017-08-26 19:27:30,716053.14,1243606.28999999
"16784",2017-08-26 20:14:26,77908.65,1321514.93999999
"16785",2017-08-26 20:14:26,77908.66,1399423.59999998
"16786",2017-08-27 02:09:32,259716.99,1659140.58999998
"16787",2017-08-27 02:09:32,354705.38,2013845.96999998
"2858",2017-08-27 03:01:20,417185.97,2431031.93999998
"2859",2017-08-27 03:04:37,-417185.97,2013845.96999998
"16788",2017-08-27 04:11:20,300121.92,2313967.88999998
"16789",2017-08-27 09:09:36,235211.59,2549179.47999998
"16790",2017-08-27 10:22:11,217556.02,2766735.49999998
"16791",2017-08-27 11:32:49,225174.55,2991910.04999998
"16792",2017-08-27 15:00:14,281944.31,3273854.35999998
"2860",2017-08-27 18:08:41,265148.08,3539002.43999998
"2861",2017-08-27 18:15:05,-265148.08,3273854.35999998
"16793",2017-08-27 19:55:06,220685.05,3494539.40999998
"16794",2017-08-27 20:53:08,224076.18,3718615.58999998
"16795",2017-08-28 00:17:48,515680.07,4234295.65999998
"2862",2017-08-28 00:32:03,281961.01,4516256.66999998
"2863",2017-08-28 00:34:41,-281961.01,4234295.65999998
"16796",2017-08-28 01:07:11,451803.46,4686099.11999998
"16797",2017-08-28 04:33:47,326705.12,5012804.23999998
"16798",2017-08-28 04:33:47,211427.67,5224231.90999998
"2864",2017-08-28 04:56:01,495639.22,5719871.12999998
"16799",2017-08-28 04:56:01,229143.17,5949014.29999998
"16800",2017-08-28 04:56:01,30658.44,5979672.73999998
"2865",2017-08-28 05:14:05,-495639.22,5484033.51999998
"2866",2017-08-28 05:34:34,324490.77,5808524.28999998
"2867",2017-08-28 05:37:47,-324490.77,5484033.51999998
"16801",2017-08-29 03:34:24,161105.25,5645138.76999998
"16802",2017-08-29 03:34:24,14872.69,5660011.45999999
"16803",2017-08-29 03:42:51,147731.98,5807743.43999999
"16804",2017-08-29 05:21:01,184633.35,5992376.78999999
"16805",2017-08-29 05:47:12,354763.85,6347140.63999998
"16806",2017-08-29 13:54:34,705857.08,7052997.71999998
"2868",2017-08-29 14:02:13,282472.77,7335470.48999999
"2869",2017-08-29 14:13:05,-282472.77,7052997.71999999
"2870",2017-08-29 14:37:54,193225.44,7246223.15999999
"16807",2017-08-29 14:37:54,201138.56,7447361.71999999
"2871",2017-08-29 14:47:52,-193225.44,7254136.27999999
"16808",2017-08-29 14:47:52,235692.47,7489828.74999999
"2872",2017-08-29 14:52:41,193798.63,7683627.37999998
"2873",2017-08-29 15:03:14,-193798.63,7489828.74999999
"2874",2017-08-29 15:23:25,219426.39,7709255.13999998
"2875",2017-08-29 15:43:09,-219426.39,7489828.74999999
"2876",2017-08-29 16:05:25,245933.96,7735762.70999999
"2877",2017-08-29 16:08:25,-245933.96,7489828.74999999
"2878",2017-08-29 16:37:25,18813.17,7508641.91999999
"16809",2017-08-29 16:50:20,183802.37,7692444.28999999
"16810",2017-08-29 16:50:20,199823.84,7892268.12999998
"16811",2017-08-29 16:50:20,-7489828.75,402439.379999985
"2879",2017-08-29 17:09:21,432987.1,835426.479999985
"16812",2017-08-29 17:09:21,199533.34,1034959.81999998
"16813",2017-08-29 17:09:21,-383626.21,651333.609999985
"16814",2017-08-29 17:40:48,250689.95,902023.559999985
"16815",2017-08-29 17:46:07,-450223.29,451800.269999985
"16816",2017-08-29 18:01:24,375002.86,826803.129999985
"16817",2017-08-29 18:13:12,-375002.86,451800.269999985
"2880",2017-08-29 21:18:35,677580.58,1129380.84999998
"16818",2017-08-29 21:18:35,335472.59,1464853.43999999
"16819",2017-08-29 21:37:24,-335472.59,1129380.84999998
"16820",2017-08-30 01:29:08,299254.71,1428635.55999998
"16821",2017-08-30 01:36:59,-299254.71,1129380.84999998
"16822",2017-08-30 01:55:15,300196.39,1429577.23999998
"16823",2017-08-30 01:59:00,-300196.39,1129380.84999998
"16824",2017-08-30 03:59:28,271194.7,1400575.54999998
"16825",2017-08-30 04:06:57,-271194.7,1129380.84999998
"16826",2017-08-30 04:26:50,261822.66,1391203.50999998
"16827",2017-08-30 04:26:50,25793.74,1416997.24999998
"16828",2017-08-30 04:34:34,285564.2,1702561.44999998
"16829",2017-08-30 04:34:34,-287616.4,1414945.04999998
"16830",2017-08-30 04:55:45,251328.62,1666273.66999998
"16831",2017-08-30 04:55:45,-285564.2,1380709.46999998
"16832",2017-08-30 04:58:38,-251328.62,1129380.84999998
"16833",2017-08-30 05:45:26,230417.17,1359798.01999998
"16834",2017-08-30 05:45:26,22229.99,1382028.00999998
"16835",2017-08-30 05:52:33,567235.14,1949263.14999998
"16836",2017-08-30 05:52:33,77916.3,2027179.44999998
"16837",2017-08-30 05:52:33,-252647.16,1774532.28999998
"16838",2017-08-30 06:10:06,165227.61,1939759.89999998
"16839",2017-08-30 06:10:06,-645151.44,1294608.45999998
"2881",2017-08-30 06:12:13,-1129380.85,165227.609999985
"16840",2017-08-30 06:21:21,-165227.61,-1.54832378029823e-08
"16841",2017-08-30 06:40:01,220715.14,220715.139999985
"16842",2017-08-30 06:59:37,-220715.14,-1.54832378029823e-08
"16843",2017-08-30 06:59:37,673936.7,673936.699999984
"16844",2017-08-30 07:21:47,-673936.7,-1.54832378029823e-08
"2882",2017-08-30 07:29:48,194573.31,194573.309999985
"2883",2017-08-30 07:31:35,-194573.31,-1.54832378029823e-08
"2884",2017-08-30 07:44:15,227694.77,227694.769999985
"16845",2017-08-30 08:11:26,194506.05,422200.819999984
"16846",2017-08-30 08:33:46,-194506.05,227694.769999984
"2885",2017-08-30 08:46:39,-227694.77,-1.55123416334391e-08
"2886",2017-08-30 09:52:02,245795.96,245795.959999984
"2887",2017-08-30 10:00:22,-245795.96,-1.55123416334391e-08
"2888",2017-08-30 10:17:08,177297.9,177297.899999984
"2889",2017-08-30 10:35:37,275984.77,453282.669999985
"2890",2017-08-30 10:35:37,-177297.9,275984.769999985
"16847",2017-08-30 10:35:37,264348.88,540333.649999985
"2891",2017-08-30 10:42:50,279721.55,820055.199999985
"2892",2017-08-30 10:42:50,-275984.77,544070.429999985
"2893",2017-08-30 10:50:03,-279721.55,264348.879999985
"16848",2017-08-30 11:01:14,239858.31,504207.189999985
"2894",2017-08-30 11:16:16,220223.71,724430.899999985
"2895",2017-08-30 11:26:44,-220223.71,504207.189999985
"16849",2017-08-30 11:26:44,285948.16,790155.349999984
"16850",2017-08-30 12:06:33,229482.1,1019637.44999998
"2896",2017-08-30 12:19:47,239567.23,1259204.67999998
"2897",2017-08-30 12:22:07,-239567.23,1019637.44999998
"16851",2017-08-30 12:34:40,369373.98,1389011.42999998
"2898",2017-08-30 12:43:49,376637.85,1765649.27999998
"16852",2017-08-30 12:43:49,247779.08,2013428.35999998
"2899",2017-08-30 12:54:11,-376637.85,1636790.50999998
"2900",2017-08-30 17:01:12,293212.64,1930003.14999998
"2901",2017-08-30 17:50:05,375946.81,2305949.95999998
"16853",2017-08-30 18:11:14,280698.6,2586648.55999998
"2902",2017-08-30 20:11:07,-669159.45,1917489.10999998
"2903",2017-08-30 23:02:30,201487.21,2118976.31999998
"2904",2017-08-30 23:08:29,-201487.21,1917489.10999998
"16854",2017-08-30 23:15:14,269179.68,2186668.78999999
"16855",2017-08-31 00:01:58,285811.41,2472480.19999999
"16856",2017-08-31 01:35:21,161761.22,2634241.41999999
"2905",2017-08-31 01:51:59,161718.33,2795959.74999999
"2906",2017-08-31 01:59:11,-161718.33,2634241.41999999
"16857",2017-08-31 02:09:07,142455.24,2776696.65999999
"16858",2017-08-31 02:26:48,138011.94,2914708.59999999
"2907",2017-08-31 03:21:08,157281.69,3071990.28999999
"2908",2017-08-31 03:27:36,-157281.69,2914708.59999999
"16859",2017-08-31 04:16:00,137639.31,3052347.90999999
"16860",2017-08-31 05:39:47,143374.41,3195722.31999999
"16861",2017-08-31 05:40:29,14473.63,3210195.94999999
"2909",2017-08-31 06:14:33,129360.81,3339556.75999999
"2910",2017-08-31 06:25:17,-129360.81,3210195.94999999
"16862",2017-08-31 07:04:48,225461,3435656.94999999
"2911",2017-08-31 07:19:10,127733.96,3563390.90999999
"2912",2017-08-31 07:27:09,-127733.96,3435656.94999999
"16863",2017-08-31 07:34:32,149923.33,3585580.27999999
"16864",2017-08-31 07:47:52,122806.14,3708386.41999999
"16865",2017-08-31 08:53:39,124361.12,3832747.53999999
"16866",2017-08-31 09:16:54,125240.86,3957988.39999999
"16867",2017-08-31 09:39:21,126660.62,4084649.01999999
"2913",2017-08-31 10:22:19,156398.37,4241047.38999999
"2914",2017-08-31 10:32:34,-156398.37,4084649.01999999
"16868",2017-08-31 10:39:20,143413.48,4228062.49999999
"16869",2017-08-31 10:44:15,325499.62,4553562.11999999
"2915",2017-08-31 10:52:43,167077.85,4720639.96999999
"2916",2017-08-31 11:20:02,156053.97,4876693.93999999
"2917",2017-08-31 11:36:57,-167077.85,4709616.08999999
"16870",2017-08-31 11:36:57,130783.98,4840400.06999999
"2918",2017-08-31 11:48:00,-156053.97,4684346.09999999
"16871",2017-08-31 12:07:54,119975.42,4804321.51999999
"16872",2017-08-31 12:48:12,114526.39,4918847.90999999
"16873",2017-08-31 12:48:12,11125.5,4929973.40999999
"16874",2017-08-31 13:16:09,227048.63,5157022.03999999
"2919",2017-08-31 13:53:55,148676.1,5305698.13999999
"2920",2017-08-31 13:53:55,287554.98,5593253.11999999
"2921",2017-08-31 13:53:55,212099.25,5805352.36999999
"16875",2017-08-31 13:53:55,151071.3,5956423.66999999
"16876",2017-08-31 13:53:55,155103.14,6111526.80999999
"16877",2017-08-31 13:53:55,306534.28,6418061.08999999
"2922",2017-08-31 14:06:19,-648330.33,5769730.75999999
"2923",2017-08-31 14:14:00,285328.19,6055058.94999999
"2924",2017-08-31 14:21:09,-285328.19,5769730.75999999
"16878",2017-08-31 14:34:48,241909.71,6011640.46999999
"2925",2017-08-31 15:54:14,187076.11,6198716.57999999
"2926",2017-08-31 16:12:16,239579.23,6438295.80999999
"2927",2017-08-31 16:12:16,-187076.11,6251219.69999999
"16879",2017-08-31 16:12:16,199521.01,6450740.70999999
"16880",2017-08-31 16:12:16,184797.41,6635538.11999999
"2928",2017-08-31 16:19:15,-239579.23,6395958.88999999
"2929",2017-08-31 16:25:17,120360.02,6516318.90999999
"2930",2017-08-31 16:28:21,-120360.02,6395958.88999999
"16881",2017-08-31 17:24:27,131934.03,6527892.91999999
"16882",2017-08-31 17:49:45,163344.49,6691237.40999999
"2931",2017-08-31 18:04:56,124612.07,6815849.47999999
"16883",2017-08-31 18:04:56,97423.33,6913272.80999999
"2932",2017-08-31 18:07:58,147129.04,7060401.84999999
"2933",2017-08-31 19:22:15,135293.2,7195695.04999999
"2934",2017-08-31 19:22:15,89028.32,7284723.36999999
"2935",2017-08-31 19:22:15,130140.35,7414863.71999999
"16884",2017-08-31 19:22:15,153514.27,7568377.98999999
"16885",2017-08-31 19:22:15,89028.33,7657406.31999999
"16886",2017-08-31 19:22:15,130140.34,7787546.65999999
"2936",2017-08-31 19:38:52,-124612.07,7662934.58999999
"2937",2017-08-31 20:05:15,-501590.91,7161343.67999999
"16887",2017-08-31 20:51:26,146438.97,7307782.64999999
"16888",2017-08-31 20:51:26,191294.26,7499076.90999999
"2938",2017-08-31 21:26:57,105374.8,7604451.70999999
"2939",2017-08-31 21:26:57,126077.01,7730528.71999998
"2940",2017-08-31 21:26:57,105862.76,7836391.47999998
"2941",2017-08-31 21:34:08,-337314.57,7499076.90999998
"2942",2017-08-31 21:52:09,161277.33,7660354.23999998
"2943",2017-08-31 22:33:04,107097.47,7767451.70999998
"2944",2017-08-31 22:33:04,146057.94,7913509.64999998
"2945",2017-08-31 22:33:04,-161277.33,7752232.31999998
"16889",2017-08-31 22:35:36,112797.82,7865030.13999998
"2946",2017-08-31 22:38:09,-253155.41,7611874.72999998
"2947",2017-08-31 22:53:06,111482,7723356.72999998
"2948",2017-08-31 23:01:51,-111482,7611874.72999998
"2949",2017-08-31 23:41:52,122974.12,7734848.84999998
"2950",2017-08-31 23:41:52,126842.85,7861691.69999998
"2951",2017-08-31 23:44:56,-249816.97,7611874.72999998
"2952",2017-09-01 00:31:08,106965.48,7718840.20999999
"16890",2017-09-01 00:31:08,111285.02,7830125.22999998
"16891",2017-09-01 00:31:08,102373.79,7932499.01999998
"16892",2017-09-01 00:31:08,113358.77,8045857.78999998
"2953",2017-09-01 00:39:27,196486.54,8242344.32999998
"2954",2017-09-01 00:39:27,-106965.48,8135378.84999998
"2955",2017-09-01 00:45:04,-196486.54,7938892.30999998
"16893",2017-09-01 00:57:03,236952.86,8175845.16999998
"16894",2017-09-01 00:59:33,111200.42,8287045.58999998
"2956",2017-09-01 01:18:09,104208.73,8391254.31999998
"2957",2017-09-01 01:22:30,-104208.73,8287045.58999998
"16895",2017-09-01 01:22:30,104974.55,8392020.13999998
"16896",2017-09-01 01:23:10,108102.3,8500122.43999998
"16897",2017-09-01 01:53:33,108061.58,8608184.01999998
"16898",2017-09-01 01:53:33,107947.42,8716131.43999998
"2958",2017-09-01 01:55:04,113667.24,8829798.67999998
"2959",2017-09-01 02:01:44,-113667.24,8716131.43999998
"16899",2017-09-01 02:11:08,108372.39,8824503.82999999
"2960",2017-09-01 02:33:30,112124.4,8936628.22999999
"2961",2017-09-01 02:42:05,-112124.4,8824503.82999999
"2962",2017-09-01 02:55:06,156820.33,8981324.15999999
"2963",2017-09-01 03:05:12,-156820.33,8824503.82999999
"16900",2017-09-01 03:05:12,101793.24,8926297.06999999
"16901",2017-09-01 03:18:31,159553.72,9085850.78999999
"16902",2017-09-01 03:26:21,111057.07,9196907.85999999
"16903",2017-09-01 03:44:20,124964.42,9321872.27999999
"16904",2017-09-01 04:21:20,115027.17,9436899.44999999
"16905",2017-09-01 04:21:20,112705.05,9549604.49999999
"2964",2017-09-01 06:25:58,146989.89,9696594.38999999
"2965",2017-09-01 06:49:46,-146989.89,9549604.49999999
"16906",2017-09-01 08:31:58,187655.56,9737260.05999999
"2966",2017-09-01 08:49:36,145760.39,9883020.44999999
"2967",2017-09-01 08:49:36,159383.65,10042404.1
"16907",2017-09-01 08:49:36,196697.01,10239101.11
"2968",2017-09-01 08:54:20,131047.26,10370148.37
"2969",2017-09-01 08:54:20,-305144.04,10065004.33
"2970",2017-09-01 09:18:24,-131047.26,9933957.06999999
"16908",2017-09-01 09:18:24,111611.29,10045568.36
"2971",2017-09-01 09:30:17,170885.55,10216453.91
"2972",2017-09-01 09:41:06,-170885.55,10045568.36
"16909",2017-09-01 09:41:06,199728.39,10245296.75
"16910",2017-09-01 10:10:33,189028.86,10434325.61
"16911",2017-09-01 10:15:45,181632.33,10615957.94
"2973",2017-09-01 10:29:44,165479.3,10781437.24
"2974",2017-09-01 10:34:10,-165479.3,10615957.94
"16912",2017-09-01 10:40:14,189028.89,10804986.83
"16913",2017-09-01 11:17:12,122793.99,10927780.82
"16914",2017-09-01 11:17:12,110258.05,11038038.87
"16915",2017-09-01 11:24:29,201993.78,11240032.65
"2975",2017-09-01 11:38:16,145430.26,11385462.91
"2976",2017-09-01 11:39:51,-145430.26,11240032.65
"16916",2017-09-01 11:39:51,171320.56,11411353.21
"16917",2017-09-01 12:12:19,148965.51,11560318.72
"16918",2017-09-01 12:12:19,163091.49,11723410.21
"16919",2017-09-01 12:12:19,124257.49,11847667.7
"2977",2017-09-01 12:22:54,189782.84,12037450.54
"2978",2017-09-01 12:33:37,-189782.84,11847667.7
"2979",2017-09-01 12:52:02,176966.89,12024634.59
"2980",2017-09-01 12:52:02,116509.55,12141144.14
"16920",2017-09-01 12:52:02,498542.52,12639686.66
"2981",2017-09-01 13:04:12,140010.37,12779697.03
"2982",2017-09-01 13:04:12,-293476.44,12486220.59
"2983",2017-09-01 13:29:52,159864.29,12646084.88
"2984",2017-09-01 13:29:52,-140010.37,12506074.51
"16921",2017-09-01 13:29:52,186104.1,12692178.61
"16922",2017-09-01 13:29:52,189029.06,12881207.67
"16923",2017-09-01 13:29:52,191943.88,13073151.55
"2985",2017-09-01 13:40:49,-159864.29,12913287.26
"2986",2017-09-01 13:52:23,114356.72,13027643.98
"2987",2017-09-01 14:11:44,183879.24,13211523.22
"2988",2017-09-01 14:11:44,137419.24,13348942.46
"2989",2017-09-01 14:11:44,-114356.72,13234585.74
"16924",2017-09-01 14:11:44,227533.18,13462118.92
"16925",2017-09-01 14:11:44,131233.88,13593352.8
"2990",2017-09-01 14:19:16,-321298.48,13272054.32
"16926",2017-09-01 14:19:16,172343.44,13444397.76
"2991",2017-09-01 14:39:14,189029.14,13633426.9
"16927",2017-09-01 14:39:14,189029.13,13822456.03
"2992",2017-09-01 14:44:43,-189029.14,13633426.89
"2993",2017-09-01 14:59:21,168019.71,13801446.6
"2994",2017-09-01 15:05:28,-168019.71,13633426.89
"16928",2017-09-01 15:05:28,302794.7,13936221.59
"2995",2017-09-01 15:19:52,159181.79,14095403.38
"16929",2017-09-01 15:19:52,129085.79,14224489.17
"2996",2017-09-01 15:23:27,177603.63,14402092.8
"2997",2017-09-01 15:23:27,-159181.79,14242911.01
"2998",2017-09-01 15:34:06,-177603.63,14065307.38
"2999",2017-09-01 15:46:43,143076.68,14208384.06
"16930",2017-09-01 15:46:43,189029.23,14397413.29
"16931",2017-09-01 15:46:43,294735.92,14692149.21
"3000",2017-09-01 15:54:12,-143076.68,14549072.53
"16932",2017-09-01 16:07:57,321075.52,14870148.05
"16933",2017-09-01 16:20:37,272806.9,15142954.95
"16934",2017-09-01 16:20:37,189029.29,15331984.24
"16935",2017-09-01 16:20:37,170740.3,15502724.54
"16936",2017-09-01 16:20:37,-14870148.05,632576.489999991
"16937",2017-09-01 16:25:26,-632576.49,-9.08039510250092e-09
"3001",2017-09-01 16:47:08,189029.34,189029.339999991
"3002",2017-09-01 16:47:08,221266.34,410295.679999991
"16938",2017-09-01 16:47:08,189029.33,599325.009999991
"16939",2017-09-01 16:47:08,186983.73,786308.739999991
"16940",2017-09-01 16:47:08,286756.02,1073064.75999999
"3003",2017-09-01 16:52:13,-410295.68,662769.079999991
"16941",2017-09-01 16:52:13,-662769.08,-8.96397978067398e-09
"3004",2017-09-01 17:12:45,189029.38,189029.379999991
"3005",2017-09-01 17:12:45,14615.8,203645.179999991
"16942",2017-09-01 17:12:45,300141.37,503786.549999991
"16943",2017-09-01 17:12:45,201375.93,705162.479999991
"16944",2017-09-01 17:12:45,188314.31,893476.789999991
"3006",2017-09-01 17:14:41,-203645.18,689831.609999991
"16945",2017-09-01 17:27:43,144162.66,833994.269999991
"16946",2017-09-01 17:27:43,178640.24,1012634.50999999
"16947",2017-09-01 17:27:43,-689831.61,322802.899999991
"16948",2017-09-01 17:45:52,177918.42,500721.319999991
"16949",2017-09-01 17:45:52,300141.43,800862.749999991
"16950",2017-09-01 17:45:52,125642.99,926505.739999991
"16951",2017-09-01 17:45:52,-322802.9,603702.839999991
"3007",2017-09-01 18:18:14,150008.03,753710.869999991
"3008",2017-09-01 18:18:14,137820.74,891531.609999991
"3009",2017-09-01 18:18:14,253468.93,1145000.53999999
"16952",2017-09-01 18:18:14,253839.06,1398839.59999999
"16953",2017-09-01 18:18:14,117774.35,1516613.94999999
"16954",2017-09-01 18:18:14,157879.28,1674493.22999999
"16955",2017-09-01 18:18:14,-603702.84,1070790.38999999
"3010",2017-09-01 18:28:47,-541297.7,529492.689999991
"16956",2017-09-01 18:28:47,252888.69,782381.379999991
"16957",2017-09-01 18:28:47,-529492.69,252888.689999991
"16958",2017-09-01 18:32:32,300141.52,553030.209999991
"16959",2017-09-01 18:35:30,-553030.21,-8.61473381519318e-09
"3011",2017-09-01 18:36:49,300141.53,300141.529999991
"3012",2017-09-01 18:48:24,-300141.53,-8.61473381519318e-09
"16960",2017-09-01 19:02:42,300141.58,300141.579999991
"16961",2017-09-01 19:02:42,124459.26,424600.839999991
"16962",2017-09-01 19:02:42,328146.31,752747.149999991
"16963",2017-09-01 19:08:08,-752747.15,-8.61473381519318e-09
"16964",2017-09-01 19:24:34,116665.78,116665.779999991
"16965",2017-09-01 19:24:34,300141.62,416807.399999991
"3013",2017-09-01 19:43:38,175445.23,592252.629999991
"3014",2017-09-01 19:43:38,135006.11,727258.739999991
"16966",2017-09-01 19:43:38,188725.75,915984.489999991
"16967",2017-09-01 19:43:38,130199.52,1046184.00999999
"16968",2017-09-01 19:43:38,-416807.4,629376.609999991
"3015",2017-09-01 20:06:08,132135.17,761511.779999991
"3016",2017-09-01 20:06:08,189029.72,950541.499999991
"3017",2017-09-01 20:06:08,-310451.34,640090.159999991
"16969",2017-09-01 20:06:08,142825.43,782915.589999991
"16970",2017-09-01 20:06:08,189398.13,972313.719999991
"3018",2017-09-01 20:21:15,-321164.89,651148.829999991
"16971",2017-09-01 20:21:15,-651148.83,-8.73114913702011e-09
"3019",2017-09-01 20:26:31,200141.73,200141.729999991
"16972",2017-09-01 20:26:31,200141.74,400283.469999991
"3020",2017-09-01 20:30:01,-200141.73,200141.739999991
"16973",2017-09-01 20:30:01,-200141.74,-8.76025296747684e-09
"16974",2017-09-01 20:30:01,125374.62,125374.619999991
"16975",2017-09-01 20:33:33,300141.76,425516.379999991
"16976",2017-09-01 20:33:33,-125374.62,300141.759999991
"3021",2017-09-01 20:42:00,169981.78,470123.539999991
"16977",2017-09-01 20:42:00,-300141.76,169981.779999991
"3022",2017-09-01 20:49:23,-169981.78,-8.70204530656338e-09
"16978",2017-09-01 20:49:23,293189.24,293189.239999991
"16979",2017-09-01 20:49:23,113127.16,406316.399999991
"3023",2017-09-01 20:51:38,132381.17,538697.569999991
"3024",2017-09-01 20:55:44,-132381.17,406316.399999991
"16980",2017-09-01 20:55:44,-406316.4,-8.73114913702011e-09
"16981",2017-09-01 21:05:26,151257.64,151257.639999991
"16982",2017-09-01 21:05:26,200141.83,351399.469999991
"16983",2017-09-01 21:05:26,146332.12,497731.589999991
"16984",2017-09-01 21:18:26,-497731.59,-8.78935679793358e-09
"16985",2017-09-01 21:30:12,217034.3,217034.299999991
"16986",2017-09-01 21:30:12,131723.57,348757.869999991
"16987",2017-09-01 21:34:08,-348757.87,-8.78935679793358e-09
"16988",2017-09-01 21:48:08,300141.86,300141.859999991
"16989",2017-09-01 21:53:23,-300141.86,-8.78935679793358e-09
"3025",2017-09-01 22:06:21,110273.19,110273.189999991
"16990",2017-09-01 22:06:21,200141.88,310415.069999991
"3026",2017-09-01 22:10:58,-110273.19,200141.879999991
"16991",2017-09-01 22:10:58,-200141.88,-8.78935679793358e-09
"16992",2017-09-01 23:25:11,247418.68,247418.679999991
"3027",2017-09-01 23:36:36,152402.3,399820.979999991
"16993",2017-09-01 23:36:36,-247418.68,152402.299999991
"3028",2017-09-01 23:41:15,-152402.3,-8.78935679793358e-09
"16994",2017-09-01 23:41:15,117732.68,117732.679999991
"16995",2017-09-01 23:52:27,149119.74,266852.419999991
"16996",2017-09-01 23:52:27,-117732.68,149119.739999991
"3029",2017-09-01 23:56:33,116655.2,265774.939999991
"16997",2017-09-01 23:56:33,-149119.74,116655.199999991
"3030",2017-09-02 00:02:18,-116655.2,-8.77480488270521e-09
"16998",2017-09-02 00:03:34,278726.7,278726.699999991
"3031",2017-09-02 00:14:40,110035.25,388761.949999991
"16999",2017-09-02 00:14:40,-278726.7,110035.249999991
"3032",2017-09-02 00:22:31,-110035.25,-8.78935679793358e-09
"17000",2017-09-02 00:22:31,111490.33,111490.329999991
"17001",2017-09-02 00:35:55,129858.28,241348.609999991
"17002",2017-09-02 00:35:55,-111490.33,129858.279999991
"17003",2017-09-02 00:44:01,-129858.28,-8.80390871316195e-09
"3033",2017-09-02 01:06:23,130543.97,130543.969999991
"3034",2017-09-02 01:09:40,-130543.97,-8.80390871316195e-09
"17004",2017-09-02 01:09:40,119815.6,119815.599999991
"17005",2017-09-02 01:15:11,-119815.6,-8.80390871316195e-09
"3035",2017-09-02 02:16:47,150142.08,150142.079999991
"3036",2017-09-02 02:16:47,186968.87,337110.949999991
"3037",2017-09-02 02:16:47,272495.78,609606.729999991
"17006",2017-09-02 02:16:47,150142.07,759748.799999991
"17007",2017-09-02 02:16:47,126626.14,886374.939999991
"17008",2017-09-02 02:16:47,257281.15,1143656.08999999
"3038",2017-09-02 02:19:03,174587.52,1318243.60999999
"3039",2017-09-02 02:27:35,-609606.73,708636.879999991
"17009",2017-09-02 02:27:35,284769.89,993406.769999991
"17010",2017-09-02 02:27:35,-534049.36,459357.409999991
"17011",2017-09-02 02:30:45,-284769.89,174587.519999991
"3040",2017-09-02 02:33:35,-174587.52,-8.70204530656338e-09
"17012",2017-09-02 02:33:35,145682.47,145682.469999991
"17013",2017-09-02 02:47:56,218252.5,363934.969999991
"17014",2017-09-02 02:47:56,134987.63,498922.599999991
"17015",2017-09-02 02:47:56,130313.21,629235.809999991
"17016",2017-09-02 02:47:56,-145682.47,483553.339999991
"17017",2017-09-02 02:47:56,15344.57,498897.909999991
"3041",2017-09-02 02:53:29,193189.03,692086.939999991
"17018",2017-09-02 02:53:29,-498897.91,193189.029999991
"3042",2017-09-02 03:01:50,317302.54,510491.569999991
"3043",2017-09-02 03:01:50,-193189.03,317302.539999991
"17019",2017-09-02 03:01:50,259068.95,576371.489999991
"3044",2017-09-02 03:13:38,-317302.54,259068.949999991
"17020",2017-09-02 03:13:38,113863.92,372932.869999991
"17021",2017-09-02 03:13:38,-259068.95,113863.919999991
"17022",2017-09-02 03:19:48,328419.75,442283.669999991
"17023",2017-09-02 03:19:48,-113863.92,328419.749999991
"17024",2017-09-02 03:19:48,-113863.92,214555.829999991
"3045",2017-09-02 03:26:46,267399.72,481955.549999991
"17025",2017-09-02 03:26:46,-214555.83,267399.719999991
"3046",2017-09-02 03:34:24,271054.63,538454.349999991
"3047",2017-09-02 03:34:24,-267399.72,271054.629999991
"17026",2017-09-02 03:34:24,164188.83,435243.459999991
"3048",2017-09-02 03:40:27,-271054.63,164188.829999991
"17027",2017-09-02 03:40:27,141705.13,305893.959999991
"17028",2017-09-02 03:40:27,-164188.83,141705.129999991
"17029",2017-09-02 03:53:03,-141705.13,-8.64383764564991e-09
"17030",2017-09-02 04:30:22,50142.59,50142.5899999914
"17031",2017-09-02 04:32:58,-50142.59,-8.64383764564991e-09
"3049",2017-09-02 07:25:00,319724.26,319724.259999991
"3050",2017-09-02 07:25:00,230001.81,549726.069999991
"3051",2017-09-02 07:33:42,-549726.07,-8.49831849336624e-09
"3052",2017-09-02 07:58:51,206947.89,206947.889999992
"3053",2017-09-02 08:45:45,-206947.89,-8.49831849336624e-09
"17032",2017-09-02 09:02:39,441884.68,441884.679999991
"3054",2017-09-02 09:14:27,158009.92,599894.599999991
"3055",2017-09-02 09:14:27,188967.93,788862.529999991
"17033",2017-09-02 09:14:27,311250.77,1100113.29999999
"17034",2017-09-02 09:14:27,198941.21,1299054.50999999
"3056",2017-09-02 09:23:39,-346977.85,952076.659999991
"17035",2017-09-02 10:08:28,180897.05,1132973.70999999
"3057",2017-09-02 10:39:01,98521.53,1231495.23999999
"3058",2017-09-02 10:50:05,298459.85,1529955.08999999
"3059",2017-09-02 10:50:05,-98521.53,1431433.55999999
"17036",2017-09-02 10:50:05,136995.65,1568429.20999999
"3060",2017-09-02 11:00:08,-298459.85,1269969.35999999
"17037",2017-09-02 11:47:04,183221.53,1453190.88999999
"3061",2017-09-02 12:07:24,143314.75,1596505.63999999
"3062",2017-09-02 12:42:00,206769.76,1803275.39999999
"3063",2017-09-02 12:42:00,166247.28,1969522.67999999
"3064",2017-09-02 13:07:09,-143314.75,1826207.92999999
"3065",2017-09-02 13:11:20,-373017.04,1453190.88999999
"3066",2017-09-02 13:30:32,281938.97,1735129.85999999
"17038",2017-09-02 13:30:32,13004,1748133.85999999
"3067",2017-09-02 13:56:40,-281938.97,1466194.88999999
"17039",2017-09-02 13:56:40,191034.68,1657229.56999999
"3068",2017-09-02 14:32:37,146472.15,1803701.71999999
"17040",2017-09-02 14:32:37,145944.26,1949645.97999999
"3069",2017-09-02 14:46:05,-146472.15,1803173.82999999
"17041",2017-09-02 14:46:05,323745.34,2126919.16999999
"3070",2017-09-02 14:54:27,282951.72,2409870.88999999
"17042",2017-09-02 14:54:27,280489.79,2690360.67999999
"3071",2017-09-02 15:03:29,161022.65,2851383.32999999
"3072",2017-09-02 15:03:29,-282951.72,2568431.60999999
"3073",2017-09-02 15:24:10,-161022.65,2407408.95999999
"3074",2017-09-02 16:17:00,558544.83,2965953.78999999
"17043",2017-09-02 16:17:00,139898.58,3105852.36999999
"17044",2017-09-02 16:17:00,348876.14,3454728.50999999
"3075",2017-09-02 16:34:50,-558544.83,2896183.67999999
"17045",2017-09-02 16:34:50,50144.72,2946328.39999999
"3076",2017-09-02 16:41:02,177921.99,3124250.38999999
"17046",2017-09-02 16:41:02,187378.87,3311629.25999999
"17047",2017-09-02 16:41:02,300144.98,3611774.23999999
"3077",2017-09-02 17:08:49,263429.99,3875204.22999999
"3078",2017-09-02 17:08:49,-177921.99,3697282.23999999
"17048",2017-09-02 17:08:49,193511.07,3890793.30999999
"3079",2017-09-02 17:13:49,-263429.99,3627363.31999999
"17049",2017-09-02 17:13:49,405051.66,4032414.97999999
"3080",2017-09-02 17:29:51,140191.34,4172606.31999999
"17050",2017-09-02 17:32:13,129430.78,4302037.09999999
"3081",2017-09-02 17:38:15,-140191.34,4161845.75999999
"3082",2017-09-02 17:55:19,188730.21,4350575.96999999
"17051",2017-09-02 17:55:19,324462.77,4675038.73999999
"3083",2017-09-02 18:00:18,-188730.21,4486308.52999999
"3084",2017-09-02 18:04:47,287698.44,4774006.96999999
"3085",2017-09-02 18:13:42,-287698.44,4486308.52999999
"17052",2017-09-02 18:13:42,150821.89,4637130.41999999
"17053",2017-09-02 18:27:45,136201.54,4773331.95999999
"17054",2017-09-02 18:34:20,233829.77,5007161.72999999
"3086",2017-09-02 18:55:48,210737.97,5217899.69999999
"3087",2017-09-02 18:55:48,100145.14,5318044.83999999
"17055",2017-09-02 18:55:48,100145.13,5418189.96999999
"3088",2017-09-02 19:01:51,-310883.11,5107306.85999999
"17056",2017-09-02 19:11:50,202173.28,5309480.13999999
"3089",2017-09-02 19:18:59,232696.81,5542176.94999999
"17057",2017-09-02 19:18:59,140703.26,5682880.20999999
"3090",2017-09-02 19:27:29,122623.92,5805504.12999999
"3091",2017-09-02 19:27:29,-232696.81,5572807.31999999
"3092",2017-09-02 19:37:26,170145.21,5742952.52999999
"3093",2017-09-02 19:37:26,-122623.92,5620328.60999999
"17058",2017-09-02 19:37:26,300145.2,5920473.80999999
"3094",2017-09-02 19:41:28,-170145.21,5750328.59999999
"3095",2017-09-02 20:33:40,300145.24,6050473.83999999
"3096",2017-09-02 20:48:23,-300145.24,5750328.59999999
"3097",2017-09-02 21:06:14,373687.48,6124016.07999999
"3098",2017-09-02 21:11:12,-373687.48,5750328.59999999
"3099",2017-09-02 21:19:30,177922.26,5928250.85999999
"17059",2017-09-02 21:19:30,630682.83,6558933.68999999
"3100",2017-09-02 21:25:40,149098.58,6708032.26999999
"3101",2017-09-02 21:25:40,-177922.26,6530110.00999999
"3102",2017-09-02 21:42:36,177922.29,6708032.29999999
"3103",2017-09-02 21:42:36,214440.71,6922473.00999999
"3104",2017-09-02 21:42:36,-149098.58,6773374.42999999
"3105",2017-09-02 22:11:33,300145.3,7073519.72999999
"3106",2017-09-02 22:11:33,-392363,6681156.72999999
"17060",2017-09-02 22:19:27,132686.13,6813842.85999999
"3107",2017-09-02 22:28:03,265486.29,7079329.14999999
"3108",2017-09-02 22:28:03,-300145.3,6779183.84999999
"17061",2017-09-02 22:28:03,162926.93,6942110.77999999
"3109",2017-09-02 22:44:35,389033.34,7331144.11999999
"3110",2017-09-02 22:44:35,-265486.29,7065657.82999999
"3111",2017-09-02 22:50:01,300145.36,7365803.18999999
"3112",2017-09-02 22:50:01,-389033.34,6976769.84999999
"17062",2017-09-02 22:50:01,148032.88,7124802.72999999
"3113",2017-09-02 23:02:35,-300145.36,6824657.36999999
"17063",2017-09-02 23:06:06,165555.23,6990212.59999999
"17064",2017-09-02 23:15:33,171443.96,7161656.55999999
"17065",2017-09-02 23:15:33,300145.39,7461801.94999999
"3114",2017-09-02 23:39:17,167557.32,7629359.26999999
"3115",2017-09-02 23:39:17,177922.4,7807281.66999999
"3116",2017-09-02 23:41:53,181250.6,7988532.26999999
"3117",2017-09-02 23:41:53,-345479.72,7643052.54999999
"3118",2017-09-03 00:02:31,-181250.6,7461801.94999999
"17066",2017-09-03 00:02:31,141199.91,7603001.85999999
"17067",2017-09-03 00:02:31,128940.88,7731942.73999999
"17068",2017-09-03 00:02:31,255836.41,7987779.14999999
"3119",2017-09-03 00:15:31,193995.71,8181774.85999999
"3120",2017-09-03 00:25:31,-193995.71,7987779.14999999
"3121",2017-09-03 00:48:11,177043.72,8164822.86999999
"17069",2017-09-03 00:48:11,461561.61,8626384.47999999
"3122",2017-09-03 01:02:28,131114.75,8757499.22999999
"3123",2017-09-03 01:02:28,121104.78,8878604.00999999
"3124",2017-09-03 01:02:28,-177043.72,8701560.28999999
"3125",2017-09-03 01:24:40,-252219.53,8449340.75999999
"3126",2017-09-03 01:48:38,263744.84,8713085.59999999
"3127",2017-09-03 01:57:58,-263744.84,8449340.75999999
"3128",2017-09-03 02:42:42,197255.11,8646595.86999999
"3129",2017-09-03 02:48:36,-197255.11,8449340.75999999
"3130",2017-09-03 03:11:07,183145.56,8632486.31999999
"3131",2017-09-03 03:20:01,-183145.56,8449340.75999999
"17070",2017-09-03 03:50:16,132083.13,8581423.88999999
"17071",2017-09-03 05:02:05,144662.2,8726086.08999999
"3132",2017-09-03 06:00:19,217720.44,8943806.52999999
"3133",2017-09-03 06:14:37,-217720.44,8726086.08999999
"3134",2017-09-03 06:25:52,300145.99,9026232.07999999
"3135",2017-09-03 06:33:17,-300145.99,8726086.08999999
"3136",2017-09-03 06:47:52,89034,8815120.08999999
"3137",2017-09-03 06:59:28,-89034,8726086.08999999
"3138",2017-09-03 07:07:45,377923.06,9104009.14999999
"3139",2017-09-03 07:07:45,290673.14,9394682.28999999
"3140",2017-09-03 07:14:33,-668596.2,8726086.08999999
"3141",2017-09-03 07:18:19,233890.97,8959977.05999999
"3142",2017-09-03 07:28:26,-233890.97,8726086.08999999
"17072",2017-09-03 07:39:14,203346.26,8929432.34999999
"3143",2017-09-03 08:06:25,205145.55,9134577.89999999
"3144",2017-09-03 08:21:31,-205145.55,8929432.34999999
"3145",2017-09-03 08:47:42,149349.15,9078781.49999999
"3146",2017-09-03 09:11:43,150099.2,9228880.69999999
"3147",2017-09-03 09:11:43,-149349.15,9079531.54999999
"3148",2017-09-03 09:17:30,-150099.2,8929432.34999999
"3149",2017-09-03 10:19:37,300146.18,9229578.52999999
"3150",2017-09-03 10:25:16,138420.6,9367999.12999999
"3151",2017-09-03 10:25:16,-300146.18,9067852.94999999
"3152",2017-09-03 10:31:15,-138420.6,8929432.34999999
"3153",2017-09-03 10:52:27,138765,9068197.34999999
"3154",2017-09-03 10:52:27,166120.53,9234317.87999999
"3155",2017-09-03 10:52:27,200146.22,9434464.09999999
"3156",2017-09-03 11:04:45,100146.23,9534610.32999999
"3157",2017-09-03 11:04:45,-505031.75,9029578.57999999
"17073",2017-09-03 11:04:45,123762.67,9153341.24999999
"3158",2017-09-03 11:19:05,-100146.23,9053195.01999999
"17074",2017-09-03 11:19:05,174798.48,9227993.49999999
"3159",2017-09-03 11:57:43,121513.73,9349507.22999999
"3160",2017-09-03 12:04:41,-121513.73,9227993.49999999
"3161",2017-09-03 12:15:25,138201.36,9366194.85999999
"3162",2017-09-03 12:21:18,309943.52,9676138.37999999
"3163",2017-09-03 12:21:18,-138201.36,9537937.01999999
"3164",2017-09-03 12:34:31,125257.73,9663194.74999999
"3165",2017-09-03 12:34:31,-309943.52,9353251.22999999
"17075",2017-09-03 12:34:31,180467.42,9533718.64999999
"3166",2017-09-03 12:55:27,-125257.73,9408460.91999999
"17076",2017-09-03 13:35:01,119437.58,9527898.49999999
"17077",2017-09-03 13:42:12,202941.4,9730839.89999999
"3167",2017-09-03 14:40:21,189034.42,9919874.31999999
"3168",2017-09-03 14:40:21,77517.43,9997391.74999999
"3169",2017-09-03 14:40:21,153511.19,10150902.94
"3170",2017-09-03 14:40:21,128983.9,10279886.84
"3171",2017-09-03 14:52:49,177923.41,10457810.25
"3172",2017-09-03 15:10:51,37923.44,10495733.69
"17078",2017-09-03 15:10:51,159724.29,10655457.98
"17079",2017-09-03 15:20:28,195645.42,10851103.4
"17080",2017-09-03 17:20:37,149370.53,11000473.93
"17081",2017-09-03 17:20:37,122119.28,11122593.21
"17082",2017-09-03 17:31:05,148942.55,11271535.76
"17083",2017-09-03 18:25:13,181301.26,11452837.02
"17084",2017-09-03 18:25:13,249698.88,11702535.9
"17085",2017-09-03 18:25:13,180424.73,11882960.63
"17086",2017-09-03 18:43:01,121928.14,12004888.77
"3173",2017-09-03 18:59:13,-764893.79,11239994.98
"17087",2017-09-03 19:45:19,209853.14,11449848.12
"17088",2017-09-03 22:01:17,164874.46,11614722.58
"17089",2017-09-03 22:01:17,204215.25,11818937.83
"3174",2017-09-04 02:31:46,254530.47,12073468.3
"3175",2017-09-04 02:36:36,-254530.47,11818937.83
"3176",2017-09-04 03:12:57,153322.67,11972260.5
"3177",2017-09-04 03:21:36,-153322.67,11818937.83
"17090",2017-09-04 03:48:00,184112.12,12003049.95
"3178",2017-09-04 03:49:53,179601.52,12182651.47
"17091",2017-09-04 04:27:59,161394.28,12344045.75
"17092",2017-09-04 05:03:04,158962.74,12503008.49
"17093",2017-09-04 05:51:58,173410.86,12676419.35
"17094",2017-09-04 07:59:22,173566.45,12849985.8
"17095",2017-09-04 08:07:40,143808.56,12993794.36
"3179",2017-09-04 08:21:25,-179601.52,12814192.84
"17096",2017-09-04 08:37:21,510952.24,13325145.08
"17097",2017-09-04 10:08:49,280727.51,13605872.59
"17098",2017-09-04 10:08:49,324994.29,13930866.88
"3180",2017-09-04 10:21:18,200148.65,14131015.53
"3181",2017-09-04 10:33:45,-200148.65,13930866.88
"3182",2017-09-04 11:27:54,75677.52,14006544.4
"3183",2017-09-04 11:29:01,100148.69,14106693.09
"3184",2017-09-04 11:43:52,300148.7,14406841.79
"3185",2017-09-04 11:43:52,-175826.21,14231015.58
"3186",2017-09-04 11:51:04,-300148.7,13930866.88
"3187",2017-09-04 12:07:25,112680.06,14043546.94
"3188",2017-09-04 12:38:07,107454.51,14151001.45
"3189",2017-09-04 12:38:07,200148.74,14351150.19
"3190",2017-09-04 12:38:07,107905.93,14459056.12
"3191",2017-09-04 12:50:54,300148.75,14759204.87
"17099",2017-09-04 12:50:54,7925.76,14767130.63
"3192",2017-09-04 13:03:22,-112680.06,14654450.57
"3193",2017-09-04 13:33:06,-715657.93,13938792.64
"3194",2017-09-04 13:53:35,209111.56,14147904.2
"3195",2017-09-04 13:53:35,115489.09,14263393.29
"3196",2017-09-04 13:56:10,130544.01,14393937.3
"3197",2017-09-04 14:15:29,146992.15,14540929.45
"3198",2017-09-04 14:15:29,-324600.65,14216328.8
"3199",2017-09-04 14:19:59,150148.82,14366477.62
"17100",2017-09-04 14:19:59,300148.81,14666626.43
"3200",2017-09-04 14:24:35,-277536.16,14389090.27
"3201",2017-09-04 14:29:00,300148.83,14689239.1
"3202",2017-09-04 14:44:44,300148.84,14989387.94
"3203",2017-09-04 14:44:44,-150148.82,14839239.12
"17101",2017-09-04 14:49:22,300148.85,15139387.97
"3204",2017-09-04 15:04:31,-600297.67,14539090.3
"3205",2017-09-04 15:46:18,300148.87,14839239.17
"3206",2017-09-04 15:46:18,377925.88,15217165.05
"17102",2017-09-04 15:46:18,300148.89,15517313.94
"17103",2017-09-04 15:46:18,300148.86,15817462.8
"3207",2017-09-04 15:52:39,199121.77,16016584.57
"3208",2017-09-04 15:55:25,-678074.75,15338509.82
"17104",2017-09-04 15:55:25,-15139388.05,199121.769999985
"3209",2017-09-04 16:09:22,295968.46,495090.229999985
"3210",2017-09-04 16:09:22,-199121.77,295968.459999985
"3211",2017-09-04 16:26:15,700148.91,996117.369999985
"3212",2017-09-04 16:26:15,-295968.46,700148.909999985
"17105",2017-09-04 16:26:15,200148.92,900297.829999985
"3213",2017-09-04 16:55:16,377925.95,1278223.77999998
"17106",2017-09-04 16:55:16,377925.93,1656149.70999998
"17107",2017-09-04 16:55:16,500148.94,2156298.64999999
"17108",2017-09-04 16:55:16,-200148.92,1956149.72999999
"17109",2017-09-04 16:55:16,-200148.92,1756000.80999999
"3214",2017-09-04 17:05:22,-700148.91,1055851.89999999
"17110",2017-09-04 17:05:22,-677925.95,377925.949999985
"3215",2017-09-04 17:20:09,-377925.95,-1.49593688547611e-08
"17111",2017-09-04 17:20:09,500148.96,500148.959999985
"17112",2017-09-04 17:20:09,149998,650146.959999985
"3216",2017-09-04 17:34:26,492220.41,1142367.36999998
"3217",2017-09-04 17:34:26,700148.98,1842516.34999998
"17113",2017-09-04 17:34:26,200148.99,2042665.33999998
"17114",2017-09-04 17:34:26,-650146.96,1392518.37999998
"3218",2017-09-04 17:45:16,-1192369.39,200148.989999985
"17115",2017-09-04 17:51:34,700149,900297.989999985
"17116",2017-09-04 17:51:34,-200148.99,700148.999999985
"17117",2017-09-04 17:58:12,-700149,-1.49011611938477e-08
"3219",2017-09-04 18:02:11,500149.02,500149.019999985
"17118",2017-09-04 18:02:11,500149.01,1000298.02999999
"3220",2017-09-04 18:28:24,250479.12,1250777.14999999
"3221",2017-09-04 18:28:24,247182.3,1497959.44999999
"3222",2017-09-04 18:28:24,77926.07,1575885.51999999
"17119",2017-09-04 18:28:24,77926.08,1653811.59999999
"17120",2017-09-04 18:28:24,77926.06,1731737.65999999
"17121",2017-09-04 18:28:24,-500149.01,1231588.64999999
"3223",2017-09-04 18:31:37,-500149.02,731439.629999985
"17122",2017-09-04 18:31:37,-155852.14,575587.489999985
"3224",2017-09-04 18:37:20,-575587.49,-1.47847458720207e-08
"17123",2017-09-04 18:44:13,778037.12,778037.119999985
"3225",2017-09-04 18:52:14,180856.13,958893.249999985
"17124",2017-09-04 18:52:14,-778037.12,180856.129999985
"3226",2017-09-04 19:01:58,252359.33,433215.459999985
"3227",2017-09-04 19:01:58,-180856.13,252359.329999985
"3228",2017-09-04 19:16:44,286569.23,538928.559999985
"3229",2017-09-04 19:16:44,258051.83,796980.389999985
"3230",2017-09-04 19:16:44,-252359.33,544621.059999985
"3231",2017-09-04 19:25:31,200149.11,744770.169999985
"3232",2017-09-04 19:25:31,-544621.06,200149.109999985
"17125",2017-09-04 19:25:31,700149.17,900298.279999985
"3233",2017-09-04 19:32:32,-200149.11,700149.169999985
"17126",2017-09-04 19:32:32,-700149.17,-1.49011611938477e-08
"17127",2017-09-04 19:40:22,500149.18,500149.179999985
"17128",2017-09-04 19:52:50,-500149.18,-1.49011611938477e-08
"3234",2017-09-04 20:19:05,777926.24,777926.239999985
"3235",2017-09-04 20:19:05,434045.87,1211972.10999998
"17129",2017-09-04 20:19:05,273383.41,1485355.51999998
"3236",2017-09-04 20:23:27,-1211972.11,273383.409999985
"17130",2017-09-04 20:23:27,-273383.41,-1.5192199498415e-08
"17131",2017-09-04 20:43:35,485436.43,485436.429999985
"17132",2017-09-04 20:48:46,-485436.43,-1.5192199498415e-08
"3237",2017-09-04 21:00:23,351114.55,351114.549999985
"3238",2017-09-04 21:02:24,-351114.55,-1.5192199498415e-08
"17133",2017-09-04 21:24:14,243206.17,243206.169999985
"3239",2017-09-04 21:48:37,293559.84,536766.009999985
"17134",2017-09-04 21:48:37,-243206.17,293559.839999985
"3240",2017-09-04 21:54:32,-293559.84,-1.5192199498415e-08
"3241",2017-09-04 22:41:12,166617.23,166617.229999985
"3242",2017-09-04 22:41:12,153166.05,319783.279999985
"3243",2017-09-04 23:03:41,-319783.28,-1.52504071593285e-08
"3244",2017-09-04 23:27:46,232493.63,232493.629999985
"3245",2017-09-04 23:34:29,188612.38,421106.009999985
"3246",2017-09-04 23:34:29,-232493.63,188612.379999985
"3247",2017-09-04 23:59:30,153150.43,341762.809999985
"3248",2017-09-04 23:59:30,-188612.38,153150.429999985
"3249",2017-09-05 00:15:59,184646.65,337797.079999985
"3250",2017-09-05 00:15:59,-153150.43,184646.649999985
"3251",2017-09-05 00:39:06,256154.39,440801.039999985
"3252",2017-09-05 00:39:06,-184646.65,256154.389999985
"17135",2017-09-05 00:39:06,193002.95,449157.339999985
"3253",2017-09-05 00:43:57,-256154.39,193002.949999985
"17136",2017-09-05 00:43:57,-193002.95,-1.53086148202419e-08
"3254",2017-09-05 01:07:41,187243.55,187243.549999985
"3255",2017-09-05 01:21:59,-187243.55,-1.53086148202419e-08
"17137",2017-09-05 01:21:59,306670.43,306670.429999985
"3256",2017-09-05 01:40:56,288137.85,594808.279999985
"17138",2017-09-05 01:40:56,203166.72,797974.999999985
"17139",2017-09-05 01:40:56,-306670.43,491304.569999985
"3257",2017-09-05 01:46:24,-288137.85,203166.719999985
"17140",2017-09-05 01:46:24,-203166.72,-1.53377186506987e-08
"3258",2017-09-05 01:52:16,181682.45,181682.449999985
"3259",2017-09-05 01:57:14,-181682.45,-1.53377186506987e-08
"3260",2017-09-05 01:59:14,170002.32,170002.319999985
"17141",2017-09-05 02:44:00,14084.95,184087.269999985
"3261",2017-09-05 02:46:05,-170002.32,14084.9499999847
"17142",2017-09-05 02:58:11,-14084.95,-1.53268047142774e-08
"3262",2017-09-05 03:07:52,218755.46,218755.459999985
"3263",2017-09-05 03:34:22,50150.28,268905.739999985
"3264",2017-09-05 03:34:22,-218755.46,50150.2799999846
"17143",2017-09-05 03:34:22,77927.22,128077.499999985
"3265",2017-09-05 03:52:10,-50150.28,77927.2199999846
"17144",2017-09-05 03:52:10,-77927.22,-1.53668224811554e-08
"17145",2017-09-05 05:47:35,77927.39,77927.3899999846
"17146",2017-09-05 06:04:02,-77927.39,-1.53668224811554e-08
"3266",2017-09-05 07:00:46,689389.15,689389.149999985
"17147",2017-09-05 07:00:46,380086.43,1069475.57999998
"3267",2017-09-05 07:22:45,-689389.15,380086.429999985
"17148",2017-09-05 07:22:45,154885.11,534971.539999985
"17149",2017-09-05 07:22:45,-380086.43,154885.109999985
"17150",2017-09-05 07:30:06,224432.66,379317.769999985
"17151",2017-09-05 08:03:33,173401.85,552719.619999985
"17152",2017-09-05 08:03:33,-379317.77,173401.849999985
"17153",2017-09-05 08:07:12,-173401.85,-1.53959263116121e-08
"3268",2017-09-05 08:18:12,151299.86,151299.859999985
"3269",2017-09-05 08:18:12,77927.31,229227.169999985
"3270",2017-09-05 08:23:18,-229227.17,-1.54250301420689e-08
"3271",2017-09-05 08:31:48,339847.61,339847.609999985
"3272",2017-09-05 08:39:20,-339847.61,-1.54250301420689e-08
"3273",2017-09-05 09:00:00,229566.1,229566.099999985
"3274",2017-09-05 09:11:14,173981.06,403547.159999985
"3275",2017-09-05 09:11:14,-229566.1,173981.059999985
"17154",2017-09-05 09:11:14,235635.94,409616.999999985
"3276",2017-09-05 09:25:44,-173981.06,235635.939999985
"17155",2017-09-05 09:25:44,-235635.94,-1.54832378029823e-08
"3277",2017-09-05 09:40:20,335195.44,335195.439999985
"17156",2017-09-05 09:40:20,232899.75,568095.189999985
"17157",2017-09-05 09:45:57,-232899.75,335195.439999985
"3278",2017-09-05 10:02:17,-335195.44,-1.54250301420689e-08
"3279",2017-09-05 10:05:20,76418,76417.9999999846
"3280",2017-09-05 10:31:20,-76418,-1.54250301420689e-08
"3281",2017-09-05 11:05:41,163419.69,163419.689999985
"3282",2017-09-05 11:05:41,202717.29,366136.979999985
"3283",2017-09-05 11:14:24,-366136.98,-1.53668224811554e-08
"3284",2017-09-05 11:40:12,175080.48,175080.479999985
"3285",2017-09-05 11:49:51,167784.54,342865.019999985
"3286",2017-09-05 11:50:37,-175080.48,167784.539999985
"3287",2017-09-05 11:57:01,-167784.54,-1.53668224811554e-08
"3288",2017-09-05 13:01:23,202742.42,202742.419999985
"3289",2017-09-05 13:07:09,374905.28,577647.699999985
"3290",2017-09-05 13:07:09,-202742.42,374905.279999985
"3291",2017-09-05 13:13:42,-374905.28,-1.53668224811554e-08
"3292",2017-09-05 14:29:59,273779.02,273779.019999985
"17158",2017-09-05 14:29:59,305408.89,579187.909999985
"3293",2017-09-05 14:38:11,-273779.02,305408.889999985
"17159",2017-09-05 14:38:11,151964.61,457373.499999985
"17160",2017-09-05 14:38:11,-305408.89,151964.609999985
"17161",2017-09-05 14:41:23,264525.58,416490.189999985
"17162",2017-09-05 14:41:23,-151964.61,264525.579999985
"3294",2017-09-05 15:28:10,188482.28,453007.859999985
"17163",2017-09-05 15:28:10,288439.38,741447.239999985
"17164",2017-09-05 15:28:10,190156.48,931603.719999985
"17165",2017-09-05 15:28:10,237548.19,1169151.90999998
"17166",2017-09-05 15:28:10,-264525.58,904626.329999984
"3295",2017-09-05 15:39:10,157423.75,1062050.07999998
"17167",2017-09-05 15:39:10,-716144.05,345906.029999984
"3296",2017-09-05 15:41:33,180573.75,526479.779999984
"3297",2017-09-05 15:41:33,-188482.28,337997.499999984
"3298",2017-09-05 15:51:58,300152.9,638150.399999984
"3299",2017-09-05 15:51:58,-337997.5,300152.899999984
"3300",2017-09-05 15:57:28,-300152.9,-1.55996531248093e-08
"3301",2017-09-05 16:09:23,14437.28,14437.2799999844
"3302",2017-09-05 16:12:30,-14437.28,-1.55996531248093e-08
"3303",2017-09-05 16:31:50,575073.58,575073.579999984
"3304",2017-09-05 16:36:58,-575073.58,-1.55996531248093e-08
"17168",2017-09-05 17:25:28,195573.28,195573.279999984
"17169",2017-09-05 17:25:28,187985.13,383558.409999984
"17170",2017-09-05 17:25:28,177136.2,560694.609999985
"3305",2017-09-05 17:28:01,392512.42,953207.029999984
"3306",2017-09-05 17:33:20,-392512.42,560694.609999985
"17171",2017-09-05 17:33:20,-560694.61,-1.54832378029823e-08
"3307",2017-09-05 18:12:05,212356.68,212356.679999985
"3308",2017-09-05 18:19:05,-212356.68,-1.54832378029823e-08
"17172",2017-09-05 19:52:41,297603.09,297603.089999985
"17173",2017-09-05 20:15:06,-297603.09,-1.54832378029823e-08
"3309",2017-09-05 21:58:23,161715.77,161715.769999985
"3310",2017-09-05 22:05:06,157175.9,318891.669999985
"3311",2017-09-05 22:05:06,-161715.77,157175.899999985
"3312",2017-09-05 22:07:18,272239.65,429415.549999985
"3313",2017-09-05 22:16:58,-429415.55,-1.54250301420689e-08
"17174",2017-09-05 22:44:07,169959.76,169959.759999985
"17175",2017-09-05 22:48:18,156843.44,326803.199999985
"17176",2017-09-05 22:48:18,-169959.76,156843.439999985
"17177",2017-09-05 22:59:38,286367.16,443210.599999985
"17178",2017-09-05 22:59:38,-156843.44,286367.159999985
"17179",2017-09-05 22:59:38,-156843.44,129523.719999985
"17180",2017-09-05 23:06:00,-129523.72,-1.54541339725256e-08
"17181",2017-09-05 23:15:43,163877.85,163877.849999985
"17182",2017-09-05 23:15:43,179234.22,343112.069999985
"17183",2017-09-05 23:20:03,-343112.07,-1.54250301420689e-08
"17184",2017-09-05 23:29:47,186416.43,186416.429999985
"17185",2017-09-05 23:54:12,-186416.43,-1.54250301420689e-08
"3314",2017-09-06 01:15:29,165535.63,165535.629999985
"17186",2017-09-06 01:15:29,215015.77,380551.399999985
"17187",2017-09-06 01:15:29,167587.47,548138.869999985
"3315",2017-09-06 01:28:50,-165535.63,382603.239999985
"17188",2017-09-06 01:28:50,-382603.24,-1.54832378029823e-08
"17189",2017-09-06 01:41:28,236174.65,236174.649999985
"17190",2017-09-06 01:54:56,-236174.65,-1.54832378029823e-08
"17191",2017-09-06 01:54:56,367011.37,367011.369999985
"17192",2017-09-06 02:04:19,-367011.37,-1.54832378029823e-08
"17193",2017-09-06 02:14:57,304830.45,304830.449999985
"17194",2017-09-06 04:19:49,238229.69,543060.139999985
"17195",2017-09-06 04:20:36,158327.95,701388.089999984
"3316",2017-09-06 04:50:20,196957.77,898345.859999985
"3317",2017-09-06 04:59:12,249400.85,1147746.70999998
"3318",2017-09-06 04:59:12,-196957.77,950788.939999985
"3319",2017-09-06 05:05:06,208449.54,1159238.47999998
"3320",2017-09-06 05:05:06,-249400.85,909837.629999985
"3321",2017-09-06 05:22:17,-208449.54,701388.089999985
"17196",2017-09-06 05:22:17,233912.34,935300.429999985
"3322",2017-09-06 05:45:00,187273.87,1122574.29999998
"3323",2017-09-06 05:52:31,-187273.87,935300.429999984
"17197",2017-09-06 07:09:14,146718.71,1082019.13999998
"17198",2017-09-06 07:22:14,150847.53,1232866.66999998
"17199",2017-09-06 07:45:51,171284.25,1404150.91999998
"17200",2017-09-06 08:02:15,163970.67,1568121.58999998
"17201",2017-09-06 08:05:53,151366.91,1719488.49999998
"17202",2017-09-06 08:27:19,153637.9,1873126.39999998
"17203",2017-09-06 09:13:27,146592.33,2019718.72999998
"3324",2017-09-06 10:33:06,200153.21,2219871.93999998
"3325",2017-09-06 10:40:53,-200153.21,2019718.72999998
"17204",2017-09-06 10:42:15,288455.81,2308174.53999998
"17205",2017-09-06 11:10:44,177467.61,2485642.14999998
"17206",2017-09-06 11:32:00,14406.1,2500048.24999998
"3326",2017-09-06 11:39:18,307947.68,2807995.92999998
"3327",2017-09-06 11:55:15,-307947.68,2500048.24999998
"17207",2017-09-06 12:24:51,174811.89,2674860.13999998
"3328",2017-09-06 13:38:50,275120.25,2949980.38999998
"17208",2017-09-06 13:38:50,310840.35,3260820.73999998
"3329",2017-09-06 13:45:21,-275120.25,2985700.48999998
"17209",2017-09-06 13:45:21,153321.87,3139022.35999998
"17210",2017-09-06 14:52:15,192576.06,3331598.41999999
"17211",2017-09-06 14:58:08,163160.87,3494759.28999999
"3330",2017-09-06 15:23:29,212702.43,3707461.71999999
"17212",2017-09-06 15:24:07,204400.84,3911862.55999999
"3331",2017-09-06 15:27:28,-212702.43,3699160.12999998
"3332",2017-09-06 16:02:40,206184.45,3905344.57999999
"3333",2017-09-06 16:02:40,191304.15,4096648.72999999
"17213",2017-09-06 16:02:40,174984.85,4271633.57999999
"17214",2017-09-06 16:02:40,401711,4673344.57999999
"3334",2017-09-06 16:06:09,-397488.6,4275855.97999999
"17215",2017-09-06 16:14:55,298653.93,4574509.90999999
"3335",2017-09-06 16:20:37,160359.36,4734869.26999999
"3336",2017-09-06 16:23:23,-160359.36,4574509.90999999
"17216",2017-09-06 16:32:21,212445.37,4786955.27999999
"17217",2017-09-06 16:32:21,172770.39,4959725.66999999
"17218",2017-09-06 17:01:58,168744.92,5128470.58999998
"17219",2017-09-06 17:31:28,225452.73,5353923.31999999
"17220",2017-09-06 17:31:28,159995.28,5513918.59999999
"17221",2017-09-06 18:09:13,248277.61,5762196.20999999
"17222",2017-09-06 18:36:44,202694.25,5964890.45999999
"17223",2017-09-06 18:59:21,186585.04,6151475.49999999
"17224",2017-09-06 19:04:51,155708.4,6307183.89999999
"17225",2017-09-06 19:26:15,195502.6,6502686.49999999
"3337",2017-09-06 20:41:48,160480.54,6663167.03999999
"3338",2017-09-06 20:53:52,17576.3,6680743.33999999
"3339",2017-09-06 20:53:52,-160480.54,6520262.79999999
"17226",2017-09-06 20:53:52,269289.18,6789551.97999999
"3340",2017-09-06 21:03:30,-17576.3,6771975.67999999
"3341",2017-09-06 21:12:43,181715.64,6953691.31999999
"3342",2017-09-06 21:27:33,-181715.64,6771975.67999999
"17227",2017-09-06 21:27:33,187212.48,6959188.15999999
"17228",2017-09-06 21:27:33,158288.5,7117476.65999999
"17229",2017-09-06 21:34:44,254509.23,7371985.88999999
"3343",2017-09-06 22:29:08,157375.06,7529360.94999999
"3344",2017-09-06 22:34:12,-157375.06,7371985.88999999
"17230",2017-09-06 22:53:56,314337.55,7686323.43999999
"3345",2017-09-06 23:01:49,186607.32,7872930.75999999
"17231",2017-09-06 23:01:49,191839.21,8064769.96999999
"17232",2017-09-06 23:54:55,175229.86,8239999.82999999
"3346",2017-09-06 23:56:20,-186607.32,8053392.50999999
"17233",2017-09-07 00:19:11,172502.6,8225895.10999999
"3347",2017-09-07 01:37:09,461196.95,8687092.05999999
"17234",2017-09-07 01:37:09,157277.98,8844370.03999999
"3348",2017-09-07 01:42:52,-461196.95,8383173.08999999
"17235",2017-09-07 01:42:52,205617.65,8588790.73999999
"3349",2017-09-07 01:44:57,197560.03,8786350.76999998
"3350",2017-09-07 01:55:34,318772.8,9105123.56999999
"3351",2017-09-07 01:55:34,-197560.03,8907563.53999999
"17236",2017-09-07 01:55:34,231751.95,9139315.48999999
"3352",2017-09-07 02:05:57,266953.71,9406269.19999999
"3353",2017-09-07 02:05:57,-318772.8,9087496.39999999
"17237",2017-09-07 02:05:57,150123.18,9237619.57999999
"3354",2017-09-07 02:10:59,-266953.71,8970665.86999998
"3355",2017-09-07 02:21:41,430321.81,9400987.67999998
"17238",2017-09-07 03:05:39,165862.21,9566849.88999999
"17239",2017-09-07 03:05:39,205582.93,9772432.81999999
"17240",2017-09-07 03:05:39,166740.18,9939172.99999999
"3356",2017-09-07 03:13:40,-430321.81,9508851.18999998
"3357",2017-09-07 03:43:46,208394.13,9717245.31999999
"3358",2017-09-07 03:53:07,-208394.13,9508851.18999998
"17241",2017-09-07 03:53:07,171723.07,9680574.25999998
"3359",2017-09-07 04:23:42,165401.16,9845975.41999999
"17242",2017-09-07 04:23:42,277660.04,10123635.46
"3360",2017-09-07 04:51:00,-165401.16,9958234.29999998
"17243",2017-09-07 04:51:00,239150.08,10197384.38
"3361",2017-09-07 07:06:41,183259.34,10380643.72
"3362",2017-09-07 07:14:21,-183259.34,10197384.38
"3363",2017-09-07 08:04:05,175012.09,10372396.47
"3364",2017-09-07 08:16:44,-175012.09,10197384.38
"17244",2017-09-07 08:46:27,208442.11,10405826.49
"17245",2017-09-07 09:11:06,198922.33,10604748.82
"17246",2017-09-07 09:21:05,179657.31,10784406.13
"17247",2017-09-07 09:52:50,77931.61,10862337.74
"17248",2017-09-07 09:52:50,295642.69,11157980.43
"17249",2017-09-07 10:07:09,310366.39,11468346.82
"3365",2017-09-07 11:02:18,173543.99,11641890.81
"3366",2017-09-07 11:16:50,-173543.99,11468346.82
"17250",2017-09-07 11:41:01,165881.99,11634228.81
"17251",2017-09-07 13:08:23,262545.56,11896774.37
"17252",2017-09-07 13:13:52,343738.36,12240512.73
"3367",2017-09-07 13:31:11,291443.47,12531956.2
"3368",2017-09-07 13:36:06,-291443.47,12240512.73
"17253",2017-09-07 16:46:01,-12240512.73,-1.67638063430786e-08
"3369",2017-09-07 17:18:24,244358.12,244358.119999983
"3370",2017-09-07 17:23:50,-244358.12,-1.67638063430786e-08
"3371",2017-09-07 19:42:07,247462.05,247462.049999983
"3372",2017-09-07 19:50:19,-247462.05,-1.67638063430786e-08
"17254",2017-09-07 20:43:33,295345.9,295345.899999983
"17255",2017-09-07 20:50:40,-295345.9,-1.67638063430786e-08
"17256",2017-09-07 22:08:02,150734.46,150734.459999983
"17257",2017-09-07 22:21:44,261051.99,411786.449999983
"17258",2017-09-07 22:21:44,-150734.46,261051.989999983
"3373",2017-09-07 22:37:39,154758.06,415810.049999983
"17259",2017-09-07 22:37:39,-261051.99,154758.059999983
"3374",2017-09-07 23:01:58,239463.78,394221.839999983
"3375",2017-09-07 23:01:58,-154758.06,239463.779999983
"3376",2017-09-07 23:07:45,-239463.78,-1.67929101735353e-08
"3377",2017-09-07 23:46:43,179853.03,179853.029999983
"3378",2017-09-07 23:52:21,-179853.03,-1.67929101735353e-08
"17260",2017-09-08 02:39:17,198751.53,198751.529999983
"3379",2017-09-08 07:00:23,170193.51,368945.039999983
"17261",2017-09-08 07:00:23,137857.46,506802.499999983
"3380",2017-09-08 07:22:45,-170193.51,336608.989999983
"3381",2017-09-08 07:46:55,145756.79,482365.779999983
"3382",2017-09-08 08:02:55,-145756.79,336608.989999983
"3383",2017-09-08 09:09:08,188680.33,525289.319999983
"17262",2017-09-08 09:09:08,206263.53,731552.849999983
"3384",2017-09-08 09:15:36,-188680.33,542872.519999983
"3385",2017-09-08 09:32:03,164463.56,707336.079999983
"3386",2017-09-08 10:00:23,-164463.56,542872.519999983
"17263",2017-09-08 10:03:22,150464.79,693337.309999983
"3387",2017-09-08 13:16:21,154251.31,847588.619999983
"3388",2017-09-08 13:20:35,-154251.31,693337.309999983
"3389",2017-09-08 13:58:41,260164.28,953501.589999983
"17264",2017-09-08 13:58:41,206260.76,1159762.34999998
"3390",2017-09-08 14:03:10,-260164.28,899598.069999983
"3391",2017-09-08 14:06:30,191786.59,1091384.65999998
"17265",2017-09-08 14:07:49,489735.14,1581119.79999998
"3392",2017-09-08 14:10:27,-191786.59,1389333.20999998
"3393",2017-09-08 14:13:47,216735.42,1606068.62999998
"3394",2017-09-08 14:24:32,211809.22,1817877.84999998
"3395",2017-09-08 14:24:32,163835.89,1981713.73999998
"3396",2017-09-08 14:24:32,-216735.42,1764978.31999998
"3397",2017-09-08 14:59:42,290566.93,2055545.24999998
"3398",2017-09-08 14:59:42,-375645.11,1679900.13999998
"17266",2017-09-08 14:59:42,214268.38,1894168.51999998
"17267",2017-09-08 14:59:42,265320.66,2159489.17999998
"17268",2017-09-08 14:59:42,15657.07,2175146.24999998
"3399",2017-09-08 15:11:34,-290566.93,1884579.31999998
"3400",2017-09-08 15:20:47,445092.47,2329671.78999998
"3401",2017-09-08 15:31:39,-445092.47,1884579.31999998
"17269",2017-09-08 15:31:39,598441.18,2483020.49999998
"3402",2017-09-08 15:50:59,264347.64,2747368.13999998
"3403",2017-09-08 15:56:24,-264347.64,2483020.49999998
"3404",2017-09-08 16:03:58,174298,2657318.49999998
"3405",2017-09-08 16:14:04,-174298,2483020.49999998
"17270",2017-09-08 16:14:04,450840.85,2933861.34999998
"17271",2017-09-08 16:41:05,150857.97,3084719.31999998
"17272",2017-09-08 16:41:05,153216.32,3237935.63999998
"3406",2017-09-08 17:03:31,433520.4,3671456.03999998
"17273",2017-09-08 17:03:31,231653.28,3903109.31999998
"17274",2017-09-08 17:06:38,254832.99,4157942.30999998
"3407",2017-09-08 17:14:55,138280.08,4296222.38999998
"3408",2017-09-08 17:14:55,-433520.4,3862701.98999998
"3409",2017-09-08 17:29:33,150155.69,4012857.67999998
"3410",2017-09-08 17:29:33,-138280.08,3874577.59999998
"17275",2017-09-08 17:29:33,150155.7,4024733.29999998
"3411",2017-09-08 17:44:53,141515.82,4166249.11999998
"3412",2017-09-08 17:44:53,-150155.69,4016093.42999998
"3413",2017-09-08 17:53:41,175793.01,4191886.43999998
"3414",2017-09-08 17:53:41,-141515.82,4050370.61999998
"17276",2017-09-08 17:53:41,449030.38,4499400.99999998
"3415",2017-09-08 18:14:01,224794.67,4724195.66999998
"3416",2017-09-08 18:14:01,-175793.01,4548402.65999998
"3417",2017-09-08 18:48:34,377932.79,4926335.44999998
"3418",2017-09-08 18:48:34,139682.24,5066017.68999998
"3419",2017-09-08 18:48:34,-224794.67,4841223.01999998
"17277",2017-09-08 18:48:34,414707.87,5255930.88999998
"17278",2017-09-08 18:48:34,211317.82,5467248.70999998
"17279",2017-09-08 18:48:34,50155.68,5517404.38999998
"17280",2017-09-08 18:54:03,-4999789.36,517615.029999983
"17281",2017-09-08 18:56:00,307809.07,825424.099999984
"3420",2017-09-08 19:16:31,555710.82,1381134.91999998
"3421",2017-09-08 19:16:31,-517615.03,863519.889999984
"17282",2017-09-08 19:16:31,218413.91,1081933.79999998
"17283",2017-09-08 19:16:31,-307809.07,774124.729999983
"17284",2017-09-08 19:35:22,389043.83,1163168.55999998
"17285",2017-09-08 19:35:22,-218413.91,944754.649999983
"3422",2017-09-08 19:40:18,-555710.82,389043.829999984
"17286",2017-09-08 19:40:18,-389043.83,-1.64727680385113e-08
"17287",2017-09-08 19:46:51,275277.99,275277.989999984
"3423",2017-09-08 19:57:07,555710.85,830988.839999984
"17288",2017-09-08 19:57:07,-275277.99,555710.849999984
"3424",2017-09-08 20:05:05,500155.86,1055866.70999998
"3425",2017-09-08 20:05:05,-555710.85,500155.859999984
"3426",2017-09-08 20:24:40,500155.89,1000311.74999998
"3427",2017-09-08 20:24:40,-500155.86,500155.889999984
"17289",2017-09-08 20:24:40,324634.88,824790.769999984
"17290",2017-09-08 20:24:40,274972.06,1099762.82999998
"3428",2017-09-08 20:30:49,-500155.89,599606.939999984
"17291",2017-09-08 20:30:49,-599606.94,-1.61817297339439e-08
"17292",2017-09-08 20:43:41,218192.37,218192.369999984
"3429",2017-09-08 20:47:28,500155.91,718348.279999984
"17293",2017-09-08 20:47:28,-218192.37,500155.909999984
"3430",2017-09-08 20:59:16,500155.92,1000311.82999998
"3431",2017-09-08 20:59:16,-500155.91,500155.919999984
"3432",2017-09-08 21:16:56,-500155.92,-1.61817297339439e-08
"17294",2017-09-08 21:16:56,185876.83,185876.829999984
"17295",2017-09-08 21:22:58,-185876.83,-1.61817297339439e-08
"3433",2017-09-08 21:39:14,240247.98,240247.979999984
"3434",2017-09-08 21:39:14,221159.78,461407.759999984
"3435",2017-09-08 21:39:14,140297.92,601705.679999984
"17296",2017-09-08 21:39:14,169519.17,771224.849999984
"3436",2017-09-08 21:47:00,-601705.68,169519.169999984
"17297",2017-09-08 21:47:00,-169519.17,-1.61526259034872e-08
"3437",2017-09-08 22:00:25,216325.2,216325.199999984
"3438",2017-09-08 22:03:33,270475.88,486801.079999984
"3439",2017-09-08 22:24:40,378943.03,865744.109999984
"3440",2017-09-08 22:24:40,-216325.2,649418.909999984
"17298",2017-09-08 22:24:40,201555.6,850974.509999984
"17299",2017-09-08 22:24:40,173186.91,1024161.41999998
"17300",2017-09-08 22:24:40,193036.35,1217197.76999998
"3441",2017-09-08 22:41:50,50156.05,1267353.81999998
"3442",2017-09-08 22:41:50,300156.06,1567509.87999998
"3443",2017-09-08 22:41:50,-649418.91,918090.969999984
"17301",2017-09-08 22:41:50,-567778.86,350312.109999984
"3444",2017-09-08 22:47:58,-350312.11,-1.59488990902901e-08
"17302",2017-09-08 22:57:36,176919.9,176919.899999984
"17303",2017-09-08 23:03:00,-176919.9,-1.59488990902901e-08
"17304",2017-09-08 23:03:00,375220.48,375220.479999984
"17305",2017-09-08 23:19:35,-375220.48,-1.59488990902901e-08
"3445",2017-09-08 23:37:36,366564.74,366564.739999984
"3446",2017-09-08 23:44:54,-366564.74,-1.59488990902901e-08
"3447",2017-09-08 23:54:10,500156.13,500156.129999984
"3448",2017-09-09 00:00:48,-500156.13,-1.59488990902901e-08
"3449",2017-09-09 00:19:50,164280.93,164280.929999984
"3450",2017-09-09 00:26:20,-164280.93,-1.59488990902901e-08
"3451",2017-09-09 00:57:07,500156.18,500156.179999984
"3452",2017-09-09 00:57:07,252298.72,752454.899999984
"3453",2017-09-09 01:20:01,-752454.9,-1.59488990902901e-08
"3454",2017-09-09 01:57:00,319922.39,319922.389999984
"3455",2017-09-09 01:58:47,174441.38,494363.769999984
"3456",2017-09-09 02:10:12,-319922.39,174441.379999984
"17306",2017-09-09 02:10:12,304878.64,479320.019999984
"3457",2017-09-09 02:18:23,172428.03,651748.049999984
"3458",2017-09-09 02:18:23,-174441.38,477306.669999984
"17307",2017-09-09 02:18:23,-304878.64,172428.029999984
"3459",2017-09-09 02:26:35,273902.56,446330.589999984
"3460",2017-09-09 02:26:35,-172428.03,273902.559999984
"3461",2017-09-09 02:43:55,-273902.56,-1.58906914293766e-08
"17308",2017-09-09 02:43:55,150774.35,150774.349999984
"17309",2017-09-09 02:43:55,153617.56,304391.909999984
"17310",2017-09-09 02:48:42,-304391.91,-1.58906914293766e-08
"3462",2017-09-09 03:04:10,189450.78,189450.779999984
"3463",2017-09-09 03:08:36,287649.17,477099.949999984
"3464",2017-09-09 03:24:24,-189450.78,287649.169999984
"17311",2017-09-09 03:24:24,150708.88,438358.049999984
"17312",2017-09-09 03:24:24,139628.7,577986.749999984
"3465",2017-09-09 03:40:01,-287649.17,290337.579999984
"17313",2017-09-09 03:40:01,142264.99,432602.569999984
"17314",2017-09-09 03:40:01,-290337.58,142264.989999984
"17315",2017-09-09 03:57:05,-142264.99,-1.58324837684631e-08
"3466",2017-09-09 04:53:51,183632.12,183632.119999984
"3467",2017-09-09 05:12:31,-183632.12,-1.58324837684631e-08
"17316",2017-09-09 05:12:31,240636.13,240636.129999984
"17317",2017-09-09 05:12:31,147820.57,388456.699999984
"17318",2017-09-09 05:22:30,-388456.7,-1.58324837684631e-08
"17319",2017-09-09 05:27:21,296514.22,296514.219999984
"17320",2017-09-09 05:34:41,-296514.22,-1.58324837684631e-08
"3468",2017-09-09 06:06:01,278204.48,278204.479999984
"17321",2017-09-09 06:06:01,229480.41,507684.889999984
"17322",2017-09-09 06:06:01,220369.9,728054.789999984
"3469",2017-09-09 06:09:56,-278204.48,449850.309999984
"17323",2017-09-09 06:09:56,-449850.31,-1.57742761075497e-08
"17324",2017-09-09 06:11:54,222420.9,222420.899999984
"3470",2017-09-09 06:28:26,146734.9,369155.799999984
"17325",2017-09-09 06:28:26,-222420.9,146734.899999984
"3471",2017-09-09 06:55:52,193163.7,339898.599999984
"3472",2017-09-09 06:55:52,-146734.9,193163.699999984
"17326",2017-09-09 06:55:52,166223.84,359387.539999984
"3473",2017-09-09 07:04:56,-193163.7,166223.839999984
"17327",2017-09-09 07:04:56,-166223.84,-1.57451722770929e-08
"17328",2017-09-09 07:25:50,150305.11,150305.109999984
"17329",2017-09-09 07:32:25,-150305.11,-1.57451722770929e-08
"3474",2017-09-09 09:37:02,170753.37,170753.369999984
"3475",2017-09-09 09:42:46,-170753.37,-1.57451722770929e-08
"3476",2017-09-09 09:54:19,162341.97,162341.969999984
"17330",2017-09-09 09:56:29,213118.56,375460.529999984
"3477",2017-09-09 10:16:16,189981.32,565441.849999984
"3478",2017-09-09 10:16:16,-162341.97,403099.879999984
"17331",2017-09-09 10:16:16,146275.68,549375.559999984
"17332",2017-09-09 10:16:16,-213118.56,336256.999999984
"3479",2017-09-09 10:40:09,-189981.32,146275.679999984
"17333",2017-09-09 10:40:09,-146275.68,-1.57742761075497e-08
"17334",2017-09-09 10:56:48,152725.51,152725.509999984
"17335",2017-09-09 11:07:52,-152725.51,-1.57742761075497e-08
"17336",2017-09-09 11:18:35,268089.93,268089.929999984
"17337",2017-09-09 11:23:23,-268089.93,-1.57742761075497e-08
"17338",2017-09-09 11:40:48,172544.42,172544.419999984
"17339",2017-09-09 12:04:07,249078.26,421622.679999984
"17340",2017-09-09 12:04:07,-172544.42,249078.259999984
"17341",2017-09-09 12:04:07,-172544.42,76533.8399999842
"3480",2017-09-09 12:12:36,212016.29,288550.129999984
"17342",2017-09-09 12:12:36,-76533.84,212016.289999984
"3481",2017-09-09 12:17:03,-212016.29,-1.58324837684631e-08
"17343",2017-09-09 12:46:14,187012.46,187012.459999984
"17344",2017-09-09 12:57:42,-187012.46,-1.58324837684631e-08
"3482",2017-09-09 13:25:12,179855.13,179855.129999984
"3483",2017-09-09 13:29:12,-179855.13,-1.58324837684631e-08
"3484",2017-09-09 14:07:06,294584.54,294584.539999984
"17345",2017-09-09 14:07:06,212570.83,507155.369999984
"3485",2017-09-09 14:23:08,-294584.54,212570.829999984
"17346",2017-09-09 14:23:08,-212570.83,-1.58033799380064e-08
"3486",2017-09-09 16:42:00,184212.63,184212.629999984
"3487",2017-09-09 16:51:09,-184212.63,-1.58033799380064e-08
"17347",2017-09-09 17:57:08,275971.62,275971.619999984
"17348",2017-09-09 18:01:22,-275971.62,-1.58324837684631e-08
"3488",2017-09-09 18:30:58,158855.63,158855.629999984
"3489",2017-09-09 18:35:59,-158855.63,-1.58324837684631e-08
"3490",2017-09-09 18:54:32,300618.82,300618.819999984
"17349",2017-09-09 18:54:32,211822.39,512441.209999984
"17350",2017-09-09 18:55:41,-211822.39,300618.819999984
"3491",2017-09-09 18:58:49,-300618.82,-1.58324837684631e-08
"3492",2017-09-09 19:04:28,191480.44,191480.439999984
"3493",2017-09-09 19:24:21,213992.91,405473.349999984
"3494",2017-09-09 19:24:21,-191480.44,213992.909999984
"17351",2017-09-09 19:24:21,178944.73,392937.639999984
"3495",2017-09-09 19:34:29,-213992.91,178944.729999984
"17352",2017-09-09 19:34:29,232622.16,411566.889999984
"17353",2017-09-09 19:34:29,-178944.73,232622.159999984
"17354",2017-09-09 19:45:07,-232622.16,-1.58324837684631e-08
"17355",2017-09-09 19:55:23,289829.21,289829.209999984
"17356",2017-09-09 19:59:19,217808.25,507637.459999984
"17357",2017-09-09 19:59:19,-289829.21,217808.249999984
"17358",2017-09-09 20:09:47,-217808.25,-1.58324837684631e-08
"3496",2017-09-09 21:56:48,161579.28,161579.279999984
"3497",2017-09-09 22:00:12,-161579.28,-1.58324837684631e-08
"17359",2017-09-09 22:45:58,200737.46,200737.459999984
"3498",2017-09-09 23:12:44,151222.43,351959.889999984
"3499",2017-09-09 23:12:44,199295.77,551255.659999984
"17360",2017-09-09 23:12:44,197601.88,748857.539999984
"17361",2017-09-09 23:12:44,-200737.46,548120.079999984
"3500",2017-09-09 23:36:30,-350518.2,197601.879999984
"17362",2017-09-09 23:36:30,-197601.88,-1.57742761075497e-08
"3501",2017-09-09 23:43:53,175811.41,175811.409999984
"3502",2017-09-09 23:48:15,-175811.41,-1.57742761075497e-08
"3503",2017-09-10 04:46:50,247371.95,247371.949999984
"3504",2017-09-10 05:00:21,-247371.95,-1.57742761075497e-08
"3505",2017-09-10 05:24:23,25028.85,25028.8499999842
"3506",2017-09-10 05:24:23,168184.72,193213.569999984
"3507",2017-09-10 05:33:11,-193213.57,-1.57742761075497e-08
"3508",2017-09-10 05:44:37,157315.32,157315.319999984
"3509",2017-09-10 05:53:29,-157315.32,-1.57742761075497e-08
"3510",2017-09-10 06:01:58,137529.31,137529.309999984
"3511",2017-09-10 06:06:45,-137529.31,-1.57742761075497e-08
"3512",2017-09-10 06:27:47,165224.19,165224.189999984
"3513",2017-09-10 06:27:47,231306.31,396530.499999984
"3514",2017-09-10 06:27:47,179510.35,576040.849999984
"3515",2017-09-10 06:37:13,300157.11,876197.959999984
"3516",2017-09-10 06:37:13,89045.1,965243.059999984
"3517",2017-09-10 06:37:13,-576040.85,389202.209999984
"3518",2017-09-10 06:41:28,-389202.21,-1.57742761075497e-08
"3519",2017-09-10 07:25:25,397422.55,397422.549999984
"3520",2017-09-10 07:25:25,18146.75,415569.299999984
"3521",2017-09-10 07:25:25,280511.8,696081.099999984
"3522",2017-09-10 07:32:49,-696081.1,-1.57160684466362e-08
"17363",2017-09-10 07:32:49,194378.05,194378.049999984
"17364",2017-09-10 07:32:49,142595.39,336973.439999984
"17365",2017-09-10 07:50:14,171018.44,507991.879999984
"3523",2017-09-10 08:03:58,253208.59,761200.469999984
"3524",2017-09-10 08:16:31,-253208.59,507991.879999984
"17366",2017-09-10 08:26:44,177048.95,685040.829999984
"3525",2017-09-10 08:39:32,304874.53,989915.359999984
"3526",2017-09-10 08:49:12,-304874.53,685040.829999984
"17367",2017-09-10 08:57:09,199399.92,884440.749999984
"17368",2017-09-10 09:39:27,322314.35,1206755.09999998
"3527",2017-09-10 10:26:12,185771.5,1392526.59999998
"3528",2017-09-10 10:26:12,148560.29,1541086.88999998
"3529",2017-09-10 10:43:23,-334331.79,1206755.09999998
"3530",2017-09-10 10:59:59,168389.36,1375144.45999998
"17369",2017-09-10 10:59:59,249022.54,1624166.99999998
"3531",2017-09-10 11:43:35,315619.62,1939786.61999998
"3532",2017-09-10 11:43:35,285374.9,2225161.51999998
"3533",2017-09-10 11:43:35,-168389.36,2056772.15999998
"17370",2017-09-10 11:43:35,272137.63,2328909.78999998
"17371",2017-09-10 11:43:35,210489.85,2539399.63999998
"3534",2017-09-10 11:54:34,-600994.52,1938405.11999998
"17372",2017-09-10 13:26:58,412942.8,2351347.91999998
"3535",2017-09-10 14:11:19,348478.85,2699826.76999998
"17373",2017-09-10 14:11:19,279096.4,2978923.16999998
"3536",2017-09-10 14:16:34,-348478.85,2630444.31999998
"17374",2017-09-10 15:00:52,356546.49,2986990.80999998
"3537",2017-09-10 16:00:51,211172.29,3198163.09999998
"3538",2017-09-10 16:00:51,327202.26,3525365.35999998
"3539",2017-09-10 16:08:28,-538374.55,2986990.80999998
"3540",2017-09-10 17:12:24,324676.66,3311667.46999998
"3541",2017-09-10 17:12:24,300157.43,3611824.89999998
"3542",2017-09-10 17:12:24,300157.42,3911982.31999998
"17375",2017-09-10 17:59:03,269941.28,4181923.59999998
"17376",2017-09-10 17:59:03,250138.59,4432062.18999998
"17377",2017-09-10 17:59:03,233341.92,4665404.10999998
"3543",2017-09-10 18:25:20,-924991.51,3740412.59999998
"17378",2017-09-10 18:44:20,318616.29,4059028.88999998
"3544",2017-09-10 18:49:41,300157.48,4359186.36999998
"3545",2017-09-10 19:00:03,-300157.48,4059028.88999998
"17379",2017-09-10 19:16:52,202459.91,4261488.79999998
"3546",2017-09-10 21:13:45,179873.88,4441362.67999998
"17380",2017-09-10 21:13:45,309761.85,4751124.52999998
"3547",2017-09-10 21:16:53,189988.78,4941113.30999998
"3548",2017-09-10 21:22:19,-179873.88,4761239.42999998
"3549",2017-09-10 21:27:23,-189988.78,4571250.64999998
"3550",2017-09-10 21:56:29,279345.47,4850596.11999998
"3551",2017-09-10 22:15:03,-279345.47,4571250.64999998
"17381",2017-09-10 22:15:03,181753.5,4753004.14999998
"3552",2017-09-10 23:14:35,196871.58,4949875.72999998
"3553",2017-09-10 23:32:06,-196871.58,4753004.14999998
"3554",2017-09-10 23:47:50,284977.96,5037982.10999998
"17382",2017-09-10 23:47:50,193518.23,5231500.33999998
"3555",2017-09-10 23:55:45,-284977.96,4946522.37999998
"17383",2017-09-10 23:55:45,307904.2,5254426.57999998
"3556",2017-09-11 00:13:46,208662.62,5463089.19999998
"3557",2017-09-11 00:21:21,-208662.62,5254426.57999998
"3558",2017-09-11 00:28:09,260792.2,5515218.77999998
"3559",2017-09-11 00:46:33,-260792.2,5254426.57999998
"17384",2017-09-11 01:20:54,197869.98,5452296.55999998
"17385",2017-09-11 01:20:54,339351.8,5791648.35999998
"3560",2017-09-11 01:22:55,191053.23,5982701.58999998
"3561",2017-09-11 01:27:45,-191053.23,5791648.35999998
"3562",2017-09-11 01:47:44,225925.43,6017573.78999998
"3563",2017-09-11 01:47:44,306302.8,6323876.58999998
"3564",2017-09-11 02:04:42,238041.52,6561918.10999998
"3565",2017-09-11 02:04:42,-532228.23,6029689.87999998
"3566",2017-09-11 02:23:36,-238041.52,5791648.35999998
"17386",2017-09-11 02:23:36,200355.25,5992003.60999998
"3567",2017-09-11 03:28:48,290733.51,6282737.11999998
"3568",2017-09-11 03:31:24,-290733.51,5992003.60999998
"3569",2017-09-11 04:52:11,313768.04,6305771.64999998
"3570",2017-09-11 04:52:11,291281.03,6597052.67999998
"3571",2017-09-11 04:52:11,296666.98,6893719.65999999
"3572",2017-09-11 04:58:11,456469.53,7350189.18999999
"3573",2017-09-11 04:58:11,-901716.05,6448473.13999999
"3574",2017-09-11 05:01:55,-456469.53,5992003.60999999
"3575",2017-09-11 06:13:05,283874,6275877.60999999
"17387",2017-09-11 06:13:05,300864.92,6576742.52999999
"3576",2017-09-11 06:33:15,268965.46,6845707.98999999
"3577",2017-09-11 06:33:15,-283874,6561833.98999999
"3578",2017-09-11 06:40:38,-268965.46,6292868.52999999
"17388",2017-09-11 12:24:25,391054.48,6683923.00999998
"17389",2017-09-11 13:55:24,433705.86,7117628.86999999
"17390",2017-09-11 17:56:10,377145.31,7494774.17999998
"17391",2017-09-11 19:10:03,27432.84,7522207.01999998
"3579",2017-09-11 21:18:35,10859.22,7533066.23999998
"3580",2017-09-11 21:32:14,-10859.22,7522207.01999998
"17392",2017-09-11 21:32:14,150519.15,7672726.16999999
"17393",2017-09-11 21:32:14,111747.98,7784474.14999999
"17394",2017-09-11 22:39:57,111962.9,7896437.04999999
"17395",2017-09-12 01:39:57,202708.19,8099145.23999999
"17396",2017-09-12 02:07:34,142257.96,8241403.19999999
"17397",2017-09-12 02:55:47,332135.53,8573538.72999999
"17398",2017-09-12 03:39:01,265874.43,8839413.15999999
"17399",2017-09-12 03:52:21,200837.25,9040250.40999999
"17400",2017-09-12 04:00:17,211877.35,9252127.75999998
"17401",2017-09-12 04:15:53,260616.19,9512743.94999998
"17402",2017-09-12 05:15:43,470179.06,9982923.00999998
"17403",2017-09-12 05:53:43,353245.09,10336168.1
"3581",2017-09-12 06:29:41,355656.51,10691824.61
"3582",2017-09-12 06:38:33,-355656.51,10336168.1
"3583",2017-09-12 06:44:44,331836.81,10668004.91
"3584",2017-09-12 06:59:29,-331836.81,10336168.1
"17404",2017-09-12 14:23:49,215079.33,10551247.43
"17405",2017-09-12 16:36:07,285859.84,10837107.27
"17406",2017-09-12 17:31:01,251210.21,11088317.48
"3585",2017-09-12 19:15:02,210668.25,11298985.73
"3586",2017-09-12 19:21:29,-210668.25,11088317.48
"17407",2017-09-12 19:21:29,-11088317.48,-1.49011611938477e-08
"3587",2017-09-12 19:32:40,205124.86,205124.859999985
"17408",2017-09-12 19:32:40,15350.73,220475.589999985
"3588",2017-09-12 19:48:05,178918.87,399394.459999985
"3589",2017-09-12 19:48:05,28794.41,428188.869999985
"3590",2017-09-12 19:48:05,-205124.86,223064.009999985
"17409",2017-09-12 19:48:05,458169.44,681233.449999985
"17410",2017-09-12 19:48:05,-15350.73,665882.719999985
"17411",2017-09-12 19:48:05,-15350.73,650531.989999985
"3591",2017-09-12 19:54:30,163441.01,813972.999999985
"17412",2017-09-12 19:54:30,-442818.71,371154.289999985
"3592",2017-09-12 19:57:47,-371154.29,-1.49011611938477e-08
"3593",2017-09-12 20:06:46,137048.2,137048.199999985
"3594",2017-09-12 20:13:05,178065.76,315113.959999985
"3595",2017-09-12 20:13:05,186508.67,501622.629999985
"3596",2017-09-12 20:13:05,-137048.2,364574.429999985
"3597",2017-09-12 20:26:16,143134.08,507708.509999985
"3598",2017-09-12 20:26:16,-364574.43,143134.079999985
"17413",2017-09-12 20:26:16,163376.77,306510.849999985
"3599",2017-09-12 20:36:59,-143134.08,163376.769999985
"17414",2017-09-12 20:36:59,-163376.77,-1.49011611938477e-08
"17415",2017-09-12 20:42:21,211642.97,211642.969999985
"3600",2017-09-12 20:49:08,145668.27,357311.239999985
"17416",2017-09-12 20:49:08,-211642.97,145668.269999985
"3601",2017-09-12 20:55:15,135456.5,281124.769999985
"3602",2017-09-12 20:55:15,-145668.27,135456.499999985
"3603",2017-09-12 21:08:19,-135456.5,-1.48720573633909e-08
"3604",2017-09-12 21:11:18,154499.52,154499.519999985
"3605",2017-09-12 21:15:57,-154499.52,-1.48720573633909e-08
"3606",2017-09-12 21:43:37,140610.64,140610.639999985
"17417",2017-09-12 21:43:37,158163.23,298773.869999985
"3607",2017-09-12 22:01:19,-140610.64,158163.229999985
"17418",2017-09-12 22:01:19,-158163.23,-1.48720573633909e-08
"3608",2017-09-12 22:38:54,128040.54,128040.539999985
"3609",2017-09-12 22:44:55,-128040.54,-1.48720573633909e-08
"17419",2017-09-12 22:44:55,171777.16,171777.159999985
"3610",2017-09-12 22:55:50,127195.3,298972.459999985
"17420",2017-09-12 22:55:50,-171777.16,127195.299999985
"3611",2017-09-12 23:14:08,146928.99,274124.289999985
"3612",2017-09-12 23:14:08,134224.64,408348.929999985
"3613",2017-09-12 23:14:08,-127195.3,281153.629999985
"3614",2017-09-12 23:25:10,142179.97,423333.599999985
"3615",2017-09-12 23:25:10,-281153.63,142179.969999985
"17421",2017-09-12 23:25:10,151918.38,294098.349999985
"3616",2017-09-12 23:40:59,-142179.97,151918.379999985
"17422",2017-09-12 23:40:59,132915.89,284834.269999985
"17423",2017-09-12 23:40:59,-151918.38,132915.889999985
"17424",2017-09-12 23:49:56,-132915.89,-1.47847458720207e-08
"3617",2017-09-13 00:14:28,129762.35,129762.349999985
"3618",2017-09-13 00:17:31,-129762.35,-1.47847458720207e-08
"3619",2017-09-13 00:42:34,255492.88,255492.879999985
"17425",2017-09-13 00:42:34,157719.26,413212.139999985
"3620",2017-09-13 01:00:34,186045.62,599257.759999985
"3621",2017-09-13 01:00:34,-255492.88,343764.879999985
"17426",2017-09-13 01:00:34,158771.45,502536.329999985
"17427",2017-09-13 01:00:34,-157719.26,344817.069999985
"17428",2017-09-13 01:00:34,-157719.26,187097.809999985
"3622",2017-09-13 01:07:07,157593.4,344691.209999985
"3623",2017-09-13 01:07:07,-186045.62,158645.589999985
"17429",2017-09-13 01:07:07,-1052.19,157593.399999985
"3624",2017-09-13 01:25:16,-157593.4,-1.48138497024775e-08
"17430",2017-09-13 01:25:16,152540.74,152540.739999985
"17431",2017-09-13 01:30:30,-152540.74,-1.48138497024775e-08
"17432",2017-09-13 02:01:20,161412.64,161412.639999985
"17433",2017-09-13 02:08:07,-161412.64,-1.48138497024775e-08
"3625",2017-09-13 02:15:40,128050.85,128050.849999985
"3626",2017-09-13 02:18:32,-128050.85,-1.48138497024775e-08
"3627",2017-09-13 02:26:10,127005.12,127005.119999985
"3628",2017-09-13 03:11:12,207930.09,334935.209999985
"3629",2017-09-13 03:11:12,196328.02,531263.229999985
"3630",2017-09-13 03:11:12,131686.09,662949.319999985
"17434",2017-09-13 03:11:12,286297.23,949246.549999985
"17435",2017-09-13 03:11:12,163663.05,1112909.59999999
"3631",2017-09-13 03:22:31,-127005.12,985904.479999985
"17436",2017-09-13 03:22:31,-449960.28,535944.199999985
"3632",2017-09-13 03:37:09,-535944.2,-1.47847458720207e-08
"3633",2017-09-13 03:58:20,183355,183354.999999985
"3634",2017-09-13 03:58:20,411411.59,594766.589999985
"3635",2017-09-13 04:11:22,330214.74,924981.329999985
"3636",2017-09-13 04:39:56,377151.47,1302132.79999999
"3637",2017-09-13 04:39:56,-594766.59,707366.209999985
"17437",2017-09-13 04:39:56,28377.76,735743.969999985
"3638",2017-09-13 04:53:39,-707366.21,28377.7599999852
"17438",2017-09-13 04:53:39,201955.96,230333.719999985
"17439",2017-09-13 04:53:39,166085.65,396419.369999985
"17440",2017-09-13 04:53:39,-28377.76,368041.609999985
"17441",2017-09-13 04:53:39,13195.97,381237.579999985
"17442",2017-09-13 04:58:19,-381237.58,-1.48429535329342e-08
"17443",2017-09-13 05:04:22,194779.07,194779.069999985
"17444",2017-09-13 05:10:34,-194779.07,-1.48429535329342e-08
"3639",2017-09-13 05:15:12,277888.95,277888.949999985
"3640",2017-09-13 05:26:51,235661.18,513550.129999985
"3641",2017-09-13 05:26:51,-277888.95,235661.179999985
"3642",2017-09-13 05:36:24,-235661.18,-1.48429535329342e-08
"3643",2017-09-13 05:46:44,259813.23,259813.229999985
"17445",2017-09-13 05:46:44,321103.45,580916.679999985
"3644",2017-09-13 05:50:19,-259813.23,321103.449999985
"3645",2017-09-13 06:01:17,160907.82,482011.269999985
"3646",2017-09-13 06:01:17,158812.64,640823.909999985
"17446",2017-09-13 06:01:17,-321103.45,319720.459999985
"3647",2017-09-13 06:13:45,262022.12,581742.579999985
"3648",2017-09-13 06:13:45,-319720.46,262022.119999985
"17447",2017-09-13 06:13:45,137011.1,399033.219999985
"17448",2017-09-13 06:13:45,145399.6,544432.819999985
"3649",2017-09-13 06:28:02,-262022.12,282410.699999985
"17449",2017-09-13 06:28:02,185910.51,468321.209999985
"17450",2017-09-13 06:28:02,180215.47,648536.679999985
"17451",2017-09-13 06:28:02,-282410.7,366125.979999985
"17452",2017-09-13 06:31:43,208811,574936.979999985
"3650",2017-09-13 06:38:06,136808.88,711745.859999985
"17453",2017-09-13 06:38:06,-574936.98,136808.879999985
"3651",2017-09-13 06:41:18,-136808.88,-1.49011611938477e-08
"3652",2017-09-13 07:23:35,152824.81,152824.809999985
"3653",2017-09-13 07:54:20,133828.84,286653.649999985
"3654",2017-09-13 07:54:20,-152824.81,133828.839999985
"3655",2017-09-13 08:01:38,194767.05,328595.889999985
"3656",2017-09-13 08:01:38,-133828.84,194767.049999985
"17454",2017-09-13 08:01:38,236234.26,431001.309999985
"17455",2017-09-13 08:12:04,-236234.26,194767.049999985
"3657",2017-09-13 08:15:48,-194767.05,-1.48429535329342e-08
"3658",2017-09-13 09:39:01,50002.04,50002.0399999852
"3659",2017-09-13 09:45:32,457406.5,507408.539999985
"3660",2017-09-13 09:45:32,-50002.04,457406.499999985
"17456",2017-09-13 09:45:32,630501.25,1087907.74999999
"3661",2017-09-13 09:50:30,-457406.5,630501.249999985
"17457",2017-09-13 09:50:30,-630501.25,-1.49011611938477e-08
"3662",2017-09-13 10:00:08,128240.45,128240.449999985
"3663",2017-09-13 10:00:08,139984.09,268224.539999985
"3664",2017-09-13 10:19:59,-268224.54,-1.49011611938477e-08
"17458",2017-09-13 10:19:59,162855.66,162855.659999985
"17459",2017-09-13 10:19:59,147069.84,309925.499999985
"3665",2017-09-13 10:25:22,185130.35,495055.849999985
"17460",2017-09-13 10:25:22,-309925.5,185130.349999985
"3666",2017-09-13 10:45:08,188930.61,374060.959999985
"3667",2017-09-13 10:45:08,172051.6,546112.559999985
"3668",2017-09-13 10:45:08,-185130.35,360982.209999985
"3669",2017-09-13 10:53:32,-360982.21,-1.49593688547611e-08
"3670",2017-09-13 11:19:05,198196.13,198196.129999985
"3671",2017-09-13 11:40:48,164708.5,362904.629999985
"3672",2017-09-13 11:40:48,148453.04,511357.669999985
"3673",2017-09-13 11:40:48,182234.45,693592.119999985
"3674",2017-09-13 11:40:48,-198196.13,495395.989999985
"17461",2017-09-13 11:40:48,318959.38,814355.369999985
"3675",2017-09-13 11:57:50,-495395.99,318959.379999985
"17462",2017-09-13 11:57:50,-318959.38,-1.50175765156746e-08
"3676",2017-09-13 12:04:35,330960.71,330960.709999985
"3677",2017-09-13 12:04:35,256951.38,587912.089999985
"3678",2017-09-13 12:11:01,-587912.09,-1.50175765156746e-08
"3679",2017-09-13 12:27:39,203633.08,203633.079999985
"17463",2017-09-13 12:27:39,241808.74,445441.819999985
"3680",2017-09-13 12:44:07,318179.75,763621.569999985
"3681",2017-09-13 12:44:07,-203633.08,559988.489999985
"17464",2017-09-13 12:44:07,284143.34,844131.829999985
"3682",2017-09-13 13:01:05,-318179.75,525952.079999985
"3683",2017-09-13 13:04:13,299998,825950.079999985
"3684",2017-09-13 13:27:05,232361.72,1058311.79999998
"3685",2017-09-13 13:27:05,-299998,758313.799999985
"3686",2017-09-13 13:38:11,-232361.72,525952.079999985
"17465",2017-09-13 13:38:11,297653.77,823605.849999985
"17466",2017-09-13 14:06:07,248445.85,1072051.69999999
"3687",2017-09-13 14:39:53,206515.98,1278567.67999999
"3688",2017-09-13 14:57:35,318447.72,1597015.39999999
"3689",2017-09-13 14:57:35,214145.76,1811161.15999999
"3690",2017-09-13 14:57:35,-206515.98,1604645.17999999
"17467",2017-09-13 14:57:35,201504.17,1806149.34999998
"3691",2017-09-13 15:11:58,276234.68,2082384.02999998
"3692",2017-09-13 15:11:58,-532593.48,1549790.54999998
"17468",2017-09-13 15:11:58,358454.99,1908245.53999998
"3693",2017-09-13 15:23:16,524397.28,2432642.81999998
"3694",2017-09-13 15:23:16,-276234.68,2156408.13999998
"3695",2017-09-13 15:37:20,-524397.28,1632010.85999998
"17469",2017-09-13 15:37:20,376435.4,2008446.25999998
"3696",2017-09-13 16:15:48,277843.4,2286289.65999998
"3697",2017-09-13 16:20:27,-277843.4,2008446.25999998
"3698",2017-09-13 16:53:48,440321.04,2448767.29999998
"3699",2017-09-13 16:58:33,269170.98,2717938.27999998
"3700",2017-09-13 16:58:33,-440321.04,2277617.23999998
"3701",2017-09-13 17:24:30,-269170.98,2008446.25999998
"3702",2017-09-13 18:19:51,173437.65,2181883.90999998
"3703",2017-09-13 18:19:51,19168.87,2201052.77999998
"3704",2017-09-13 18:26:32,239779.08,2440831.85999998
"3705",2017-09-13 18:26:32,-192606.52,2248225.33999998
"3706",2017-09-13 18:34:11,-239779.08,2008446.25999998
"17470",2017-09-13 18:34:11,177851.89,2186298.14999999
"3707",2017-09-13 20:06:40,158725.03,2345023.17999998
"3708",2017-09-13 20:10:07,170732.07,2515755.24999998
"3709",2017-09-13 20:22:32,-158725.03,2357030.21999998
"3710",2017-09-13 20:41:16,-170732.07,2186298.14999999
"17471",2017-09-13 20:51:57,174213.03,2360511.17999998
"3711",2017-09-13 21:15:03,196612.07,2557123.24999998
"3712",2017-09-13 21:18:38,-196612.07,2360511.17999998
"3713",2017-09-13 22:18:57,216293.23,2576804.40999998
"3714",2017-09-13 22:22:40,-216293.23,2360511.17999998
"17472",2017-09-13 22:34:20,210175.66,2570686.83999998
"17473",2017-09-13 22:41:01,316562.82,2887249.65999998
"3715",2017-09-14 03:47:02,215444.51,3102694.16999999
"3716",2017-09-14 03:47:02,29237.98,3131932.14999999
"3717",2017-09-14 04:06:24,-244682.49,2887249.65999999
"17474",2017-09-14 04:31:12,186039.35,3073289.00999999
"17475",2017-09-14 06:15:30,170624.09,3243913.09999999
"17476",2017-09-14 07:17:06,187565.57,3431478.66999999
"17477",2017-09-14 08:17:07,243443.19,3674921.85999998
"3718",2017-09-14 11:18:31,170494.16,3845416.01999999
"3719",2017-09-14 11:18:31,425317.03,4270733.04999998
"3720",2017-09-14 11:18:31,176142.01,4446875.05999998
"3721",2017-09-14 11:42:05,308648.08,4755523.13999998
"3722",2017-09-14 11:42:05,-771953.2,3983569.93999998
"17478",2017-09-14 11:42:05,14787.81,3998357.74999998
"3723",2017-09-14 11:54:54,-308648.08,3689709.66999998
"17479",2017-09-14 12:07:11,186008.55,3875718.21999998
"17480",2017-09-14 12:07:11,220660.7,4096378.91999998
"3724",2017-09-14 12:18:07,181284.93,4277663.84999998
"17481",2017-09-14 12:18:07,196687.97,4474351.81999998
"3725",2017-09-14 12:30:35,500003.14,4974354.95999998
"3726",2017-09-14 12:30:35,-181284.93,4793070.02999998
"3727",2017-09-14 12:41:01,-500003.14,4293066.88999998
"17482",2017-09-14 12:41:01,286782.35,4579849.23999998
"3728",2017-09-14 12:59:49,339312.04,4919161.27999998
"17483",2017-09-14 12:59:49,216039.95,5135201.22999998
"17484",2017-09-14 12:59:49,218511.9,5353713.12999998
"3729",2017-09-14 13:09:40,-339312.04,5014401.08999998
"3730",2017-09-14 13:26:06,224605.25,5239006.33999998
"3732",2017-09-14 13:32:35,-224605.25,5014401.08999998
"3731",2017-09-14 13:32:36,500003.22,5514404.30999998
"3733",2017-09-14 14:07:01,269886.42,5784290.72999998
"3734",2017-09-14 14:07:01,375239.41,6159530.13999998
"3735",2017-09-14 14:07:01,300003.23,6459533.36999998
"3736",2017-09-14 14:08:45,-500003.22,5959530.14999998
"3737",2017-09-14 14:42:31,-945129.06,5014401.08999998
"17485",2017-09-14 15:18:27,585363.6,5599764.68999998
"17486",2017-09-14 15:22:18,266315.38,5866080.06999998
"3738",2017-09-14 16:14:50,288932.91,6155012.97999998
"3739",2017-09-14 16:14:50,223588.92,6378601.89999998
"3740",2017-09-14 16:14:50,214609.12,6593211.01999998
"3741",2017-09-14 16:44:53,-727130.95,5866080.06999998
"3742",2017-09-14 17:44:48,1026955.66,6893035.72999998
"3743",2017-09-14 17:51:02,300003.32,7193039.04999998
"3744",2017-09-14 17:51:02,-1026955.66,6166083.38999998
"3745",2017-09-14 17:56:54,500003.51,6666086.89999998
"3746",2017-09-14 18:04:46,-300003.32,6366083.57999998
"3747",2017-09-14 18:14:25,589458.65,6955542.22999998
"3748",2017-09-14 18:14:25,-500003.51,6455538.71999998
"3749",2017-09-14 18:27:38,636042.74,7091581.45999999
"3750",2017-09-14 18:27:38,573870.01,7665451.46999998
"3751",2017-09-14 18:27:38,-589458.65,7075992.81999998
"3752",2017-09-14 18:43:55,700003.58,7775996.39999998
"3753",2017-09-14 18:43:55,-1209912.75,6566083.64999998
"3754",2017-09-14 19:01:26,-700003.58,5866080.06999998
"17487",2017-09-14 19:24:03,588649.95,6454730.01999998
"3755",2017-09-14 21:43:52,59944.85,6514674.86999998
"3756",2017-09-14 21:53:11,-59944.85,6454730.01999998
"3757",2017-09-14 22:10:03,226816.54,6681546.55999998
"3758",2017-09-14 22:16:46,-226816.54,6454730.01999998
"17488",2017-09-14 22:16:46,321821.34,6776551.35999998
"17489",2017-09-14 22:23:04,400105.63,7176656.98999998
"3759",2017-09-15 00:16:05,500003.76,7676660.74999998
"3760",2017-09-15 00:16:05,21132.36,7697793.10999998
"3761",2017-09-15 00:16:05,259884.68,7957677.78999998
"3762",2017-09-15 00:16:05,230214.25,8187892.03999998
"3763",2017-09-15 00:36:46,-1011235.05,7176656.98999998
"17490",2017-09-15 00:36:46,470461.03,7647118.01999998
"17491",2017-09-15 00:42:52,347963.16,7995081.17999998
"3764",2017-09-15 00:58:41,483277.33,8478358.50999998
"3765",2017-09-15 01:08:05,-483277.33,7995081.17999998
"17492",2017-09-15 01:08:05,386106.41,8381187.58999998
"3766",2017-09-15 01:11:11,280455.88,8661643.46999999
"3767",2017-09-15 01:29:17,-280455.88,8381187.58999999
"3768",2017-09-15 01:55:25,516875.8,8898063.38999999
"3769",2017-09-15 02:10:01,-516875.8,8381187.58999999
"17493",2017-09-15 02:43:24,419682.17,8800869.75999999
"3770",2017-09-15 06:04:29,605170.25,9406040.00999999
"17494",2017-09-15 06:04:29,47178.54,9453218.54999999
"3771",2017-09-15 06:16:14,-605170.25,8848048.29999999
"3772",2017-09-15 07:22:02,524608.08,9372656.37999999
"3773",2017-09-15 07:31:34,-524608.08,8848048.29999999
"17495",2017-09-15 07:31:34,305174.4,9153222.69999999
"3774",2017-09-15 07:42:51,549366.34,9702589.03999999
"3775",2017-09-15 07:53:44,-549366.34,9153222.69999999
"3776",2017-09-15 08:00:56,640713.32,9793936.01999999
"3777",2017-09-15 08:13:54,-640713.32,9153222.69999999
"3778",2017-09-15 08:32:08,575162.86,9728385.55999999
"3779",2017-09-15 08:38:28,-575162.86,9153222.69999999
"17496",2017-09-15 08:38:28,540396.13,9693618.82999999
"3780",2017-09-15 09:28:47,453520.8,10147139.63
"3781",2017-09-15 09:33:12,-453520.8,9693618.82999999
"3782",2017-09-15 10:20:35,700004.32,10393623.15
"3783",2017-09-15 10:31:16,-700004.32,9693618.82999999
"17497",2017-09-15 10:31:16,344042.48,10037661.31
"3784",2017-09-15 10:46:27,339504.99,10377166.3
"3785",2017-09-15 10:46:27,536045.56,10913211.86
"3786",2017-09-15 11:06:07,777781.36,11690993.22
"3787",2017-09-15 11:06:07,-875550.55,10815442.67
"17498",2017-09-15 11:06:07,356837.54,11172280.21
"17499",2017-09-15 11:06:07,400472.93,11572753.14
"3788",2017-09-15 11:12:35,354320.4,11927073.54
"3789",2017-09-15 11:13:42,-777781.36,11149292.18
"3790",2017-09-15 11:21:34,-354320.4,10794971.78
"17500",2017-09-15 11:21:34,362991.75,11157963.53
"3791",2017-09-15 11:33:14,468766.77,11626730.3
"3792",2017-09-15 11:47:50,700004.39,12326734.69
"3793",2017-09-15 11:47:50,-468766.77,11857967.92
"3794",2017-09-15 11:55:08,-700004.39,11157963.53
"17501",2017-09-15 12:02:08,457383.75,11615347.28
"3795",2017-09-15 12:29:24,700004.41,12315351.69
"3796",2017-09-15 12:43:18,-700004.41,11615347.28
"17502",2017-09-15 12:55:29,446015.66,12061362.94
"3797",2017-09-15 15:15:10,328411.11,12389774.05
"3798",2017-09-15 15:15:10,475710.11,12865484.16
"3799",2017-09-15 15:23:03,-804121.22,12061362.94
"3800",2017-09-15 16:00:47,408217.86,12469580.8
"3801",2017-09-15 16:17:13,-408217.86,12061362.94
"17503",2017-09-15 16:41:19,329905.01,12391267.95
"3802",2017-09-15 17:01:33,205482.9,12596750.85
"3803",2017-09-15 17:18:35,700004.65,13296755.5
"3804",2017-09-15 17:18:35,-205482.9,13091272.6
"3805",2017-09-15 17:23:35,-700004.65,12391267.95
"3806",2017-09-15 17:47:26,325255.34,12716523.29
"17504",2017-09-15 17:47:26,215670.75,12932194.04
"17505",2017-09-15 17:47:26,306088.19,13238282.23
"3807",2017-09-15 17:55:56,-325255.34,12913026.89
"17506",2017-09-15 18:09:50,27986.73,12941013.62
"17507",2017-09-15 18:09:50,31837.99,12972851.61
"3808",2017-09-15 18:10:09,516261.28,13489112.89
"3809",2017-09-15 18:18:29,-516261.28,12972851.61
"17508",2017-09-15 18:18:29,-12972851.61,-1.49011611938477e-08
"3810",2017-09-15 18:55:10,247861.77,247861.769999985
"3811",2017-09-15 19:06:56,-247861.77,-1.49011611938477e-08
"3812",2017-09-15 19:39:35,320764.77,320764.769999985
"3813",2017-09-15 19:39:35,211856.1,532620.869999985
"17509",2017-09-15 19:39:35,315981.74,848602.609999985
"17510",2017-09-15 19:39:35,360243.88,1208846.48999999
"3814",2017-09-15 19:47:44,-532620.87,676225.619999985
"17511",2017-09-15 19:47:44,229797.65,906023.269999985
"17512",2017-09-15 19:47:44,-676225.62,229797.649999985
"17513",2017-09-15 19:59:08,-229797.65,-1.48720573633909e-08
"3815",2017-09-15 20:04:23,357335.89,357335.889999985
"3816",2017-09-15 20:09:46,-357335.89,-1.49011611938477e-08
"17514",2017-09-15 20:14:18,213287.86,213287.859999985
"17515",2017-09-15 20:22:16,-213287.86,-1.49011611938477e-08
"3817",2017-09-15 21:21:04,295886.59,295886.589999985
"3818",2017-09-15 21:24:25,-295886.59,-1.49011611938477e-08
"17516",2017-09-15 21:41:43,205004.64,205004.639999985
"17517",2017-09-15 21:41:43,348359.84,553364.479999985
"17518",2017-09-15 21:54:23,-553364.48,-1.49011611938477e-08
"3819",2017-09-15 22:43:04,426801.58,426801.579999985
"3820",2017-09-15 22:43:04,427858.51,854660.089999985
"3821",2017-09-15 22:55:21,-854660.09,-1.47847458720207e-08
"17519",2017-09-15 22:55:21,233791.01,233791.009999985
"17520",2017-09-15 23:07:32,-233791.01,-1.47847458720207e-08
"3822",2017-09-16 00:03:49,215176.94,215176.939999985
"3823",2017-09-16 00:14:07,-215176.94,-1.47847458720207e-08
"17521",2017-09-16 00:48:35,233138.15,233138.149999985
"17522",2017-09-16 01:09:06,-233138.15,-1.47847458720207e-08
"17523",2017-09-16 01:09:06,248736.51,248736.509999985
"17524",2017-09-16 01:17:19,-248736.51,-1.47847458720207e-08
"17525",2017-09-16 01:33:26,281184.22,281184.219999985
"17526",2017-09-16 01:37:19,-281184.22,-1.47847458720207e-08
"17527",2017-09-16 01:49:53,220663.44,220663.439999985
"17528",2017-09-16 02:04:25,-220663.44,-1.47847458720207e-08
"17529",2017-09-16 03:34:05,544807.71,544807.709999985
"3824",2017-09-16 04:07:38,267088.13,811895.839999985
"17530",2017-09-16 04:07:38,395898.73,1207794.56999999
"17531",2017-09-16 04:07:38,284205.2,1491999.76999999
"17532",2017-09-16 04:07:38,-544807.71,947192.059999985
"17533",2017-09-16 04:07:38,-544807.71,402384.349999985
"3825",2017-09-16 04:21:48,-267088.13,135296.219999985
"17534",2017-09-16 04:21:48,-135296.22,-1.48138497024775e-08
"3826",2017-09-16 04:39:41,239169.97,239169.969999985
"3827",2017-09-16 04:44:56,-239169.97,-1.48138497024775e-08
"3828",2017-09-16 05:17:03,251603.42,251603.419999985
"3829",2017-09-16 05:24:06,-251603.42,-1.48138497024775e-08
"17535",2017-09-16 06:34:15,777782.11,777782.109999985
"17536",2017-09-16 06:34:15,25951.12,803733.229999985
"17537",2017-09-16 06:34:15,319494.29,1123227.51999999
"17538",2017-09-16 06:41:13,-1123227.52,-1.49011611938477e-08
"3830",2017-09-16 06:54:50,233445.22,233445.219999985
"3831",2017-09-16 07:08:03,-233445.22,-1.49011611938477e-08
"3832",2017-09-16 07:20:59,432401.85,432401.849999985
"3833",2017-09-16 07:28:12,-432401.85,-1.49011611938477e-08
"17539",2017-09-16 08:36:34,415465.5,415465.499999985
"17540",2017-09-16 09:05:10,-415465.5,-1.49011611938477e-08
"3834",2017-09-16 10:34:57,212215.06,212215.059999985
"3835",2017-09-16 10:34:57,200728.75,412943.809999985
"3836",2017-09-16 10:34:57,256510.34,669454.149999985
"3837",2017-09-16 10:34:57,402252.12,1071706.26999999
"17541",2017-09-16 10:34:57,407957.57,1479663.83999999
"17542",2017-09-16 10:34:57,258624.88,1738288.71999999
"17543",2017-09-16 10:34:57,336397.03,2074685.74999999
"3838",2017-09-16 10:44:35,-1071706.27,1002979.47999999
"17544",2017-09-16 10:44:35,316982.56,1319962.03999999
"17545",2017-09-16 10:44:35,-1002979.48,316982.559999985
"17546",2017-09-16 10:51:29,-316982.56,-1.46101228892803e-08
"3839",2017-09-16 11:12:42,265650.8,265650.799999985
"3840",2017-09-16 11:12:42,700005.32,965656.119999985
"3841",2017-09-16 11:12:42,378498.3,1344154.41999999
"17547",2017-09-16 11:12:42,397642.82,1741797.23999999
"3842",2017-09-16 11:19:13,-1344154.42,397642.819999985
"17548",2017-09-16 11:19:13,-397642.82,-1.46101228892803e-08
"17549",2017-09-16 11:58:34,544155.01,544155.009999985
"17550",2017-09-16 12:04:16,-544155.01,-1.46683305501938e-08
"17551",2017-09-16 13:42:50,325727.49,325727.489999985
"17552",2017-09-16 13:53:14,304892.02,630619.509999985
"17553",2017-09-16 13:58:39,324678.16,955297.669999985
"17554",2017-09-16 14:44:14,310359.54,1265657.20999999
"17555",2017-09-16 15:20:14,419094.17,1684751.37999999
"17556",2017-09-16 16:06:03,372838.83,2057590.20999999
"3843",2017-09-16 16:16:22,464264.97,2521855.17999999
"3844",2017-09-16 16:26:01,-464264.97,2057590.20999999
"17557",2017-09-16 16:31:25,339150.55,2396740.75999999
"17558",2017-09-16 16:41:39,484357.02,2881097.77999999
"3845",2017-09-16 21:26:39,503729.78,3384827.55999999
"3846",2017-09-16 21:26:39,532505.97,3917333.52999999
"3847",2017-09-16 21:34:20,-1036235.75,2881097.77999999
"17559",2017-09-16 21:57:21,301450.16,3182547.93999999
"3848",2017-09-17 02:47:12,400955.61,3583503.54999999
"3849",2017-09-17 02:56:02,-400955.61,3182547.93999999
"3850",2017-09-17 04:07:27,466928.21,3649476.14999999
"3851",2017-09-17 04:14:31,-466928.21,3182547.93999999
"3852",2017-09-17 05:09:03,297248.74,3479796.67999999
"3853",2017-09-17 05:11:46,-297248.74,3182547.93999999
"3854",2017-09-17 05:38:29,283739.3,3466287.23999999
"3855",2017-09-17 05:44:06,-283739.3,3182547.93999999
"3856",2017-09-17 06:31:23,454475.52,3637023.45999999
"3857",2017-09-17 06:51:36,-454475.52,3182547.93999999
"3858",2017-09-17 08:23:24,320196.48,3502744.41999999
"3859",2017-09-17 08:23:24,284611.61,3787356.02999999
"3860",2017-09-17 08:37:44,283912.79,4071268.81999999
"3861",2017-09-17 08:37:44,-604808.09,3466460.72999999
"3862",2017-09-17 08:46:29,294265.43,3760726.15999999
"3863",2017-09-17 08:46:29,-283912.79,3476813.36999999
"3864",2017-09-17 08:56:10,-294265.43,3182547.93999999
"3865",2017-09-17 09:58:18,453643.65,3636191.58999999
"3866",2017-09-17 10:07:28,-453643.65,3182547.93999999
"17560",2017-09-17 17:43:03,325561.94,3508109.87999999
"3867",2017-09-17 18:56:31,296246.4,3804356.27999999
"3868",2017-09-17 18:56:31,26573.04,3830929.31999999
"3869",2017-09-17 18:59:09,-322819.44,3508109.87999999
"3870",2017-09-17 19:45:39,313369.8,3821479.67999999
"3871",2017-09-17 20:36:58,-313369.8,3508109.87999999
"17561",2017-09-17 20:36:58,347846.78,3855956.65999999
"3872",2017-09-17 22:19:48,272163.08,4128119.73999999
"3873",2017-09-17 22:19:48,23338.04,4151457.77999999
"3874",2017-09-17 22:19:48,29654.96,4181112.73999999
"3875",2017-09-17 22:23:47,-325156.08,3855956.65999999
"3876",2017-09-18 00:02:29,365704.7,4221661.35999999
"3877",2017-09-18 00:13:12,-365704.7,3855956.65999999
"17562",2017-09-18 01:20:26,275747.67,4131704.32999999
"17563",2017-09-18 01:32:05,355356.56,4487060.88999998
"3878",2017-09-18 06:09:28,44834.42,4531895.30999998
"3879",2017-09-18 06:18:45,-44834.42,4487060.88999998
"3880",2017-09-18 07:06:11,318383.73,4805444.61999998
"3881",2017-09-18 07:28:50,-318383.73,4487060.88999998
"3882",2017-09-18 08:23:21,327445.54,4814506.42999998
"3883",2017-09-18 08:43:15,-327445.54,4487060.88999998
"3884",2017-09-18 09:46:46,300735.44,4787796.32999998
"3885",2017-09-18 09:46:46,331863.74,5119660.06999998
"3886",2017-09-18 11:19:06,415461.02,5535121.08999998
"3887",2017-09-18 11:53:31,-632599.18,4902521.90999999
"3888",2017-09-18 12:04:26,-415461.02,4487060.88999999
"17564",2017-09-18 12:27:14,49538.11,4536598.99999999
"17565",2017-09-18 12:32:43,487909.82,5024508.81999999
"17566",2017-09-18 14:46:26,15410.71,5039919.52999999
"17567",2017-09-18 14:46:26,25817.08,5065736.60999999
"17568",2017-09-18 14:46:26,17137.02,5082873.62999999
"17569",2017-09-18 14:54:10,300593.18,5383466.80999999
"3889",2017-09-18 15:18:19,686503.94,6069970.74999999
"3890",2017-09-18 15:18:19,700006.42,6769977.16999999
"17570",2017-09-18 15:18:19,222965.53,6992942.69999999
"3891",2017-09-18 15:30:56,-1386510.36,5606432.33999998
"17571",2017-09-18 15:50:31,15738.7,5622171.03999999
"17572",2017-09-18 16:20:51,393699.6,6015870.63999998
"3892",2017-09-18 16:23:51,235463.92,6251334.55999998
"3893",2017-09-18 16:36:08,700006.5,6951341.05999998
"3894",2017-09-18 16:36:08,264963,7216304.05999998
"3895",2017-09-18 16:36:08,261112.26,7477416.31999998
"3896",2017-09-18 16:36:08,37877.23,7515293.54999998
"3897",2017-09-18 16:36:08,-235463.92,7279829.62999998
"3898",2017-09-18 16:50:54,-1263958.99,6015870.63999998
"3899",2017-09-18 18:23:44,213581.67,6229452.30999998
"3900",2017-09-18 19:04:43,41612.25,6271064.55999998
"3901",2017-09-18 19:04:43,-213581.67,6057482.88999998
"3902",2017-09-18 19:18:16,-41612.25,6015870.63999998
"3903",2017-09-18 21:23:08,183833.69,6199704.32999999
"3904",2017-09-18 21:40:52,218345.46,6418049.78999999
"3905",2017-09-18 21:40:52,34734.98,6452784.76999999
"3906",2017-09-18 21:40:52,9157.42,6461942.18999999
"3907",2017-09-18 21:43:59,-183833.69,6278108.49999999
"3908",2017-09-18 22:10:53,195385.91,6473494.40999999
"17573",2017-09-18 22:10:53,252213.63,6725708.03999999
"17574",2017-09-18 22:10:53,406234.45,7131942.48999999
"3909",2017-09-18 22:19:46,500006.66,7631949.14999999
"3910",2017-09-18 22:19:46,-262237.86,7369711.28999999
"3911",2017-09-18 22:59:21,-695392.57,6674318.71999998
"3912",2017-09-19 00:35:38,206267.77,6880586.48999998
"3913",2017-09-19 00:53:27,176490.5,7057076.98999998
"3914",2017-09-19 00:53:27,-206267.77,6850809.21999998
"3915",2017-09-19 01:08:52,-176490.5,6674318.71999998
"3916",2017-09-19 02:00:20,236407.26,6910725.97999998
"3917",2017-09-19 02:09:19,-236407.26,6674318.71999998
"17575",2017-09-19 03:05:47,29884.65,6704203.36999999
"3918",2017-09-19 04:09:37,307911.69,7012115.05999999
"17576",2017-09-19 04:09:37,182804.8,7194919.85999999
"17577",2017-09-19 04:09:37,173592,7368511.85999999
"17578",2017-09-19 04:09:37,188841.36,7557353.21999999
"3919",2017-09-19 04:18:51,-307911.69,7249441.52999999
"3920",2017-09-19 05:30:11,367737.14,7617178.66999999
"3921",2017-09-19 05:30:11,232798.06,7849976.72999998
"3922",2017-09-19 05:30:11,182681.91,8032658.63999998
"17579",2017-09-19 05:30:11,324054.19,8356712.82999999
"17580",2017-09-19 05:31:29,266016.6,8622729.42999998
"3923",2017-09-19 05:48:40,-783217.11,7839512.31999998
"17581",2017-09-19 05:48:40,226705.84,8066218.15999998
"3924",2017-09-19 06:04:38,306790.51,8373008.66999998
"3925",2017-09-19 06:04:38,244348.87,8617357.53999998
"17582",2017-09-19 06:04:38,215984.38,8833341.91999999
"17583",2017-09-19 06:04:38,83413.35,8916755.26999998
"3926",2017-09-19 06:15:07,186243.52,9102998.78999998
"3927",2017-09-19 06:15:07,-551139.38,8551859.40999998
"3928",2017-09-19 06:42:30,-186243.52,8365615.88999998
"17584",2017-09-19 06:42:30,221203.99,8586819.87999998
"17585",2017-09-19 06:42:30,309244.14,8896064.01999998
"17586",2017-09-19 06:49:28,313192.21,9209256.22999999
"17587",2017-09-19 07:56:54,190169.35,9399425.57999999
"17588",2017-09-19 07:56:54,192410.37,9591835.94999998
"3929",2017-09-19 08:27:40,222333.66,9814169.60999998
"17589",2017-09-19 08:27:40,268843.9,10083013.51
"3930",2017-09-19 08:53:34,206508.52,10289522.03
"3931",2017-09-19 08:53:34,-222333.66,10067188.37
"3932",2017-09-19 09:02:39,-206508.52,9860679.84999998
"17590",2017-09-19 09:27:56,10517.63,9871197.47999999
"3933",2017-09-19 14:15:51,218413.08,10089610.56
"3934",2017-09-19 14:20:28,-218413.08,9871197.47999999
"17591",2017-09-19 15:31:18,10413.12,9881610.59999998
"17592",2017-09-19 15:59:12,319390.05,10201000.65
"3935",2017-09-19 16:40:11,307650.71,10508651.36
"3936",2017-09-19 16:43:21,19293.15,10527944.51
"3937",2017-09-19 16:43:21,-307650.71,10220293.8
"17593",2017-09-19 16:43:21,32352.96,10252646.76
"3938",2017-09-19 17:02:19,-19293.15,10233353.61
"17594",2017-09-19 17:18:48,-10233353.61,-1.30385160446167e-08
"17595",2017-09-19 17:18:48,266690.91,266690.909999987
"17596",2017-09-19 17:38:50,-266690.91,-1.30385160446167e-08
"3939",2017-09-19 20:01:14,345796.94,345796.939999987
"3940",2017-09-19 20:01:14,201499.35,547296.289999987
"17597",2017-09-19 20:01:14,460518.6,1007814.88999999
"17598",2017-09-19 20:03:09,259098.84,1266913.72999999
"3941",2017-09-19 20:07:58,-547296.29,719617.439999987
"17599",2017-09-19 20:07:58,-719617.44,-1.30385160446167e-08
"3942",2017-09-19 20:19:34,208733.01,208733.009999987
"3943",2017-09-19 20:33:16,189597.44,398330.449999987
"3944",2017-09-19 20:33:16,-208733.01,189597.439999987
"3945",2017-09-19 20:37:42,376804.62,566402.059999987
"3946",2017-09-19 20:37:42,-189597.44,376804.619999987
"3947",2017-09-19 20:53:25,-376804.62,-1.29803083837032e-08
"17600",2017-09-19 21:11:07,228014.57,228014.569999987
"17601",2017-09-19 21:14:13,-228014.57,-1.29803083837032e-08
"17602",2017-09-19 21:25:26,228036.01,228036.009999987
"17603",2017-09-19 21:34:26,-228036.01,-1.29803083837032e-08
"17604",2017-09-19 22:22:45,216112.03,216112.029999987
"3948",2017-09-19 22:45:13,201995.84,418107.869999987
"3949",2017-09-19 22:45:13,32387.43,450495.299999987
"17605",2017-09-19 22:45:13,-216112.03,234383.269999987
"3950",2017-09-19 22:59:54,-234383.27,-1.29803083837032e-08
"3951",2017-09-19 23:44:18,196802.34,196802.339999987
"3952",2017-09-19 23:49:02,-196802.34,-1.29803083837032e-08
"3953",2017-09-20 01:20:04,221640.3,221640.299999987
"3954",2017-09-20 01:28:24,-221640.3,-1.29803083837032e-08
"3955",2017-09-20 02:33:27,411708.19,411708.189999987
"3956",2017-09-20 02:51:57,-411708.19,-1.29803083837032e-08
"17606",2017-09-20 05:40:22,319115.42,319115.419999987
"17607",2017-09-20 05:56:18,250896.81,570012.229999987
"17608",2017-09-20 05:56:18,201855.61,771867.839999987
"17609",2017-09-20 05:56:18,31460,803327.839999987
"17610",2017-09-20 06:32:32,316238.43,1119566.26999999
"17611",2017-09-20 06:54:16,-1119566.27,-1.30385160446167e-08
"17612",2017-09-20 07:28:21,215401.79,215401.789999987
"3957",2017-09-20 07:55:14,236721.84,452123.629999987
"17613",2017-09-20 07:55:14,-215401.79,236721.839999987
"3958",2017-09-20 08:23:45,-236721.84,-1.30385160446167e-08
"17614",2017-09-20 14:23:11,526642.97,526642.969999987
"17615",2017-09-20 14:29:10,-526642.97,-1.30385160446167e-08
"3959",2017-09-21 02:06:13,336099.06,336099.059999987
"3960",2017-09-21 02:18:36,83428.53,419527.589999987
"3961",2017-09-21 02:18:36,-336099.06,83428.5299999869
"3962",2017-09-21 02:27:44,-83428.53,-1.30676198750734e-08
"17616",2017-09-21 02:50:07,286573.09,286573.089999987
"17617",2017-09-21 02:50:07,16909.18,303482.269999987
"3963",2017-09-21 04:03:28,340438.31,643920.579999987
"3964",2017-09-21 04:17:22,269884.6,913805.179999987
"3965",2017-09-21 04:17:22,-340438.31,573366.869999987
"3966",2017-09-21 04:24:48,-269884.6,303482.269999987
"3967",2017-09-21 06:35:39,99336.4,402818.669999987
"3968",2017-09-21 06:58:07,-99336.4,303482.269999987
"3969",2017-09-21 07:16:41,27306.53,330788.799999987
"3970",2017-09-21 07:20:35,-27306.53,303482.269999987
"3971",2017-09-21 08:22:11,260021.9,563504.169999987
"3972",2017-09-21 08:31:15,-260021.9,303482.269999987
"3973",2017-09-21 12:47:22,38705.09,342187.359999987
"3974",2017-09-21 12:47:22,18844.18,361031.539999987
"3975",2017-09-21 12:51:03,-57549.27,303482.269999987
"3976",2017-09-21 15:15:36,195720.42,499202.689999987
"3977",2017-09-21 15:15:36,22624.18,521826.869999987
"3978",2017-09-21 15:31:09,348833.7,870660.569999987
"3979",2017-09-21 15:31:09,-218344.6,652315.969999987
"3980",2017-09-21 15:45:51,500008.51,1152324.47999999
"3981",2017-09-21 15:45:51,380709.44,1533033.91999999
"3982",2017-09-21 15:45:51,-348833.7,1184200.21999999
"17618",2017-09-21 15:45:51,180372.64,1364572.85999999
"17619",2017-09-21 15:45:51,24977.06,1389549.91999999
"3983",2017-09-21 16:00:01,-880717.95,508831.969999987
"17620",2017-09-21 16:00:01,9949.59,518781.559999987
"17621",2017-09-21 16:00:01,10561.27,529342.829999987
"3984",2017-09-21 16:26:10,347358.43,876701.259999987
"3985",2017-09-21 16:26:10,179336.91,1056038.16999999
"17622",2017-09-21 16:26:10,263981.55,1320019.71999999
"17623",2017-09-21 16:26:10,248672.54,1568692.25999999
"3986",2017-09-21 16:48:25,700008.6,2268700.85999999
"3987",2017-09-21 16:48:25,184574.62,2453275.47999999
"3988",2017-09-21 16:48:25,-526695.34,1926580.13999999
"3989",2017-09-21 16:56:24,-884583.22,1041996.91999999
"17624",2017-09-21 16:56:24,14165.91,1056162.82999999
"3990",2017-09-21 17:11:19,700008.63,1756171.45999999
"17625",2017-09-21 17:11:19,212538.58,1968710.03999999
"3991",2017-09-21 17:21:32,-700008.63,1268701.40999999
"3992",2017-09-21 17:55:16,173742.58,1442443.98999999
"3993",2017-09-21 18:14:07,178192.35,1620636.33999999
"3994",2017-09-21 18:14:07,293133.92,1913770.25999999
"3995",2017-09-21 18:14:07,-173742.58,1740027.67999999
"3996",2017-09-21 18:21:09,210088.39,1950116.06999999
"3997",2017-09-21 18:21:09,134272.67,2084388.73999999
"3998",2017-09-21 18:21:09,-471326.27,1613062.46999999
"3999",2017-09-21 18:25:54,-344361.06,1268701.40999999
"4000",2017-09-21 19:01:09,454208.06,1722909.46999999
"17626",2017-09-21 19:01:09,259195.86,1982105.32999999
"4001",2017-09-21 19:11:01,200212.2,2182317.52999999
"4002",2017-09-21 19:11:01,-454208.06,1728109.46999999
"4003",2017-09-21 19:22:21,-200212.2,1527897.26999999
"4004",2017-09-21 19:35:04,358726.4,1886623.66999999
"4005",2017-09-21 19:35:04,273565.08,2160188.74999999
"4006",2017-09-21 19:35:04,20250.61,2180439.35999999
"4007",2017-09-21 19:35:04,24406.18,2204845.53999999
"4008",2017-09-21 19:41:05,-676948.27,1527897.26999999
"4009",2017-09-21 19:48:16,307297.69,1835194.95999999
"4010",2017-09-21 20:01:23,300008.82,2135203.77999999
"4011",2017-09-21 20:01:23,330090.04,2465293.81999999
"4012",2017-09-21 20:01:23,-307297.69,2157996.12999999
"4013",2017-09-21 20:08:34,-630098.86,1527897.26999999
"4014",2017-09-21 20:28:48,377785.84,1905683.10999999
"4015",2017-09-21 20:28:48,319097.84,2224780.94999999
"4016",2017-09-21 20:32:44,-696883.68,1527897.26999999
"17627",2017-09-21 20:51:34,353362.65,1881259.91999999
"4017",2017-09-21 21:14:04,203442.93,2084702.84999999
"4018",2017-09-21 21:25:57,279900.59,2364603.43999999
"4019",2017-09-21 21:25:57,-203442.93,2161160.50999999
"4020",2017-09-21 21:33:41,-279900.59,1881259.91999999
"17628",2017-09-21 22:01:04,249415.11,2130675.02999999
"4021",2017-09-21 22:17:33,226734.69,2357409.71999999
"4022",2017-09-21 22:25:39,-226734.69,2130675.02999999
"17629",2017-09-21 22:47:22,258947.05,2389622.07999999
"4023",2017-09-21 23:05:07,193747.77,2583369.84999999
"4024",2017-09-21 23:23:01,-193747.77,2389622.07999999
"4025",2017-09-21 23:40:36,278098.42,2667720.49999999
"4026",2017-09-21 23:40:36,91609.52,2759330.01999999
"4027",2017-09-21 23:46:33,-369707.94,2389622.07999999
"4028",2017-09-22 00:22:29,294864.16,2684486.23999999
"17630",2017-09-22 00:23:37,244270.4,2928756.63999999
"4029",2017-09-22 00:28:48,-294864.16,2633892.47999999
"4030",2017-09-22 00:37:16,303431.13,2937323.60999999
"4031",2017-09-22 01:02:43,-303431.13,2633892.47999999
"4032",2017-09-22 01:12:45,230035.31,2863927.78999999
"4033",2017-09-22 01:18:21,-230035.31,2633892.47999999
"17631",2017-09-22 01:52:57,209188.73,2843081.20999999
"4034",2017-09-22 03:46:40,395657.33,3238738.53999999
"17632",2017-09-22 03:46:40,231988.85,3470727.38999999
"4035",2017-09-22 03:49:50,-395657.33,3075070.05999999
"17633",2017-09-22 04:24:10,277813.81,3352883.86999999
"17634",2017-09-22 04:53:10,317668.95,3670552.81999999
"17635",2017-09-22 07:56:18,258745.89,3929298.70999999
"17636",2017-09-22 08:51:10,313031.53,4242330.23999999
"4036",2017-09-22 09:10:03,218487.72,4460817.95999999
"4037",2017-09-22 09:28:50,-218487.72,4242330.23999999
"4038",2017-09-22 10:55:05,250487.37,4492817.60999999
"4039",2017-09-22 11:08:50,-250487.37,4242330.23999999
"4040",2017-09-22 11:58:25,265915.3,4508245.53999999
"4041",2017-09-22 12:31:39,195319.48,4703565.01999999
"4042",2017-09-22 12:31:39,700009.17,5403574.18999999
"4043",2017-09-22 12:31:39,285349.78,5688923.96999999
"4044",2017-09-22 12:31:39,-265915.3,5423008.66999999
"17637",2017-09-22 12:31:39,263202.76,5686211.42999999
"4045",2017-09-22 12:45:57,-1180678.43,4505532.99999999
"4046",2017-09-22 13:28:13,777786.18,5283319.17999999
"4047",2017-09-22 14:02:34,-777786.18,4505532.99999999
"17638",2017-09-22 14:02:34,34354.91,4539887.90999999
"17639",2017-09-22 14:18:19,398624.68,4938512.58999999
"17640",2017-09-22 14:39:55,341343.56,5279856.14999999
"4048",2017-09-22 17:32:58,227484.54,5507340.68999999
"4049",2017-09-22 18:03:19,329401.75,5836742.43999999
"4050",2017-09-22 18:03:19,-227484.54,5609257.89999999
"17641",2017-09-22 18:03:19,300222.72,5909480.61999999
"4051",2017-09-22 18:15:53,-329401.75,5580078.86999999
"17642",2017-09-22 19:19:15,404026.1,5984104.96999999
"17643",2017-09-22 19:55:04,225626.12,6209731.08999999
"4052",2017-09-22 21:33:18,338121.47,6547852.55999999
"4053",2017-09-22 21:42:29,-338121.47,6209731.08999999
"17644",2017-09-22 22:12:29,203407.37,6413138.45999999
"4054",2017-09-22 23:11:20,198445.41,6611583.86999999
"4055",2017-09-22 23:13:02,-198445.41,6413138.45999999
"4056",2017-09-23 02:25:40,235301.66,6648440.11999999
"4057",2017-09-23 03:04:50,-235301.66,6413138.45999999
"17645",2017-09-23 03:04:50,240499.64,6653638.09999999
"4058",2017-09-23 04:26:23,384888.64,7038526.73999999
"4059",2017-09-23 04:37:08,-384888.64,6653638.09999999
"4060",2017-09-23 05:00:47,218470.54,6872108.63999999
"4061",2017-09-23 05:04:03,-218470.54,6653638.09999999
"17646",2017-09-23 08:50:08,199994.11,6853632.20999999
"17647",2017-09-23 10:54:03,262746.81,7116379.01999999
"4062",2017-09-23 17:39:45,412893.49,7529272.50999999
"17648",2017-09-23 17:58:20,262457.04,7791729.54999999
"4063",2017-09-23 18:55:34,-412893.49,7378836.05999999
"17649",2017-09-23 23:17:35,379743.06,7758579.11999999
"17650",2017-09-24 07:54:12,296279.1,8054858.21999999
"4064",2017-09-24 08:55:11,279506.09,8334364.30999999
"4065",2017-09-24 09:29:19,-279506.09,8054858.21999999
"17651",2017-09-24 09:45:10,276600.67,8331458.88999999
"4066",2017-09-25 02:36:10,221847,8553305.88999999
"4067",2017-09-25 02:36:10,290674.13,8843980.01999999
"4068",2017-09-25 02:36:10,226625.44,9070605.45999999
"17652",2017-09-25 02:36:10,388448.07,9459053.52999999
"4069",2017-09-25 02:55:24,-739146.57,8719906.95999999
"17653",2017-09-25 02:55:24,274074.48,8993981.43999999
"17654",2017-09-25 03:08:13,295152.16,9289133.59999999
"4070",2017-09-25 15:55:57,451178.53,9740312.12999999
"4071",2017-09-25 16:14:12,-451178.53,9289133.59999999
"17655",2017-09-25 17:28:19,315237.27,9604370.86999999
"4072",2017-09-26 06:31:28,626637.88,10231008.75
"4073",2017-09-26 06:34:51,-626637.88,9604370.86999999
"17656",2017-09-26 09:55:00,454002.77,10058373.64
"17657",2017-09-26 22:43:47,-10058373.64,-1.49011611938477e-08
"17658",2017-09-27 03:37:07,670415.81,670415.809999985
"17659",2017-09-27 03:41:52,-670415.81,-1.49011611938477e-08
"17660",2017-09-27 10:47:24,659334.54,659334.539999985
"17661",2017-09-27 11:06:36,-659334.54,-1.49011611938477e-08
"17662",2017-09-28 09:03:37,552317.57,552317.569999985
"17663",2017-09-28 09:07:23,-552317.57,-1.49011611938477e-08
"17664",2017-09-28 11:04:09,777790.49,777790.489999985
"17665",2017-09-28 11:04:09,234671.5,1012461.98999999
"4074",2017-09-28 11:14:25,433007.45,1445469.43999999
"17666",2017-09-28 11:14:25,-1012461.99,433007.449999985
"4075",2017-09-28 11:20:29,-433007.45,-1.49593688547611e-08
"4076",2017-09-28 11:58:45,534471.64,534471.639999985
"4077",2017-09-28 12:31:01,-534471.64,-1.50175765156746e-08
"17667",2017-09-28 12:31:01,705372.28,705372.279999985
"17668",2017-09-28 12:45:27,-705372.28,-1.50175765156746e-08
"4078",2017-09-28 14:48:17,468881.72,468881.719999985
"4079",2017-09-28 14:48:17,494588.58,963470.299999985
"4080",2017-09-28 14:54:25,777790.58,1741260.87999998
"4081",2017-09-28 14:54:25,-963470.3,777790.579999985
"4082",2017-09-28 15:14:56,800013.59,1577804.16999999
"4083",2017-09-28 15:14:56,-777790.58,800013.589999985
"4084",2017-09-28 15:23:21,-800013.59,-1.49011611938477e-08
"17669",2017-09-28 15:31:58,80013.6,80013.5999999851
"17670",2017-09-28 15:51:55,549693.23,629706.829999985
"4085",2017-09-28 16:02:25,326308.15,956014.979999985
"4086",2017-09-28 16:19:58,-326308.15,629706.829999985
"4087",2017-09-28 17:30:11,390698.44,1020405.26999999
"4088",2017-09-28 17:39:27,-390698.44,629706.829999985
"4089",2017-09-28 18:55:48,441502,1071208.82999999
"4090",2017-09-28 19:01:09,-441502,629706.829999985
"4091",2017-09-28 19:08:59,47152.22,676859.049999985
"4092",2017-09-28 19:30:11,500254.88,1177113.92999999
"4093",2017-09-28 19:30:11,-47152.22,1129961.70999999
"4094",2017-09-28 19:35:11,-500254.88,629706.829999985
"4095",2017-09-28 20:20:48,447679.17,1077385.99999999
"4096",2017-09-28 20:29:13,-447679.17,629706.829999985
"17671",2017-09-28 20:29:13,321214.36,950921.189999985
"17672",2017-09-28 22:00:29,612768.09,1563689.27999999
"4097",2017-09-29 03:13:20,777787.74,2341477.01999999
"4098",2017-09-29 03:13:20,238939.75,2580416.76999999
"4099",2017-09-29 03:13:20,444420.97,3024837.73999999
"17673",2017-09-29 03:13:20,62534.97,3087372.70999999
"17674",2017-09-29 03:13:20,88750.34,3176123.04999999
"17675",2017-09-29 03:20:29,281108.95,3457231.99999999
"4100",2017-09-29 03:31:24,-1461148.46,1996083.53999999
"17676",2017-09-29 03:37:28,690941.35,2687024.88999999
"17677",2017-09-29 03:49:13,163658.56,2850683.44999999
"4101",2017-09-29 04:01:44,777787.81,3628471.25999999
"4102",2017-09-29 04:01:44,447113.82,4075585.07999999
"4103",2017-09-29 04:16:26,888898.83,4964483.90999999
"4104",2017-09-29 04:16:26,-1224901.63,3739582.27999999
"17678",2017-09-29 04:16:26,157876.78,3897459.05999999
"4105",2017-09-29 04:32:04,-888898.83,3008560.22999999
"17679",2017-09-29 04:45:25,757873.59,3766433.81999998
"4106",2017-09-29 05:05:45,381409.75,4147843.56999998
"17680",2017-09-29 05:05:45,777787.86,4925631.42999998
"17681",2017-09-29 05:05:45,117030.87,5042662.29999998
"17682",2017-09-29 05:05:45,700010.89,5742673.18999998
"4107",2017-09-29 05:10:13,-381409.75,5361263.43999998
"4108",2017-09-29 05:44:08,384884.92,5746148.35999998
"4109",2017-09-29 05:45:51,533623.69,6279772.04999998
"4110",2017-09-29 05:45:51,-384884.92,5894887.12999998
"4111",2017-09-29 06:02:46,-533623.69,5361263.43999998
"4112",2017-09-29 06:28:54,598755.45,5960018.88999998
"4113",2017-09-29 06:51:04,28472.03,5988490.91999999
"4114",2017-09-29 06:51:04,-598755.45,5389735.46999998
"4115",2017-09-29 07:10:39,-28472.03,5361263.43999998
"4116",2017-09-29 07:26:47,158224.92,5519488.35999998
"4117",2017-09-29 07:35:16,-158224.92,5361263.43999998
"4118",2017-09-29 10:13:43,700011.39,6061274.82999998
"17683",2017-09-29 10:13:43,77788.43,6139063.25999998
"4119",2017-09-29 10:25:13,-700011.39,5439051.86999998
"17684",2017-09-29 11:36:37,777788.61,6216840.47999998
"17685",2017-09-29 11:36:37,671884.62,6888725.09999998
"4120",2017-09-29 15:51:24,777788.02,7666513.11999998
"17686",2017-09-29 15:51:24,515078.88,8181591.99999998
"4121",2017-09-29 15:54:36,-777788.02,7403803.97999998
"4122",2017-09-30 00:02:47,77788.67,7481592.64999998
"4123",2017-09-30 00:08:32,-77788.67,7403803.97999998
"4124",2017-09-30 01:27:11,658852.58,8062656.55999998
"4125",2017-09-30 01:33:55,-658852.58,7403803.97999998
"17687",2017-10-01 03:55:51,746514.85,8150318.82999998
"4126",2017-10-01 04:13:33,416178.73,8566497.55999998
"4127",2017-10-01 04:21:01,-416178.73,8150318.82999998
"4128",2017-10-03 06:48:19,565657.8,8715976.62999998
"4129",2017-10-03 07:09:50,38341.27,8754317.89999998
"4130",2017-10-03 07:09:50,-565657.8,8188660.09999998
"4131",2017-10-03 07:16:44,-38341.27,8150318.82999998
"4132",2017-10-03 10:44:36,269867.89,8420186.71999998
"4133",2017-10-03 10:47:43,-269867.89,8150318.82999998
"17688",2017-10-03 11:07:42,447470.05,8597788.87999998
"4134",2017-10-03 11:24:33,284163.89,8881952.76999998
"4135",2017-10-03 11:39:19,-284163.89,8597788.87999998
"4136",2017-10-03 12:12:02,63427.56,8661216.43999998
"4137",2017-10-03 12:21:27,-63427.56,8597788.87999998
"4138",2017-10-03 13:25:59,560941.21,9158730.08999998
"4139",2017-10-03 13:29:43,-560941.21,8597788.87999998
"4140",2017-10-03 13:59:53,276968.74,8874757.61999998
"4141",2017-10-03 14:03:02,497309.08,9372066.69999998
"4142",2017-10-03 14:13:14,-276968.74,9095097.95999998
"4143",2017-10-03 14:19:07,-497309.08,8597788.87999998
"4144",2017-10-03 14:38:29,777789.18,9375578.05999998
"4145",2017-10-03 14:51:40,-777789.18,8597788.87999998
"17689",2017-10-03 16:35:36,241030.03,8838818.90999998
"17690",2017-10-03 22:46:35,316773.6,9155592.50999998
"17691",2017-10-03 23:35:30,365155.34,9520747.84999998
"17692",2017-10-04 00:13:43,309215.16,9829963.00999998
"4146",2017-10-04 13:12:27,207478.02,10037441.03
"4147",2017-10-04 13:24:42,30949.51,10068390.54
"4148",2017-10-04 13:24:42,-207478.02,9860912.51999998
"4149",2017-10-04 14:10:05,-30949.51,9829963.00999998
"4150",2017-10-04 14:33:12,186936.06,10016899.07
"17693",2017-10-04 14:33:12,186203.61,10203102.68
"4151",2017-10-04 14:52:48,182179.75,10385282.43
"4152",2017-10-04 14:52:48,-186936.06,10198346.37
"4153",2017-10-04 15:15:09,144279.1,10342625.47
"4154",2017-10-04 15:15:09,-182179.75,10160445.72
"4155",2017-10-04 15:50:07,-144279.1,10016166.62
"17694",2017-10-04 16:40:34,295596.89,10311763.51
"17695",2017-10-04 19:11:23,155170.48,10466933.99
"17696",2017-10-04 19:36:59,155241.33,10622175.32
"17697",2017-10-04 20:59:15,267114.93,10889290.25
"4156",2017-10-04 21:16:36,223934.78,11113225.03
"4157",2017-10-04 21:51:09,-223934.78,10889290.25
"17698",2017-10-04 22:53:58,235591.45,11124881.7
"4158",2017-10-05 03:15:33,177696.15,11302577.85
"4159",2017-10-05 03:17:44,-177696.15,11124881.7
"17699",2017-10-05 03:59:57,-11124881.7,-1.67638063430786e-08
"4160",2017-10-05 04:38:36,215539.82,215539.819999983
"4161",2017-10-05 04:53:07,-215539.82,-1.67638063430786e-08
"4162",2017-10-05 05:49:33,276626.82,276626.819999983
"4163",2017-10-05 06:02:28,-276626.82,-1.67638063430786e-08
"4164",2017-10-05 06:08:10,194347.02,194347.019999983
"4165",2017-10-05 06:25:15,-194347.02,-1.67638063430786e-08
"17700",2017-10-05 06:25:15,214795.56,214795.559999983
"17701",2017-10-05 06:39:30,190581.19,405376.749999983
"17702",2017-10-05 06:39:30,-214795.56,190581.189999983
"4166",2017-10-05 06:47:03,15872.89,206454.079999983
"4167",2017-10-05 06:47:03,211774.14,418228.219999983
"17703",2017-10-05 06:47:03,-190581.19,227647.029999983
"4168",2017-10-05 06:52:32,-227647.03,-1.67347025126219e-08
"4169",2017-10-05 07:01:46,136463.2,136463.199999983
"4170",2017-10-05 07:18:30,-136463.2,-1.67347025126219e-08
"17704",2017-10-05 09:23:49,143156.26,143156.259999983
"17705",2017-10-05 09:35:42,-143156.26,-1.67347025126219e-08
"17706",2017-10-05 10:08:38,177267.07,177267.069999983
"17707",2017-10-05 10:11:03,-177267.07,-1.67347025126219e-08
"4171",2017-10-05 10:45:08,170731.07,170731.069999983
"4172",2017-10-05 11:29:14,-170731.07,-1.67347025126219e-08
"17708",2017-10-05 12:20:25,219162.99,219162.989999983
"17709",2017-10-05 12:33:29,-219162.99,-1.67347025126219e-08
"4173",2017-10-05 22:41:33,346908.4,346908.399999983
"4174",2017-10-05 22:47:31,-346908.4,-1.67638063430786e-08
"17710",2017-10-05 23:10:00,269009.33,269009.329999983
"17711",2017-10-05 23:17:23,-269009.33,-1.67638063430786e-08
"17712",2017-10-06 07:03:22,463577.96,463577.959999983
"17713",2017-10-06 07:12:02,-463577.96,-1.67638063430786e-08
"17714",2017-10-06 09:52:43,285671.77,285671.769999983
"17715",2017-10-06 10:02:29,433349.62,719021.389999983
"17716",2017-10-06 10:02:29,-285671.77,433349.619999983
"17717",2017-10-06 10:02:29,-285671.77,147677.849999983
"17718",2017-10-06 10:10:54,-147677.85,-1.67929101735353e-08
"17719",2017-10-06 11:58:54,289234.44,289234.439999983
"17720",2017-10-06 14:14:58,405097.82,694332.259999983
"17721",2017-10-06 23:20:00,448121.4,1142453.65999998
"17722",2017-10-06 23:52:23,549975,1692428.65999998
"4175",2017-10-07 00:45:34,605924.63,2298353.28999998
"4176",2017-10-07 01:28:34,-605924.63,1692428.65999998
"4177",2017-10-07 23:03:54,412958.55,2105387.20999998
"4178",2017-10-07 23:07:56,-412958.55,1692428.65999998
"4179",2017-10-07 23:38:15,382380.94,2074809.59999998
"4180",2017-10-07 23:42:47,-382380.94,1692428.65999998
"4181",2017-10-08 00:18:41,585893.49,2278322.14999998
"4182",2017-10-08 00:24:19,-585893.49,1692428.65999998
"17723",2017-10-09 10:01:37,363160.26,2055588.91999998
"17724",2017-10-10 00:35:25,598691.5,2654280.41999998
"4183",2017-10-10 01:13:23,619273.01,3273553.42999998
"4184",2017-10-10 01:19:43,-619273.01,2654280.41999998
"17725",2017-10-10 09:15:07,-2654280.42,-1.67638063430786e-08
"4185",2017-10-10 10:46:52,384972.82,384972.819999983
"4186",2017-10-10 11:08:54,512579.03,897551.849999983
"4187",2017-10-10 11:08:54,-384972.82,512579.029999983
"4188",2017-10-10 11:16:54,-512579.03,-1.67055986821651e-08
"4189",2017-10-10 17:12:02,475540.45,475540.449999983
"4190",2017-10-10 17:25:45,664223.33,1139763.77999998
"4191",2017-10-10 17:25:45,-475540.45,664223.329999983
"4192",2017-10-10 17:40:34,-664223.33,-1.66473910212517e-08
"17726",2017-10-12 02:34:48,777693.36,777693.359999983
"4193",2017-10-12 08:05:32,622571.62,1400264.97999998
"4194",2017-10-12 08:15:46,-622571.62,777693.359999983
"17727",2017-10-12 08:15:46,535038.98,1312732.33999998
"4195",2017-10-12 08:28:41,651228.81,1963961.14999998
"17728",2017-10-12 08:28:41,497209.14,2461170.28999998
"4196",2017-10-12 08:37:13,-651228.81,1809941.47999998
"17729",2017-10-12 08:37:13,567717.3,2377658.77999998
"4197",2017-10-12 08:46:24,470038.63,2847697.40999998
"4198",2017-10-12 08:56:50,692252.17,3539949.57999998
"4199",2017-10-12 08:56:50,-470038.63,3069910.94999998
"4200",2017-10-12 09:03:14,-692252.17,2377658.77999998
"4201",2017-10-12 09:26:05,668787.2,3046445.97999998
"4202",2017-10-12 09:51:19,-668787.2,2377658.77999998
"17730",2017-10-12 10:31:27,724252.19,3101910.96999998
"17731",2017-10-12 12:42:37,664045.34,3765956.30999998
"17732",2017-10-12 16:57:12,578219.73,4344176.03999998
"17733",2017-10-12 17:03:41,501611.35,4845787.38999998
"4203",2017-10-12 17:39:30,686553.07,5532340.45999998
"4204",2017-10-12 17:50:02,-686553.07,4845787.38999998
"4205",2017-10-13 02:26:05,692358.96,5538146.34999998
"4206",2017-10-13 02:36:57,-692358.96,4845787.38999998
"17734",2017-10-13 02:36:57,777790.86,5623578.24999998
"17735",2017-10-13 02:36:57,236932.87,5860511.11999998
"4207",2017-10-13 03:24:51,77790.89,5938302.00999998
"4208",2017-10-13 03:24:51,777790.91,6716092.91999998
"17736",2017-10-13 03:24:51,77790.88,6793883.79999998
"17737",2017-10-13 03:24:51,777790.9,7571674.69999998
"17738",2017-10-13 04:25:09,635818.82,8207493.51999998
"4209",2017-10-13 05:08:24,485668.59,8693162.10999998
"4210",2017-10-13 05:26:08,581688.61,9274850.71999998
"17739",2017-10-13 05:41:47,478671.17,9753521.88999998
"17740",2017-10-13 05:41:47,358003.18,10111525.07
"17741",2017-10-13 06:01:02,402908.86,10514433.93
"17742",2017-10-13 07:01:06,382960.28,10897394.21
"4211",2017-10-13 10:11:44,-855581.8,10041812.41
"4212",2017-10-13 10:37:38,-1067357.2,8974455.20999998
"4213",2017-10-13 10:56:51,644405.14,9618860.34999998
"17743",2017-10-13 12:11:00,699104.56,10317964.91
"17744",2017-10-13 12:56:55,602321.51,10920286.42
"17745",2017-10-13 13:41:24,619802.84,11540089.26
"17746",2017-10-13 14:18:02,489512.31,12029601.57
"17747",2017-10-13 14:43:46,563657.11,12593258.68
"4214",2017-10-13 15:26:54,705204.42,13298463.1
"4215",2017-10-13 20:05:33,-644405.14,12654057.96
"4216",2017-10-13 20:15:51,-705204.42,11948853.54
"17748",2017-10-13 20:25:37,818718.19,12767571.73
"17749",2017-10-14 02:47:09,438751.64,13206323.37
"17750",2017-10-14 06:13:33,-13206323.37,-1.67638063430786e-08
"17751",2017-10-14 23:16:45,517472.82,517472.819999983
"17752",2017-10-15 00:00:08,777791.2,1295264.01999998
"17753",2017-10-15 02:05:10,708429.16,2003693.17999998
"4217",2017-10-15 05:49:32,661589.01,2665282.18999998
"4218",2017-10-15 05:59:59,-661589.01,2003693.17999998
"4219",2017-10-15 09:37:16,686338.46,2690031.63999998
"4220",2017-10-15 10:10:22,-686338.46,2003693.17999998
"17754",2017-10-15 12:05:34,69504.58,2073197.75999998
"17755",2017-10-15 12:08:07,777791.3,2850989.05999998
"4221",2017-10-15 12:28:55,312664.56,3163653.61999998
"4222",2017-10-15 12:47:03,273576.44,3437230.05999998
"4223",2017-10-15 12:47:03,-312664.56,3124565.49999998
"4224",2017-10-15 13:11:30,-273576.44,2850989.05999998
"17756",2017-10-15 13:35:00,392231.83,3243220.88999998
"4225",2017-10-15 13:44:32,283743.57,3526964.45999998
"4226",2017-10-15 13:50:31,-283743.57,3243220.88999998
"4227",2017-10-15 17:29:32,25818.99,3269039.87999998
"4228",2017-10-15 17:29:32,241213.03,3510252.90999998
"4229",2017-10-15 17:34:35,-267032.02,3243220.88999998
"17757",2017-10-15 20:43:42,203361.56,3446582.44999998
"17758",2017-10-15 20:51:41,233077.29,3679659.73999998
"4230",2017-10-15 22:22:10,278478.66,3958138.39999998
"17759",2017-10-15 22:22:10,386800.61,4344939.00999998
"4231",2017-10-15 22:32:51,-278478.66,4066460.34999998
"17760",2017-10-15 22:32:51,485043.21,4551503.55999998
"4232",2017-10-16 02:46:02,516850.89,5068354.44999998
"4233",2017-10-16 02:48:59,-516850.89,4551503.55999998
"17761",2017-10-16 03:16:47,331756.73,4883260.28999998
"17762",2017-10-16 06:32:40,320063.73,5203324.01999998
"17763",2017-10-16 10:49:35,345668.86,5548992.87999998
"17764",2017-10-16 14:13:21,597439.91,6146432.78999999
"17765",2017-10-16 18:55:06,-6146432.79,-1.49011611938477e-08
"4234",2017-10-17 00:47:31,603363.56,603363.559999985
"4235",2017-10-17 01:14:17,-603363.56,-1.49011611938477e-08
"17766",2017-10-17 08:26:53,47784.32,47784.3199999851
"17767",2017-10-17 08:33:43,172454.04,220238.359999985
"17768",2017-10-17 08:33:43,-47784.32,172454.039999985
"17769",2017-10-17 08:49:20,-172454.04,-1.49011611938477e-08
"17770",2017-10-17 09:34:02,303582.76,303582.759999985
"17771",2017-10-17 09:39:40,-303582.76,-1.49011611938477e-08
"17772",2017-10-17 11:45:49,409816.55,409816.549999985
"17773",2017-10-17 11:56:35,-409816.55,-1.49011611938477e-08
"17774",2017-10-17 13:38:17,323367.21,323367.209999985
"17775",2017-10-17 13:51:52,273339.83,596707.039999985
"17776",2017-10-17 13:51:52,-323367.21,273339.829999985
"17777",2017-10-17 14:10:58,-273339.83,-1.49011611938477e-08
"17778",2017-10-17 17:28:34,407166.62,407166.619999985
"17779",2017-10-17 17:38:33,-407166.62,-1.49011611938477e-08
"17780",2017-10-18 02:26:19,18723.92,18723.9199999851
"17781",2017-10-18 02:51:29,174618.67,193342.589999985
"4236",2017-10-18 03:47:50,138591.16,331933.749999985
"4237",2017-10-18 03:47:50,21522.82,353456.569999985
"4238",2017-10-18 04:00:30,123488.89,476945.459999985
"4239",2017-10-18 04:00:30,-160113.98,316831.479999985
"17782",2017-10-18 04:00:30,155401.45,472232.929999985
"4240",2017-10-18 04:04:10,195116.75,667349.679999985
"4241",2017-10-18 04:12:52,-318605.64,348744.039999985
"17783",2017-10-18 04:12:52,133962.03,482706.069999985
"4242",2017-10-18 07:05:24,150015.39,632721.459999985
"17784",2017-10-18 07:05:24,150015.38,782736.839999985
"4243",2017-10-18 07:12:06,-150015.39,632721.449999985
"4244",2017-10-18 07:26:50,300015.41,932736.859999985
"17785",2017-10-18 07:26:50,120782.93,1053519.78999998
"17786",2017-10-18 07:26:50,50015.4,1103535.18999998
"4245",2017-10-18 07:44:45,-300015.41,803519.779999985
"17787",2017-10-18 07:47:32,109285.48,912805.259999985
"17788",2017-10-18 10:29:42,136704,1049509.25999998
"17789",2017-10-18 11:06:03,13458.72,1062967.97999998
"4246",2017-10-18 11:28:47,107394.37,1170362.34999998
"4247",2017-10-18 11:28:47,139723.66,1310086.00999998
"4248",2017-10-18 11:28:47,115329.69,1425415.69999998
"4249",2017-10-18 11:35:52,-362447.72,1062967.97999998
"17790",2017-10-18 11:50:14,224597.32,1287565.29999998
"17791",2017-10-18 11:50:14,144662.63,1432227.92999998
"4250",2017-10-18 12:05:56,199985.55,1632213.47999998
"17792",2017-10-18 12:05:56,182455.94,1814669.41999998
"4251",2017-10-18 12:13:26,153975.82,1968645.23999998
"4252",2017-10-18 12:13:26,-199985.55,1768659.68999998
"4253",2017-10-18 12:38:10,-153975.82,1614683.86999998
"17793",2017-10-18 12:38:10,50015.61,1664699.47999998
"4254",2017-10-18 13:23:47,171550.29,1836249.76999998
"4255",2017-10-18 13:27:47,-171550.29,1664699.47999998
"17794",2017-10-18 14:15:44,150015.7,1814715.17999998
"17795",2017-10-18 14:15:44,161343.93,1976059.10999998
"17796",2017-10-18 14:15:44,150015.69,2126074.79999998
"17797",2017-10-18 14:15:44,88903.68,2214978.47999999
"17798",2017-10-18 14:24:14,133692.74,2348671.21999998
"4256",2017-10-18 14:31:25,185717.62,2534388.83999998
"17799",2017-10-18 14:31:25,337196.98,2871585.81999998
"4257",2017-10-18 15:01:59,150869.55,3022455.36999998
"4258",2017-10-18 15:01:59,-185717.62,2836737.74999998
"17800",2017-10-18 15:01:59,199787.24,3036524.98999998
"4259",2017-10-18 15:11:21,177792.77,3214317.75999998
"4260",2017-10-18 15:11:21,-150869.55,3063448.20999998
"17801",2017-10-18 15:11:21,88903.76,3152351.96999998
"4261",2017-10-18 15:16:59,-177792.77,2974559.19999998
"17802",2017-10-18 15:58:25,232638.76,3207197.95999998
"17803",2017-10-18 15:58:25,235112.59,3442310.54999998
"17804",2017-10-18 21:06:42,253690.22,3696000.76999998
"17805",2017-10-18 21:06:42,147921.98,3843922.74999998
"17806",2017-10-18 22:11:45,141311.73,3985234.47999998
"17807",2017-10-18 22:32:20,11734.08,3996968.55999998
"17808",2017-10-19 00:05:06,136298.28,4133266.83999998
"17809",2017-10-19 00:05:06,129857.15,4263123.98999998
"17810",2017-10-19 00:17:50,142060.2,4405184.18999998
"17811",2017-10-19 00:41:19,123832.11,4529016.29999998
"17812",2017-10-19 00:56:24,121628.94,4650645.23999999
"4262",2017-10-19 01:19:34,157831.85,4808477.08999998
"4263",2017-10-19 01:19:34,143024.37,4951501.45999999
"4264",2017-10-19 01:23:23,-300856.22,4650645.23999999
"17813",2017-10-19 01:23:23,274490.14,4925135.37999998
"17814",2017-10-19 02:09:49,14769.93,4939905.30999998
"4265",2017-10-19 02:41:52,192990.09,5132895.39999998
"4266",2017-10-19 02:51:55,-192990.09,4939905.30999998
"17815",2017-10-19 03:37:35,163785.13,5103690.43999998
"4267",2017-10-19 04:03:43,200697.39,5304387.82999998
"4268",2017-10-19 04:13:07,-200697.39,5103690.43999998
"17816",2017-10-19 04:13:07,296551.76,5400242.19999998
"17817",2017-10-19 04:22:12,10471.4,5410713.59999998
"17818",2017-10-19 04:55:42,337204.97,5747918.56999998
"17819",2017-10-19 06:43:25,190792.98,5938711.54999998
"4269",2017-10-19 07:15:51,157924.05,6096635.59999998
"4270",2017-10-19 07:27:38,-157924.05,5938711.54999998
"4271",2017-10-19 07:36:54,170631.1,6109342.64999998
"4272",2017-10-19 08:08:37,9156.4,6118499.04999998
"4273",2017-10-19 08:08:37,-170631.1,5947867.94999999
"4274",2017-10-19 08:28:58,-9156.4,5938711.54999998
"17820",2017-10-19 09:32:58,190884.44,6129595.98999999
"4275",2017-10-19 10:01:10,188343.03,6317939.01999999
"4276",2017-10-19 10:14:43,-188343.03,6129595.98999999
"4277",2017-10-19 10:50:12,162448.97,6292044.95999999
"4278",2017-10-19 11:01:55,-162448.97,6129595.98999999
"17821",2017-10-19 12:46:49,217500.42,6347096.40999999
"4279",2017-10-19 13:08:15,280680.21,6627776.61999999
"4280",2017-10-19 13:18:19,-280680.21,6347096.40999999
"4281",2017-10-19 13:50:08,298414.88,6645511.28999999
"17822",2017-10-19 13:50:08,240392.32,6885903.60999999
"4282",2017-10-19 13:56:47,-298414.88,6587488.72999999
"17823",2017-10-19 14:16:49,180628.51,6768117.23999999
"4283",2017-10-19 14:54:22,178070.24,6946187.47999999
"4284",2017-10-19 15:05:08,-178070.24,6768117.23999999
"4285",2017-10-19 16:30:09,218306.49,6986423.72999999
"4286",2017-10-19 16:36:17,-218306.49,6768117.23999999
"4287",2017-10-19 18:37:34,9929.03,6778046.26999999
"4288",2017-10-19 18:50:11,-9929.03,6768117.23999999
"17824",2017-10-19 21:02:01,148850.03,6916967.26999999
"4289",2017-10-19 22:12:29,146773.86,7063741.12999999
"4290",2017-10-19 22:21:40,-146773.86,6916967.26999999
"17825",2017-10-20 03:16:25,-6916967.27,-1.39698386192322e-08
"4291",2017-10-20 03:53:06,427765.41,427765.409999986
"4292",2017-10-20 03:59:24,-427765.41,-1.39698386192322e-08
"17826",2017-10-20 05:02:00,364687.85,364687.849999986
"17827",2017-10-20 05:07:32,-364687.85,-1.39698386192322e-08
"4293",2017-10-20 14:10:29,309122.08,309122.079999986
"4294",2017-10-20 14:10:29,203886.75,513008.829999986
"4295",2017-10-20 14:43:41,300016.8,813025.629999986
"4296",2017-10-20 14:43:41,-513008.83,300016.799999986
"17828",2017-10-20 14:43:41,247159.7,547176.499999986
"17829",2017-10-20 14:43:41,193104.42,740280.919999986
"17830",2017-10-20 14:43:41,359298.19,1099579.10999999
"4297",2017-10-20 15:01:23,700016.84,1799595.94999999
"4298",2017-10-20 15:01:23,-300016.8,1499579.14999999
"17831",2017-10-20 15:01:23,347550.65,1847129.79999999
"4299",2017-10-20 15:17:11,-700016.84,1147112.95999999
"17832",2017-10-20 15:17:11,380016.85,1527129.80999999
"4300",2017-10-20 15:22:44,441787.3,1968917.10999999
"4301",2017-10-20 15:44:38,259182.29,2228099.39999999
"4302",2017-10-20 15:44:38,334955.89,2563055.28999999
"4303",2017-10-20 15:44:38,-441787.3,2121267.98999999
"17833",2017-10-20 15:44:38,438333.06,2559601.04999999
"4304",2017-10-20 15:59:26,-594138.18,1965462.86999999
"4305",2017-10-20 16:32:18,77793.96,2043256.82999999
"17834",2017-10-20 16:32:18,77793.97,2121050.79999999
"17835",2017-10-20 16:34:56,37793.95,2158844.74999999
"4306",2017-10-20 16:39:41,-77793.96,2081050.78999999
"4307",2017-10-20 16:54:36,777793.99,2858844.77999999
"17836",2017-10-20 16:54:36,777793.98,3636638.75999999
"4308",2017-10-20 17:00:01,777793.94,4414432.69999999
"4309",2017-10-20 17:00:01,777793.91,5192226.60999999
"4310",2017-10-20 17:00:01,-777793.99,4414432.61999999
"17837",2017-10-20 17:00:01,381906.7,4796339.31999999
"17838",2017-10-20 17:00:01,777793.93,5574133.24999999
"4311",2017-10-20 17:17:56,777793.9,6351927.14999999
"4312",2017-10-20 17:17:56,-1555587.85,4796339.29999999
"4313",2017-10-20 17:27:50,-777793.9,4018545.39999999
"17839",2017-10-20 18:31:50,90962.02,4109507.41999999
"17840",2017-10-20 18:31:50,777794.01,4887301.42999999
"4314",2017-10-20 19:07:19,380108.97,5267410.39999999
"4315",2017-10-20 19:33:07,-380108.97,4887301.42999999
"4316",2017-10-20 19:56:24,584902.63,5472204.05999999
"4317",2017-10-20 20:05:42,-584902.63,4887301.42999999
"17841",2017-10-21 02:30:11,650601.99,5537903.41999999
"4318",2017-10-21 03:56:58,578998.28,6116901.69999999
"4319",2017-10-21 04:07:19,-578998.28,5537903.41999999
"17842",2017-10-21 12:02:45,482307.31,6020210.72999999
"4320",2017-10-21 14:33:34,335457.93,6355668.65999999
"17843",2017-10-21 14:33:34,368801.81,6724470.46999999
"17844",2017-10-21 14:33:34,471561.59,7196032.05999999
"4321",2017-10-21 14:39:32,-335457.93,6860574.12999999
"17845",2017-10-21 16:56:17,237310.57,7097884.69999999
"17846",2017-10-21 17:06:44,182800.82,7280685.51999999
"4322",2017-10-21 17:22:09,195498.56,7476184.07999999
"17847",2017-10-21 17:22:09,235945.83,7712129.90999999
"4323",2017-10-21 17:29:39,-195498.56,7516631.34999999
"17848",2017-10-21 17:29:39,19199.72,7535831.06999999
"4324",2017-10-21 17:48:29,298365.53,7834196.59999999
"17849",2017-10-21 17:48:29,254777.26,8088973.85999999
"4325",2017-10-21 17:58:56,-298365.53,7790608.32999999
"17850",2017-10-21 17:58:56,378895.49,8169503.81999999
"17851",2017-10-21 17:58:56,9120.47,8178624.28999999
"17852",2017-10-21 18:22:29,223132.89,8401757.17999999
"17853",2017-10-21 19:20:16,217385.43,8619142.60999999
"17854",2017-10-21 20:08:39,184934.54,8804077.14999999
"17855",2017-10-21 20:08:39,184831.1,8988908.24999999
"4326",2017-10-21 21:40:16,207572.14,9196480.38999999
"4327",2017-10-21 21:58:19,-207572.14,8988908.24999999
"17856",2017-10-21 22:30:37,178478.05,9167386.29999999
"17857",2017-10-22 00:38:41,279663.39,9447049.68999999
"4328",2017-10-22 01:04:14,232181.04,9679230.72999999
"4329",2017-10-22 01:04:14,289773.32,9969004.04999999
"4330",2017-10-22 01:15:11,-521954.36,9447049.68999999
"17858",2017-10-22 01:19:08,180055.76,9627105.44999999
"17859",2017-10-22 02:16:56,204122.26,9831227.70999999
"17860",2017-10-22 02:35:15,188524.52,10019752.23
"4331",2017-10-22 03:42:25,312076.56,10331828.79
"4332",2017-10-22 03:55:03,-312076.56,10019752.23
"17861",2017-10-22 10:52:14,195600.19,10215352.42
"4333",2017-10-22 11:30:34,211984.8,10427337.22
"17862",2017-10-22 11:30:34,240694.99,10668032.21
"4334",2017-10-22 11:38:27,-211984.8,10456047.41
"4335",2017-10-22 11:52:14,363762.06,10819809.47
"17863",2017-10-22 11:52:14,269986.15,11089795.62
"17864",2017-10-22 11:52:14,165960.26,11255755.88
"4336",2017-10-22 12:08:31,377794.9,11633550.78
"4337",2017-10-22 12:08:31,358511.78,11992062.56
"4338",2017-10-22 12:08:31,-363762.06,11628300.5
"4339",2017-10-22 12:18:51,-736306.68,10891993.82
"17865",2017-10-22 12:49:46,547489.64,11439483.46
"4340",2017-10-22 14:30:05,184398.45,11623881.91
"4341",2017-10-22 14:44:23,-184398.45,11439483.46
"4342",2017-10-22 22:18:45,208603.75,11648087.21
"17866",2017-10-22 22:18:45,214757.23,11862844.44
"4343",2017-10-22 22:57:43,-208603.75,11654240.69
"17867",2017-10-22 23:33:20,258024.28,11912264.97
"4344",2017-10-22 23:46:22,222835.23,12135100.2
"4345",2017-10-22 23:52:59,-222835.23,11912264.97
"4346",2017-10-23 02:17:44,222213.23,12134478.2
"4347",2017-10-23 02:22:28,-222213.23,11912264.97
"4348",2017-10-23 05:17:18,495899.37,12408164.34
"4349",2017-10-23 05:36:31,-495899.37,11912264.97
"4350",2017-10-23 06:29:20,371926.71,12284191.68
"4351",2017-10-23 06:45:52,-371926.71,11912264.97
"17868",2017-10-23 15:17:52,-11912264.97,-1.49011611938477e-08
"17869",2017-10-23 15:23:56,7785.8,7785.7999999851
"4352",2017-10-23 15:30:38,294254.39,302040.189999985
"17870",2017-10-23 15:30:38,-7785.8,294254.389999985
"4353",2017-10-23 16:02:38,-294254.39,-1.49011611938477e-08
"17871",2017-10-23 16:02:38,126654.61,126654.609999985
"17872",2017-10-23 16:02:38,192701.74,319356.349999985
"4354",2017-10-23 16:19:10,12752.37,332108.719999985
"17873",2017-10-23 16:19:10,-319356.35,12752.3699999851
"4355",2017-10-23 16:26:19,170468.17,183220.539999985
"4356",2017-10-23 16:26:19,-12752.37,170468.169999985
"4357",2017-10-23 16:54:19,321229.35,491697.519999985
"17874",2017-10-23 16:54:19,131140.51,622838.029999985
"4358",2017-10-23 16:58:10,-170468.17,452369.859999985
"17875",2017-10-23 16:59:30,-131140.51,321229.349999985
"4359",2017-10-23 17:22:52,-321229.35,-1.49011611938477e-08
"17876",2017-10-23 17:22:52,221597.3,221597.299999985
"17877",2017-10-23 17:22:52,212349.84,433947.139999985
"4360",2017-10-23 17:29:20,158396.14,592343.279999985
"17878",2017-10-23 17:29:20,-433947.14,158396.139999985
"4361",2017-10-23 17:34:45,-158396.14,-1.49011611938477e-08
"17879",2017-10-23 18:18:24,125218.56,125218.559999985
"17880",2017-10-23 18:29:30,-125218.56,-1.49011611938477e-08
"4362",2017-10-23 19:30:04,166525.6,166525.599999985
"4363",2017-10-23 19:57:08,-166525.6,-1.49011611938477e-08
"17881",2017-10-23 19:57:08,179065.78,179065.779999985
"17882",2017-10-23 19:57:08,330847.35,509913.129999985
"17883",2017-10-23 20:16:22,177795.68,687708.809999985
"17884",2017-10-23 20:16:22,605537.46,1293246.26999999
"17885",2017-10-23 20:16:22,-509913.13,783333.139999985
"17886",2017-10-23 20:23:05,-783333.14,-1.49011611938477e-08
"4364",2017-10-23 20:37:16,504819.58,504819.579999985
"17887",2017-10-23 20:37:16,194853.72,699673.299999985
"17888",2017-10-23 20:39:23,147047.06,846720.359999985
"4365",2017-10-23 20:52:25,-504819.58,341900.779999985
"17889",2017-10-23 20:52:25,166396.46,508297.239999985
"17890",2017-10-23 20:52:25,-341900.78,166396.459999985
"17891",2017-10-23 20:59:38,-166396.46,-1.48138497024775e-08
"17892",2017-10-23 21:19:02,133582.49,133582.489999985
"17893",2017-10-23 21:30:55,-133582.49,-1.48138497024775e-08
"17894",2017-10-23 21:33:03,179655.81,179655.809999985
"17895",2017-10-23 21:36:34,-179655.81,-1.48138497024775e-08
"4366",2017-10-23 22:09:11,105292.31,105292.309999985
"4367",2017-10-23 22:09:11,5358.08,110650.389999985
"4368",2017-10-23 22:13:56,-110650.39,-1.48138497024775e-08
"4369",2017-10-23 22:24:01,4337.25,4337.24999998519
"4370",2017-10-23 23:18:38,240078.55,244415.799999985
"4371",2017-10-23 23:18:38,113700.09,358115.889999985
"4372",2017-10-23 23:18:38,177795.79,535911.679999985
"4373",2017-10-23 23:18:38,-4337.25,531574.429999985
"17896",2017-10-23 23:18:38,189251.11,720825.539999985
"17897",2017-10-23 23:18:38,338111.37,1058936.90999999
"17898",2017-10-23 23:18:38,177795.8,1236732.70999999
"4374",2017-10-23 23:21:50,300018.87,1536751.57999999
"4375",2017-10-23 23:31:27,-531574.43,1005177.14999999
"17899",2017-10-23 23:31:27,-705158.28,300018.869999985
"4376",2017-10-23 23:39:23,-300018.87,-1.49011611938477e-08
"17900",2017-10-24 00:02:16,343836.99,343836.989999985
"17901",2017-10-24 00:11:30,-343836.99,-1.49011611938477e-08
"4377",2017-10-24 00:19:48,22673.55,22673.5499999851
"4378",2017-10-24 00:23:57,-22673.55,-1.49011611938477e-08
"4379",2017-10-24 01:34:36,12740.83,12740.8299999851
"4380",2017-10-24 01:34:36,283067.19,295808.019999985
"17902",2017-10-24 01:34:36,308629.32,604437.339999985
"4381",2017-10-24 01:43:21,-295808.02,308629.319999985
"17903",2017-10-24 01:43:21,-308629.32,-1.48429535329342e-08
"17904",2017-10-24 01:58:10,164056.99,164056.989999985
"4382",2017-10-24 02:11:30,161090.06,325147.049999985
"17905",2017-10-24 02:11:30,-164056.99,161090.059999985
"4383",2017-10-24 02:14:50,273770.88,434860.939999985
"4384",2017-10-24 02:18:31,-161090.06,273770.879999985
"4385",2017-10-24 02:28:20,-273770.88,-1.48429535329342e-08
"17906",2017-10-24 02:36:36,120111.32,120111.319999985
"4386",2017-10-24 02:43:25,112470.97,232582.289999985
"17907",2017-10-24 02:43:25,-120111.32,112470.969999985
"4387",2017-10-24 02:53:29,-112470.97,-1.48429535329342e-08
"17908",2017-10-24 02:53:29,195642.46,195642.459999985
"17909",2017-10-24 03:00:01,167177.02,362819.479999985
"17910",2017-10-24 03:00:01,-195642.46,167177.019999985
"17911",2017-10-24 03:03:35,-167177.02,-1.48429535329342e-08
"4388",2017-10-24 03:21:01,123008.01,123008.009999985
"17912",2017-10-24 03:21:01,173937.34,296945.349999985
"4389",2017-10-24 03:31:06,162505.52,459450.869999985
"4390",2017-10-24 03:31:06,-123008.01,336442.859999985
"17913",2017-10-24 03:31:06,-173937.34,162505.519999985
"4391",2017-10-24 03:36:17,-162505.52,-1.49011611938477e-08
"4392",2017-10-24 03:49:32,10853.44,10853.4399999851
"17914",2017-10-24 03:49:32,180327.67,191181.109999985
"4393",2017-10-24 03:53:41,-10853.44,180327.669999985
"17915",2017-10-24 03:53:41,-180327.67,-1.49011611938477e-08
"4394",2017-10-24 04:14:11,182800.06,182800.059999985
"4395",2017-10-24 04:14:11,105956.76,288756.819999985
"4396",2017-10-24 04:14:11,124014.32,412771.139999985
"4397",2017-10-24 04:20:30,-412771.14,-1.49011611938477e-08
"17916",2017-10-24 04:39:03,191533.79,191533.789999985
"4398",2017-10-24 04:45:51,135340.27,326874.059999985
"17917",2017-10-24 04:45:51,-191533.79,135340.269999985
"4399",2017-10-24 04:58:13,112601.84,247942.109999985
"4400",2017-10-24 04:58:13,129215.96,377158.069999985
"4401",2017-10-24 04:58:13,-135340.27,241817.799999985
"4402",2017-10-24 05:32:45,-241817.8,-1.48720573633909e-08
"17918",2017-10-24 05:32:45,140694.61,140694.609999985
"17919",2017-10-24 05:32:45,134683.21,275377.819999985
"17920",2017-10-24 05:32:45,157119.3,432497.119999985
"17921",2017-10-24 05:32:45,4940.36,437437.479999985
"4403",2017-10-24 05:41:57,111610.58,549048.059999985
"17922",2017-10-24 05:41:57,10994.26,560042.319999985
"17923",2017-10-24 05:41:57,-437437.48,122604.839999985
"4404",2017-10-24 05:46:40,-111610.58,10994.2599999851
"17924",2017-10-24 05:46:40,-10994.26,-1.4935721992515e-08
"4405",2017-10-24 06:31:42,118365.93,118365.929999985
"4406",2017-10-24 06:31:42,132596.59,250962.519999985
"4407",2017-10-24 06:31:42,160378.99,411341.509999985
"4408",2017-10-24 06:36:59,198289.81,609631.319999985
"4409",2017-10-24 06:36:59,-411341.51,198289.809999985
"4410",2017-10-24 06:55:26,-198289.81,-1.49593688547611e-08
"4411",2017-10-24 07:44:42,179689.52,179689.519999985
"4412",2017-10-24 08:02:56,-179689.52,-1.49593688547611e-08
"4413",2017-10-24 08:07:07,177795.98,177795.979999985
"4414",2017-10-24 08:07:07,188906.81,366702.789999985
"17925",2017-10-24 08:07:07,214850.5,581553.289999985
"17926",2017-10-24 08:07:07,177795.97,759349.259999985
"17927",2017-10-24 08:07:07,188906.82,948256.079999985
"4415",2017-10-24 08:15:27,-366702.79,581553.289999985
"17928",2017-10-24 08:15:27,175641.36,757194.649999985
"17929",2017-10-24 08:15:27,-581553.29,175641.359999985
"4416",2017-10-24 08:24:03,181105.55,356746.909999985
"17930",2017-10-24 08:24:03,-175641.36,181105.549999985
"4417",2017-10-24 08:31:28,-181105.55,-1.51339918375015e-08
"4418",2017-10-24 08:57:41,297213.41,297213.409999985
"4419",2017-10-24 09:09:08,-297213.41,-1.51339918375015e-08
"17931",2017-10-24 09:09:08,366373.19,366373.189999985
"4420",2017-10-24 09:26:56,180870.7,547243.889999985
"17932",2017-10-24 09:26:56,-366373.19,180870.699999985
"4421",2017-10-24 09:36:25,-180870.7,-1.51339918375015e-08
"4422",2017-10-24 09:49:43,308526.17,308526.169999985
"4423",2017-10-24 09:53:57,-308526.17,-1.51339918375015e-08
"4424",2017-10-24 10:40:54,245064.82,245064.819999985
"4425",2017-10-24 10:59:06,8918.43,253983.249999985
"4426",2017-10-24 10:59:06,-245064.82,8918.42999998486
"4427",2017-10-24 11:11:28,487042.64,495961.069999985
"4428",2017-10-24 11:11:28,-8918.43,487042.639999985
"4429",2017-10-24 11:19:13,-487042.64,-1.51339918375015e-08
"17933",2017-10-24 11:36:25,222469.95,222469.949999985
"4430",2017-10-24 12:07:06,228812.79,451282.739999985
"17934",2017-10-24 12:07:06,-222469.95,228812.789999985
"4431",2017-10-24 12:13:40,-228812.79,-1.51630956679583e-08
"4432",2017-10-24 13:31:18,239783.09,239783.089999985
"4433",2017-10-24 13:46:56,497572.58,737355.669999985
"4434",2017-10-24 13:46:56,-239783.09,497572.579999985
"4435",2017-10-24 14:01:37,-497572.58,-1.5192199498415e-08
"17935",2017-10-24 14:01:37,312133.06,312133.059999985
"4436",2017-10-24 14:27:02,377796.57,689929.629999985
"4437",2017-10-24 14:27:02,181375.58,871305.209999985
"17936",2017-10-24 14:27:02,-312133.06,559172.149999985
"4438",2017-10-24 14:36:32,-559172.15,-1.52504071593285e-08
"4439",2017-10-24 15:01:36,15660.29,15660.2899999848
"17937",2017-10-24 15:01:36,194306.87,209967.159999985
"4440",2017-10-24 15:10:19,185312.79,395279.949999985
"4441",2017-10-24 15:10:19,-15660.29,379619.659999985
"17938",2017-10-24 15:10:19,187569.05,567188.709999985
"17939",2017-10-24 15:10:19,-194306.87,372881.839999985
"4442",2017-10-24 15:14:42,29356.08,402237.919999985
"4443",2017-10-24 15:14:42,-185312.79,216925.129999985
"17940",2017-10-24 15:14:42,-187569.05,29356.0799999849
"4444",2017-10-24 15:23:35,-29356.08,-1.51485437527299e-08
"4445",2017-10-24 15:33:43,214246.43,214246.429999985
"17941",2017-10-24 16:13:59,311088.33,525334.759999985
"4446",2017-10-24 16:38:57,285066.07,810400.829999985
"4447",2017-10-24 16:38:57,169959.72,980360.549999985
"17942",2017-10-24 16:38:57,-311088.33,669272.219999985
"4448",2017-10-24 16:42:49,-214246.43,455025.789999985
"4449",2017-10-24 16:55:32,-455025.79,-1.51339918375015e-08
"4450",2017-10-24 17:05:23,377796.69,377796.689999985
"4451",2017-10-24 17:58:18,-377796.69,-1.51339918375015e-08
"17943",2017-10-24 19:10:47,216499.89,216499.889999985
"17944",2017-10-24 19:38:02,-216499.89,-1.51339918375015e-08
"17945",2017-10-24 19:49:32,307481.77,307481.769999985
"17946",2017-10-24 19:55:09,-307481.77,-1.51339918375015e-08
"4452",2017-10-24 20:58:52,164296.61,164296.609999985
"4453",2017-10-24 21:04:53,188185.58,352482.189999985
"4454",2017-10-24 21:04:53,-164296.61,188185.579999985
"4455",2017-10-24 21:17:07,-188185.58,-1.51630956679583e-08
"4456",2017-10-24 21:35:57,188381.94,188381.939999985
"17947",2017-10-24 21:35:57,218804.51,407186.449999985
"4457",2017-10-24 21:42:34,204961.7,612148.149999985
"4458",2017-10-24 21:42:34,-188381.94,423766.209999985
"17948",2017-10-24 21:42:34,-218804.51,204961.699999985
"4459",2017-10-24 21:49:51,-204961.7,-1.52504071593285e-08
"4460",2017-10-24 21:59:40,210693.54,210693.539999985
"4461",2017-10-24 22:01:03,-210693.54,-1.52504071593285e-08
"4462",2017-10-24 22:39:20,196192.43,196192.429999985
"4463",2017-10-24 22:39:20,177381.98,373574.409999985
"17949",2017-10-24 22:39:20,197562.3,571136.709999985
"4464",2017-10-24 22:52:17,300019.81,871156.519999985
"4465",2017-10-24 22:52:17,-373574.41,497582.109999985
"17950",2017-10-24 22:52:17,-197562.3,300019.809999985
"4466",2017-10-24 22:59:59,-300019.81,-1.50757841765881e-08
"4467",2017-10-24 23:31:21,163023.12,163023.119999985
"4468",2017-10-24 23:40:13,-163023.12,-1.50757841765881e-08
"4469",2017-10-25 00:25:41,166882.7,166882.699999985
"4470",2017-10-25 00:41:45,-166882.7,-1.50757841765881e-08
"4471",2017-10-25 00:59:01,176624.3,176624.299999985
"4472",2017-10-25 01:04:12,211135.37,387759.669999985
"4473",2017-10-25 01:04:12,-176624.3,211135.369999985
"4474",2017-10-25 01:14:18,-211135.37,-1.50757841765881e-08
"4475",2017-10-25 01:22:01,209837.96,209837.959999985
"4476",2017-10-25 01:27:28,-209837.96,-1.50757841765881e-08
"4477",2017-10-25 01:30:21,184934.33,184934.329999985
"4478",2017-10-25 01:30:55,252665.37,437599.699999985
"4479",2017-10-25 01:34:13,-437599.7,-1.50757841765881e-08
"4480",2017-10-25 01:40:46,206656.9,206656.899999985
"4481",2017-10-25 01:44:00,286598.79,493255.689999985
"4482",2017-10-25 02:08:04,296519.73,789775.419999985
"4483",2017-10-25 02:08:04,-493255.69,296519.729999985
"17951",2017-10-25 02:08:04,214466.05,510985.779999985
"4484",2017-10-25 02:22:16,-296519.73,214466.049999985
"17952",2017-10-25 02:22:16,-214466.05,-1.50757841765881e-08
"4485",2017-10-25 03:03:18,214112.81,214112.809999985
"4486",2017-10-25 03:03:18,300019.97,514132.779999985
"4487",2017-10-25 03:03:18,166600.43,680733.209999985
"4488",2017-10-25 03:03:18,23633.26,704366.469999985
"4489",2017-10-25 03:03:18,300019.98,1004386.44999998
"4490",2017-10-25 03:12:50,-1004386.45,-1.51339918375015e-08
"17953",2017-10-25 03:12:50,220459.55,220459.549999985
"17954",2017-10-25 03:19:55,241097.36,461556.909999985
"17955",2017-10-25 03:19:55,-220459.55,241097.359999985
"17956",2017-10-25 03:32:13,-241097.36,-1.51339918375015e-08
"17957",2017-10-25 04:03:59,230206.88,230206.879999985
"17958",2017-10-25 04:12:07,-230206.88,-1.51339918375015e-08
"17959",2017-10-25 04:52:38,175899.03,175899.029999985
"17960",2017-10-25 05:13:56,-175899.03,-1.51339918375015e-08
"4491",2017-10-25 05:21:16,289796.69,289796.689999985
"17961",2017-10-25 05:21:16,12894,302690.689999985
"4492",2017-10-25 05:43:29,232694.38,535385.069999985
"4493",2017-10-25 05:43:29,-289796.69,245588.379999985
"17962",2017-10-25 05:43:29,-12894,232694.379999985
"4494",2017-10-25 05:50:06,-232694.38,-1.50757841765881e-08
"17963",2017-10-25 05:50:06,170414.08,170414.079999985
"17964",2017-10-25 06:14:57,-170414.08,-1.50757841765881e-08
"4495",2017-10-25 06:25:59,201371.32,201371.319999985
"4496",2017-10-25 06:35:44,-201371.32,-1.50757841765881e-08
"17965",2017-10-25 06:51:18,211101.38,211101.379999985
"4497",2017-10-25 07:40:29,182771.88,393873.259999985
"4498",2017-10-25 07:55:41,-182771.88,211101.379999985
"4499",2017-10-25 10:49:23,364392.75,575494.129999985
"4500",2017-10-25 11:03:45,-364392.75,211101.379999985
"4501",2017-10-25 11:12:15,175585.13,386686.509999985
"4502",2017-10-25 11:19:53,-175585.13,211101.379999985
"4503",2017-10-25 11:36:08,241709.86,452811.239999985
"4504",2017-10-25 11:49:23,-241709.86,211101.379999985
"4505",2017-10-25 12:28:35,176147.5,387248.879999985
"4506",2017-10-25 12:58:49,-176147.5,211101.379999985
"17966",2017-10-25 14:19:58,172782.64,383884.019999985
"17967",2017-10-25 15:36:23,166804.09,550688.109999985
"17968",2017-10-25 16:04:49,280190.11,830878.219999985
"4507",2017-10-25 16:31:59,163909.2,994787.419999985
"4508",2017-10-25 16:38:18,-163909.2,830878.219999985
"4509",2017-10-25 16:50:10,167482.46,998360.679999985
"4510",2017-10-25 17:04:58,180142.59,1178503.26999999
"4511",2017-10-25 17:04:58,-167482.46,1011020.80999999
"4512",2017-10-25 17:11:15,-180142.59,830878.219999985
"4513",2017-10-25 17:48:16,266847.14,1097725.35999999
"4514",2017-10-25 17:55:56,-266847.14,830878.219999985
"4515",2017-10-25 18:26:32,188434.81,1019313.02999999
"4516",2017-10-25 18:30:28,-188434.81,830878.219999985
"4517",2017-10-25 19:48:47,175681.53,1006559.74999999
"4518",2017-10-25 20:05:50,371677.05,1378236.79999999
"4519",2017-10-25 20:05:50,-175681.53,1202555.26999999
"4520",2017-10-25 20:10:13,370020.29,1572575.55999999
"4521",2017-10-25 20:18:39,-741697.34,830878.219999985
"4522",2017-10-25 20:50:32,300020.31,1130898.52999999
"4523",2017-10-25 20:53:05,-300020.31,830878.219999985
"17969",2017-10-25 21:27:36,169610.62,1000488.83999999
"17970",2017-10-25 21:43:56,221676.11,1222164.94999999
"4524",2017-10-25 22:05:20,224549.97,1446714.91999999
"4525",2017-10-25 22:14:09,-224549.97,1222164.94999999
"4526",2017-10-25 22:20:33,190551.49,1412716.43999999
"4527",2017-10-25 22:24:22,-190551.49,1222164.94999999
"4528",2017-10-25 23:11:36,174446.85,1396611.79999999
"4529",2017-10-25 23:18:33,-174446.85,1222164.94999999
"4530",2017-10-25 23:36:50,239211.35,1461376.29999999
"4531",2017-10-25 23:53:46,-239211.35,1222164.94999999
"17971",2017-10-26 00:13:16,201837.11,1424002.05999999
"4532",2017-10-26 01:08:20,178909.37,1602911.42999999
"4533",2017-10-26 01:21:13,-178909.37,1424002.05999999
"4534",2017-10-26 02:56:32,217283.67,1641285.72999999
"4535",2017-10-26 03:14:54,175543.28,1816829.00999999
"4536",2017-10-26 03:14:54,-217283.67,1599545.33999999
"4537",2017-10-26 03:21:51,-175543.28,1424002.05999999
"17972",2017-10-26 04:04:24,174040.75,1598042.80999999
"4538",2017-10-26 04:52:53,279215.46,1877258.26999999
"4539",2017-10-26 05:03:20,-279215.46,1598042.80999999
"17973",2017-10-26 06:31:40,182722.72,1780765.52999999
"17974",2017-10-26 09:24:20,192130.64,1972896.16999999
"4540",2017-10-26 10:01:06,168208.31,2141104.47999999
"4541",2017-10-26 10:04:43,-168208.31,1972896.16999999
"4542",2017-10-26 11:23:26,360493.49,2333389.65999999
"17975",2017-10-26 11:23:26,199198.24,2532587.89999999
"4543",2017-10-26 11:28:01,-360493.49,2172094.40999999
"17976",2017-10-26 11:28:01,188071.19,2360165.59999999
"17977",2017-10-26 12:06:29,210627.93,2570793.52999999
"17978",2017-10-26 12:06:29,171159.65,2741953.17999999
"17979",2017-10-26 12:14:22,226399.63,2968352.80999999
"17980",2017-10-26 12:53:07,166867.08,3135219.88999999
"17981",2017-10-26 13:02:22,289268.36,3424488.24999999
"4544",2017-10-26 13:35:26,226481.82,3650970.06999998
"4545",2017-10-26 13:39:19,-226481.82,3424488.24999999
"17982",2017-10-26 13:39:19,209155.29,3633643.53999999
"4546",2017-10-26 13:50:25,186416.52,3820060.05999999
"17983",2017-10-26 13:50:25,282506.63,4102566.68999999
"4547",2017-10-26 13:58:12,315156.39,4417723.07999999
"4548",2017-10-26 13:58:12,-186416.52,4231306.55999999
"17984",2017-10-26 13:58:12,264373.2,4495679.75999999
"4549",2017-10-26 14:11:02,162580.59,4658260.34999999
"4550",2017-10-26 14:11:02,-315156.39,4343103.95999999
"4551",2017-10-26 14:21:22,300020.64,4643124.59999999
"4552",2017-10-26 14:21:22,-162580.59,4480544.00999999
"17985",2017-10-26 14:21:22,300020.65,4780564.65999999
"4553",2017-10-26 14:28:02,-300020.64,4480544.01999999
"4554",2017-10-26 18:47:59,323974.76,4804518.77999999
"4555",2017-10-26 18:57:24,-323974.76,4480544.01999999
"4556",2017-10-26 19:18:02,184330.58,4664874.59999999
"17986",2017-10-26 19:18:02,219024.71,4883899.30999999
"4557",2017-10-26 19:43:53,-184330.58,4699568.72999999
"17987",2017-10-26 21:12:47,314229.77,5013798.49999999
"17988",2017-10-26 21:25:15,268768.36,5282566.85999999
"4558",2017-10-26 22:18:29,304528.83,5587095.68999999
"4559",2017-10-26 22:37:34,204261.76,5791357.44999999
"4560",2017-10-26 22:37:34,-304528.83,5486828.61999999
"17989",2017-10-26 22:37:34,219966.55,5706795.16999999
"4561",2017-10-26 23:47:26,188390.88,5895186.04999999
"4562",2017-10-26 23:49:07,-204261.76,5690924.28999999
"4563",2017-10-27 01:17:18,268487.99,5959412.27999999
"4564",2017-10-27 01:17:18,331096.97,6290509.24999999
"17990",2017-10-27 01:17:18,301564.65,6592073.89999999
"17991",2017-10-27 01:17:18,264292.45,6856366.34999999
"17992",2017-10-27 01:17:18,193244.38,7049610.72999999
"4565",2017-10-27 01:18:18,-188390.88,6861219.84999999
"4566",2017-10-27 01:23:12,-599584.96,6261634.88999999
"4567",2017-10-27 01:49:01,298424.65,6560059.53999999
"4568",2017-10-27 03:23:56,-298424.65,6261634.88999999
"17993",2017-10-27 05:25:08,257335.87,6518970.75999999
"17994",2017-10-27 05:44:24,163335.53,6682306.28999999
"17995",2017-10-27 09:19:49,172741.59,6855047.87999999
"17996",2017-10-27 09:43:14,155975.1,7011022.97999999
"4569",2017-10-27 10:50:26,161966.55,7172989.52999999
"17997",2017-10-27 12:33:56,161097.52,7334087.04999999
"4570",2017-10-27 13:16:22,-161966.55,7172120.49999999
"4571",2017-10-27 20:08:42,205713.93,7377834.42999999
"4572",2017-10-27 20:21:25,-205713.93,7172120.49999999
"4573",2017-10-28 00:27:18,195433.43,7367553.92999999
"4574",2017-10-28 00:27:18,219620.95,7587174.87999999
"4575",2017-10-28 00:31:14,-415054.38,7172120.49999999
"17998",2017-10-28 11:22:18,201732.02,7373852.51999999
"17999",2017-10-28 21:40:42,-7373852.52,-1.30385160446167e-08
"4576",2017-10-29 04:55:10,165174.3,165174.299999987
"4577",2017-10-29 05:29:43,-165174.3,-1.30385160446167e-08
"18000",2017-10-29 05:52:46,199566.51,199566.509999987
"18001",2017-10-29 06:42:54,-199566.51,-1.30385160446167e-08
"18002",2017-10-29 06:51:00,252644.08,252644.079999987
"18003",2017-10-29 06:58:14,-252644.08,-1.30385160446167e-08
"4578",2017-10-29 07:06:12,171898.2,171898.199999987
"18004",2017-10-29 07:07:10,267095.08,438993.279999987
"4579",2017-10-29 07:09:23,-171898.2,267095.079999987
"18005",2017-10-29 07:09:23,-267095.08,-1.30385160446167e-08
"4580",2017-10-29 07:37:38,300186.56,300186.559999987
"18006",2017-10-29 07:37:38,156128.13,456314.689999987
"18007",2017-10-29 07:37:38,194982.31,651296.999999987
"18008",2017-10-29 07:41:07,-351110.44,300186.559999987
"4581",2017-10-29 07:43:19,-300186.56,-1.30385160446167e-08
"18009",2017-10-29 09:27:19,170724.34,170724.339999987
"18010",2017-10-29 09:48:50,172668.98,343393.319999987
"18011",2017-10-29 11:05:45,354345.44,697738.759999987
"4582",2017-10-29 11:35:47,483895.44,1181634.19999999
"4583",2017-10-29 11:49:10,219955.37,1401589.56999999
"4584",2017-10-29 11:49:10,-483895.44,917694.129999987
"18012",2017-10-29 11:49:10,563204.49,1480898.61999999
"18013",2017-10-29 11:51:59,188909.89,1669808.50999999
"4585",2017-10-29 12:04:50,300021.9,1969830.40999999
"4586",2017-10-29 12:04:50,-219955.37,1749875.03999999
"4587",2017-10-29 12:18:20,-300021.9,1449853.13999999
"18014",2017-10-29 13:42:56,535815.72,1985668.85999999
"4588",2017-10-29 14:43:25,368033.65,2353702.50999999
"4589",2017-10-29 14:51:19,-368033.65,1985668.85999999
"4590",2017-10-29 16:03:24,777798.94,2763467.79999999
"4591",2017-10-29 16:10:00,-777798.94,1985668.85999999
"4592",2017-10-29 16:36:27,777798.97,2763467.82999999
"18015",2017-10-29 16:36:27,777798.98,3541266.80999999
"18016",2017-10-29 16:36:27,777798.96,4319065.76999999
"4593",2017-10-29 16:44:11,-777798.97,3541266.79999999
"4594",2017-10-29 16:56:29,575475.34,4116742.13999999
"4595",2017-10-29 17:04:46,-575475.34,3541266.79999999
"4596",2017-10-29 17:31:59,674967.38,4216234.17999999
"18017",2017-10-29 17:31:59,559817.44,4776051.61999999
"4597",2017-10-29 17:36:47,-674967.38,4101084.23999999
"18018",2017-10-29 17:52:00,615340.33,4716424.56999999
"4598",2017-10-29 18:06:14,580524.63,5296949.19999999
"4599",2017-10-29 18:40:56,-580524.63,4716424.56999999
"4600",2017-10-29 20:00:04,660733.57,5377158.13999999
"4601",2017-10-29 20:00:04,777799.06,6154957.19999999
"4602",2017-10-29 20:00:04,682984.49,6837941.68999999
"18019",2017-10-29 20:00:04,351466.99,7189408.67999999
"4603",2017-10-29 20:21:17,377799.28,7567207.95999999
"18020",2017-10-29 20:37:17,50022.32,7617230.27999999
"4604",2017-10-29 20:46:10,-2121517.12,5495713.15999999
"4605",2017-10-29 21:04:41,-377799.28,5117913.87999999
"18021",2017-10-29 21:17:57,300022.92,5417936.79999999
"18022",2017-10-29 21:45:16,177799.34,5595736.13999999
"4606",2017-10-29 21:57:39,777800.31,6373536.44999999
"4607",2017-10-29 21:57:39,586240.33,6959776.77999999
"4608",2017-10-29 21:57:39,777800.32,7737577.09999999
"18023",2017-10-29 21:57:39,771725.35,8509302.44999999
"18024",2017-10-29 21:57:39,777800.34,9287102.78999999
"4609",2017-10-29 22:05:31,-2141840.96,7145261.82999999
"18025",2017-10-29 22:33:16,777800.37,7923062.19999999
"18026",2017-10-29 22:33:16,102985.38,8026047.57999999
"4610",2017-10-29 22:59:45,595898.6,8621946.17999999
"4611",2017-10-29 23:21:33,603831.4,9225777.57999999
"4612",2017-10-29 23:21:33,-595898.6,8629878.97999999
"4613",2017-10-29 23:28:59,777800.43,9407679.40999999
"4614",2017-10-29 23:28:59,-603831.4,8803848.00999999
"18027",2017-10-29 23:28:59,88910.29,8892758.29999999
"4615",2017-10-29 23:47:02,-777800.43,8114957.86999999
"4616",2017-10-30 02:55:23,638676.34,8753634.20999999
"4617",2017-10-30 03:10:19,-638676.34,8114957.86999999
"4618",2017-10-30 03:58:13,245880.46,8360838.32999999
"4619",2017-10-30 04:03:01,777800.45,9138638.77999999
"4620",2017-10-30 04:03:01,-245880.46,8892758.31999999
"18028",2017-10-30 04:03:01,612126.82,9504885.13999999
"4621",2017-10-30 04:11:23,-777800.45,8727084.68999999
"18029",2017-10-30 05:10:28,597326.21,9324410.89999999
"4622",2017-10-30 12:25:54,696731.59,10021142.49
"4623",2017-10-30 12:39:17,-696731.59,9324410.89999999
"18030",2017-10-30 13:14:28,522571.01,9846981.90999999
"18031",2017-10-31 14:40:06,579953.59,10426935.5
"18032",2017-10-31 16:24:44,-10426935.5,-1.30385160446167e-08
"18033",2017-10-31 21:02:22,428960.96,428960.959999987
"18034",2017-10-31 21:30:22,293460.48,722421.439999987
"18035",2017-10-31 21:30:22,-428960.96,293460.479999987
"18036",2017-10-31 21:41:39,-293460.48,-1.30967237055302e-08
"18037",2017-11-01 07:05:14,254697.95,254697.949999987
"18038",2017-11-01 07:12:14,-254697.95,-1.30967237055302e-08
"18039",2017-11-01 07:34:07,288861.7,288861.699999987
"18040",2017-11-01 07:47:28,-288861.7,-1.30967237055302e-08
"18041",2017-11-01 08:16:51,464366.54,464366.539999987
"18042",2017-11-01 08:23:18,-464366.54,-1.30967237055302e-08
"18043",2017-11-01 09:46:18,523768.69,523768.689999987
"18044",2017-11-01 09:51:23,-523768.69,-1.30967237055302e-08
"18045",2017-11-01 11:16:47,432395.37,432395.369999987
"18046",2017-11-01 11:22:23,-432395.37,-1.30967237055302e-08
"18047",2017-11-01 20:14:09,193806.07,193806.069999987
"18048",2017-11-02 00:02:35,268160.01,461966.079999987
"4624",2017-11-02 00:41:42,388913.34,850879.419999987
"4625",2017-11-02 00:41:42,77802.31,928681.729999987
"18049",2017-11-02 00:41:42,188913.32,1117595.04999999
"18050",2017-11-02 00:41:42,88913.33,1206508.37999999
"4626",2017-11-02 00:53:21,-466715.65,739792.729999987
"4627",2017-11-02 02:21:17,214053.69,953846.419999987
"18051",2017-11-02 02:21:17,211410.96,1165257.37999999
"18052",2017-11-02 02:25:13,162136.76,1327394.13999999
"4628",2017-11-02 02:26:16,177802.42,1505196.55999999
"4629",2017-11-02 02:28:04,-214053.69,1291142.86999999
"4630",2017-11-02 02:36:18,-177802.42,1113340.44999999
"18053",2017-11-02 03:18:47,107234.51,1220574.95999999
"18054",2017-11-02 03:44:37,72909.53,1293484.48999999
"18055",2017-11-02 03:44:37,65968.73,1359453.21999999
"4631",2017-11-02 04:43:04,196195.31,1555648.52999999
"4632",2017-11-02 05:03:04,120530.67,1676179.19999999
"4633",2017-11-02 05:03:04,104664.39,1780843.58999999
"4634",2017-11-02 05:03:04,-196195.31,1584648.27999999
"18056",2017-11-02 05:03:04,134757.97,1719406.24999999
"4635",2017-11-02 05:23:33,-225195.06,1494211.18999999
"18057",2017-11-02 05:30:40,77802.43,1572013.61999999
"4636",2017-11-02 07:29:58,119040.95,1691054.56999999
"4637",2017-11-02 07:29:58,118896.22,1809950.78999999
"4638",2017-11-02 07:29:58,114454.85,1924405.63999999
"18058",2017-11-02 07:29:58,4423.56,1928829.19999999
"18059",2017-11-02 07:29:58,3628.45,1932457.64999999
"4639",2017-11-02 07:48:32,-352392.02,1580065.62999999
"18060",2017-11-02 07:48:32,177802.67,1757868.29999999
"18061",2017-11-02 08:12:04,96312.93,1854181.22999999
"4640",2017-11-02 08:39:45,94173.05,1948354.27999999
"18062",2017-11-02 08:39:45,-1854181.23,94173.0499999868
"4641",2017-11-02 08:54:35,-94173.05,-1.32276909425855e-08
"18063",2017-11-02 08:54:35,124335.85,124335.849999987
"18064",2017-11-02 08:54:35,100025.71,224361.559999987
"4642",2017-11-02 09:07:14,77802.66,302164.219999987
"18065",2017-11-02 09:07:14,-224361.56,77802.6599999868
"18066",2017-11-02 09:07:14,300025.64,377828.299999987
"4643",2017-11-02 09:12:37,-77802.66,300025.639999987
"18067",2017-11-02 09:12:37,-300025.64,-1.31549313664436e-08
"18068",2017-11-02 09:27:29,146141.7,146141.699999987
"18069",2017-11-02 09:28:34,38247.87,184389.569999987
"18070",2017-11-02 09:56:05,-184389.57,-1.31549313664436e-08
"18071",2017-11-02 09:56:05,174077.28,174077.279999987
"18072",2017-11-02 10:00:31,-174077.28,-1.31549313664436e-08
"18073",2017-11-02 10:01:43,55580.72,55580.7199999868
"18074",2017-11-02 10:07:54,-55580.72,-1.31549313664436e-08
"18075",2017-11-02 10:15:38,3686.52,3686.51999998685
"18076",2017-11-02 10:19:35,-3686.52,-1.31549313664436e-08
"18077",2017-11-02 10:29:57,4078.87,4078.86999998684
"18078",2017-11-02 10:29:57,34594.47,38673.3399999868
"18079",2017-11-02 10:43:09,-38673.34,-1.31476554088295e-08
"4644",2017-11-02 10:54:28,48793.97,48793.9699999869
"4645",2017-11-02 11:09:43,-48793.97,-1.31476554088295e-08
"18080",2017-11-02 11:09:43,37802.92,37802.9199999869
"18081",2017-11-02 11:20:45,935.57,38738.4899999869
"18082",2017-11-02 11:20:45,-37802.92,935.569999986852
"18083",2017-11-02 11:24:21,1939.83,2875.39999998685
"18084",2017-11-02 11:24:21,-935.57,1939.82999998685
"18085",2017-11-02 11:38:05,-1939.83,-1.31481101561803e-08
"4646",2017-11-02 11:41:12,56842.57,56842.5699999869
"4647",2017-11-02 11:48:11,-56842.57,-1.31476554088295e-08
"18086",2017-11-02 11:50:15,120426.82,120426.819999987
"18087",2017-11-02 11:52:25,-120426.82,-1.31549313664436e-08
"4648",2017-11-02 12:06:38,37802.93,37802.9299999868
"4649",2017-11-02 12:06:38,77802.99,115605.919999987
"18088",2017-11-02 12:06:38,42566.63,158172.549999987
"18089",2017-11-02 12:06:38,77803,235975.549999987
"4650",2017-11-02 12:28:36,300026.06,536001.609999987
"4651",2017-11-02 12:28:36,-115605.92,420395.689999987
"18090",2017-11-02 12:28:36,-120369.63,300026.059999987
"18091",2017-11-02 12:28:36,77803.07,377829.129999987
"18092",2017-11-02 12:28:36,88914.1,466743.229999987
"4652",2017-11-02 12:52:05,-300026.06,166717.169999987
"18093",2017-11-02 12:52:05,82446.22,249163.389999987
"18094",2017-11-02 12:52:05,18582.43,267745.819999987
"18095",2017-11-02 12:52:05,-166717.17,101028.649999987
"18096",2017-11-02 13:02:56,-101028.65,-1.31549313664436e-08
"4653",2017-11-02 13:23:54,178785.19,178785.189999987
"4654",2017-11-02 13:23:54,83392.43,262177.619999987
"18097",2017-11-02 13:23:54,178081.52,440259.139999987
"4655",2017-11-02 13:31:11,-262177.62,178081.519999987
"18098",2017-11-02 13:31:11,98942.38,277023.899999987
"18099",2017-11-02 13:31:11,-178081.52,98942.3799999869
"4656",2017-11-02 13:41:02,177803.21,276745.589999987
"18100",2017-11-02 13:41:02,105873.25,382618.839999987
"18101",2017-11-02 13:41:02,-98942.38,283676.459999987
"4657",2017-11-02 13:43:16,-177803.21,105873.249999987
"18102",2017-11-02 13:45:23,-105873.25,-1.31258275359869e-08
"18103",2017-11-02 13:51:31,205449.43,205449.429999987
"4658",2017-11-02 13:55:24,134828.68,340278.109999987
"4659",2017-11-02 13:55:24,101344.79,441622.899999987
"18104",2017-11-02 13:55:24,-205449.43,236173.469999987
"4660",2017-11-02 14:08:35,-236173.47,-1.31840351969004e-08
"18105",2017-11-02 14:08:35,98990.44,98990.4399999868
"18106",2017-11-02 14:08:35,91371.18,190361.619999987
"18107",2017-11-02 14:08:35,3411.36,193772.979999987
"4661",2017-11-02 14:22:56,200789.24,394562.219999987
"18108",2017-11-02 14:22:56,140647.25,535209.469999987
"18109",2017-11-02 14:22:56,-193772.98,341436.489999987
"4662",2017-11-02 14:34:13,77803.11,419239.599999987
"4663",2017-11-02 14:34:13,-200789.24,218450.359999987
"18110",2017-11-02 14:34:13,101599.63,320049.989999987
"18111",2017-11-02 14:34:13,-140647.25,179402.739999987
"18112",2017-11-02 14:34:13,77803.12,257205.859999987
"18113",2017-11-02 14:37:11,75904.09,333109.949999987
"4664",2017-11-02 14:44:37,137803.34,470913.289999987
"4665",2017-11-02 14:44:37,-77803.11,393110.179999987
"18114",2017-11-02 14:44:37,66508.09,459618.269999987
"18115",2017-11-02 14:44:37,102458.58,562076.849999987
"18116",2017-11-02 14:44:37,-255306.84,306770.009999987
"4666",2017-11-02 15:29:50,177803.41,484573.419999987
"4667",2017-11-02 15:29:50,137803.36,622376.779999987
"4668",2017-11-02 15:29:50,-137803.34,484573.439999987
"18117",2017-11-02 15:29:50,143811.61,628385.049999987
"18118",2017-11-02 15:29:50,137803.39,766188.439999987
"18119",2017-11-02 15:29:50,-168966.67,597221.769999987
"4669",2017-11-02 15:39:39,-315606.77,281614.999999987
"18120",2017-11-02 15:39:39,21043.8,302658.799999987
"18121",2017-11-02 15:39:39,-281615,21043.7999999867
"4670",2017-11-02 16:05:22,143837.18,164880.979999987
"18122",2017-11-02 16:05:22,83841.86,248722.839999987
"18123",2017-11-02 16:05:22,139449.53,388172.369999987
"18124",2017-11-02 16:05:22,-21043.8,367128.569999987
"4671",2017-11-02 16:09:26,-143837.18,223291.389999987
"4672",2017-11-02 16:22:57,102090.77,325382.159999987
"18125",2017-11-02 16:22:57,180581.95,505964.109999987
"18126",2017-11-02 16:22:57,-223291.39,282672.719999987
"4673",2017-11-02 16:46:25,87749.8,370422.519999987
"4674",2017-11-02 16:46:25,-102090.77,268331.749999987
"18127",2017-11-02 16:46:25,157379.54,425711.289999987
"18128",2017-11-02 16:46:25,81122.12,506833.409999987
"18129",2017-11-02 16:46:25,-180581.95,326251.459999987
"4675",2017-11-02 16:54:46,300026.51,626277.969999987
"4676",2017-11-02 16:54:46,-87749.8,538528.169999987
"18130",2017-11-02 16:54:46,-238501.66,300026.509999987
"4677",2017-11-02 17:03:19,-300026.51,-1.33877620100975e-08
"18131",2017-11-02 17:08:06,200026.52,200026.519999987
"4678",2017-11-02 17:23:51,86803.28,286829.799999987
"18132",2017-11-02 17:23:51,84623.1,371452.899999987
"18133",2017-11-02 17:23:51,177803.55,549256.449999987
"18134",2017-11-02 17:23:51,-200026.52,349229.929999987
"4679",2017-11-02 17:40:51,70853.88,420083.809999987
"4680",2017-11-02 17:40:51,68071.13,488154.939999987
"4681",2017-11-02 17:40:51,-86803.28,401351.659999987
"18135",2017-11-02 17:40:51,181686.82,583038.479999987
"18136",2017-11-02 17:40:51,-262426.65,320611.829999987
"4682",2017-11-02 17:49:04,-138925.01,181686.819999987
"18137",2017-11-02 17:49:04,85963.1,267649.919999987
"18138",2017-11-02 17:49:04,-181686.82,85963.0999999866
"18139",2017-11-02 18:01:45,-85963.1,-1.33586581796408e-08
"4683",2017-11-02 18:17:03,179208.06,179208.059999987
"4684",2017-11-02 18:26:30,67321.7,246529.759999987
"4685",2017-11-02 18:26:30,-179208.06,67321.6999999866
"18140",2017-11-02 18:26:30,77803.37,145125.069999987
"4686",2017-11-02 18:38:53,-67321.7,77803.3699999866
"18141",2017-11-02 18:38:53,-77803.37,-1.33732100948691e-08
"4687",2017-11-02 19:06:27,141403.75,141403.749999987
"18142",2017-11-02 19:06:27,124081.56,265485.309999987
"18143",2017-11-02 19:06:27,118425.82,383911.129999987
"4688",2017-11-02 19:09:55,108365.47,492276.599999987
"4689",2017-11-02 19:33:03,-141403.75,350872.849999987
"18144",2017-11-02 19:33:03,84003.37,434876.219999987
"18145",2017-11-02 19:33:03,-242507.38,192368.839999987
"18146",2017-11-02 19:37:27,-84003.37,108365.469999987
"4690",2017-11-02 19:45:16,-108365.47,-1.34168658405542e-08
"18147",2017-11-02 19:45:16,75655.47,75655.4699999866
"18148",2017-11-02 19:45:16,101089.43,176744.899999987
"4691",2017-11-02 20:07:08,118148.79,294893.689999987
"18149",2017-11-02 20:07:08,123556.9,418450.589999987
"18150",2017-11-02 20:07:08,-176744.9,241705.689999987
"18151",2017-11-02 20:10:14,-123556.9,118148.789999987
"4692",2017-11-02 20:17:36,-118148.79,-1.34023139253259e-08
"4693",2017-11-02 20:17:36,77803.38,77803.3799999866
"18152",2017-11-02 20:17:36,100237.65,178041.029999987
"4694",2017-11-02 20:19:27,86352.91,264393.939999987
"4695",2017-11-02 20:25:08,165099.91,429493.849999987
"4696",2017-11-02 20:25:08,-164156.29,265337.559999987
"18153",2017-11-02 20:25:08,265860.44,531197.999999986
"18154",2017-11-02 20:25:08,-100237.65,430960.349999986
"18155",2017-11-02 20:25:08,-100237.65,330722.699999986
"18156",2017-11-02 20:28:31,-165622.79,165099.909999986
"4697",2017-11-02 20:33:24,193554.29,358654.199999986
"4698",2017-11-02 20:33:24,-165099.91,193554.289999986
"4699",2017-11-02 20:45:07,-193554.29,-1.35623849928379e-08
"4700",2017-11-02 20:52:37,164759.53,164759.529999986
"4701",2017-11-02 20:57:40,-164759.53,-1.35623849928379e-08
"4702",2017-11-02 21:24:24,132015.17,132015.169999986
"4703",2017-11-02 21:43:01,157047.19,289062.359999986
"4704",2017-11-02 21:43:01,-132015.17,157047.189999986
"4705",2017-11-02 22:02:08,132320.2,289367.389999987
"4706",2017-11-02 22:02:08,-157047.19,132320.199999987
"4707",2017-11-02 22:16:30,-132320.2,-1.35041773319244e-08
"18157",2017-11-02 23:06:29,165039.01,165039.009999987
"18158",2017-11-02 23:06:29,180256.97,345295.979999986
"4708",2017-11-02 23:19:01,5187.6,350483.579999986
"18159",2017-11-02 23:19:01,-345295.98,5187.59999998647
"4709",2017-11-02 23:33:00,-5187.6,-1.35278241941705e-08
"18160",2017-11-03 00:11:29,181887.45,181887.449999986
"18161",2017-11-03 00:11:29,115426.21,297313.659999986
"4710",2017-11-03 00:21:51,6447.41,303761.069999986
"4711",2017-11-03 00:21:51,223426.78,527187.849999986
"18162",2017-11-03 00:21:51,-297313.66,229874.189999986
"4712",2017-11-03 00:27:00,204450.99,434325.179999986
"4713",2017-11-03 00:27:00,-229874.19,204450.989999986
"18163",2017-11-03 00:27:00,234449.95,438900.939999986
"4714",2017-11-03 00:47:44,195926.05,634826.989999986
"4715",2017-11-03 00:47:44,136596.36,771423.349999986
"4716",2017-11-03 00:47:44,-204450.99,566972.359999986
"18164",2017-11-03 00:47:44,163322.54,730294.899999987
"18165",2017-11-03 00:47:44,-234449.95,495844.949999987
"18166",2017-11-03 00:51:26,-163322.54,332522.409999987
"4717",2017-11-03 01:08:52,155638.56,488160.969999987
"4718",2017-11-03 01:08:52,-332522.41,155638.559999987
"4719",2017-11-03 01:49:17,170234.79,325873.349999987
"4720",2017-11-03 01:49:17,-155638.56,170234.789999987
"4721",2017-11-03 02:18:22,178662.15,348896.939999987
"4722",2017-11-03 02:18:22,-170234.79,178662.149999987
"18167",2017-11-03 02:18:22,130572.62,309234.769999987
"4723",2017-11-03 03:02:09,-178662.15,130572.619999987
"18168",2017-11-03 03:02:09,-130572.62,-1.34750735014677e-08
"4724",2017-11-03 03:21:36,266658.83,266658.829999987
"4725",2017-11-03 03:21:36,257866.96,524525.789999987
"4726",2017-11-03 03:48:27,-524525.79,-1.35041773319244e-08
"18169",2017-11-03 03:48:27,225231.15,225231.149999986
"18170",2017-11-03 03:48:27,326594.82,551825.969999986
"4727",2017-11-03 04:11:48,177804.21,729630.179999986
"4728",2017-11-03 04:11:48,174331.85,903962.029999986
"18171",2017-11-03 04:11:48,-551825.97,352136.059999986
"4729",2017-11-03 04:23:14,-352136.06,-1.35623849928379e-08
"4730",2017-11-03 09:12:47,777807.08,777807.079999986
"4731",2017-11-03 09:12:47,67427.09,845234.169999986
"18172",2017-11-03 09:12:47,777807.1,1623041.26999999
"18173",2017-11-03 09:12:47,20749.11,1643790.37999999
"4732",2017-11-03 09:25:11,-845234.17,798556.209999986
"18174",2017-11-03 09:45:47,23029.72,821585.929999986
"4733",2017-11-03 10:12:43,300030.15,1121616.07999999
"4734",2017-11-03 10:12:43,208400.3,1330016.37999999
"18175",2017-11-03 10:12:43,300030.17,1630046.54999999
"4735",2017-11-03 10:17:04,388918.18,2018964.72999999
"4736",2017-11-03 10:17:04,-508430.45,1510534.27999999
"4737",2017-11-03 10:45:06,-388918.18,1121616.09999999
"4738",2017-11-03 10:53:24,300030.19,1421646.28999999
"4739",2017-11-03 11:11:21,-300030.19,1121616.09999999
"18176",2017-11-03 11:21:28,436201.88,1557817.97999999
"18177",2017-11-03 11:26:11,251207.58,1809025.55999999
"4740",2017-11-03 12:14:37,300030.25,2109055.80999999
"4741",2017-11-03 12:23:19,-300030.25,1809025.55999999
"18178",2017-11-03 13:01:33,161410.03,1970435.58999999
"4742",2017-11-03 13:17:24,155856.76,2126292.34999999
"4743",2017-11-03 13:23:52,-155856.76,1970435.58999999
"18179",2017-11-03 13:23:52,300030.31,2270465.89999999
"4744",2017-11-03 13:35:22,181667.36,2452133.25999999
"4745",2017-11-03 13:35:22,300030.34,2752163.59999999
"4746",2017-11-03 13:38:58,-481697.7,2270465.89999999
"4747",2017-11-03 14:07:28,300030.36,2570496.25999999
"18180",2017-11-03 14:07:28,300030.35,2870526.60999999
"4748",2017-11-03 14:20:45,-300030.36,2570496.24999999
"4749",2017-11-03 14:35:28,158956.29,2729452.53999999
"18181",2017-11-03 14:35:28,191178.99,2920631.52999999
"4750",2017-11-03 16:03:29,283616.38,3204247.90999999
"4751",2017-11-03 16:03:29,300030.43,3504278.33999999
"18182",2017-11-03 16:03:29,300030.4,3804308.73999999
"18183",2017-11-03 16:03:29,300030.42,4104339.15999999
"4752",2017-11-03 16:33:53,-158956.29,3945382.86999999
"4753",2017-11-03 17:00:46,-583646.81,3361736.05999999
"4754",2017-11-03 17:24:44,146681.63,3508417.68999999
"4755",2017-11-03 18:24:11,157713.1,3666130.78999999
"18184",2017-11-03 18:24:11,133527.79,3799658.57999999
"18185",2017-11-03 18:24:11,157189.15,3956847.72999999
"4756",2017-11-03 18:32:47,135542.08,4092389.80999999
"4757",2017-11-03 18:52:28,300030.53,4392420.33999999
"18186",2017-11-03 18:52:28,137807.54,4530227.87999999
"4758",2017-11-03 19:05:28,-146681.63,4383546.24999999
"18187",2017-11-03 19:59:34,300030.55,4683576.79999999
"18188",2017-11-03 20:50:13,77807.59,4761384.38999999
"4759",2017-11-03 21:18:25,-593285.71,4168098.67999999
"18189",2017-11-03 21:18:25,88918.63,4257017.30999999
"18190",2017-11-03 21:45:04,88918.7,4345936.00999999
"18191",2017-11-03 21:45:04,397212.76,4743148.76999999
"4760",2017-11-03 22:04:40,114656.52,4857805.28999999
"4761",2017-11-03 22:12:03,300030.75,5157836.03999999
"4762",2017-11-03 22:12:03,-114656.52,5043179.51999999
"4763",2017-11-03 22:27:39,-300030.75,4743148.76999999
"18192",2017-11-03 22:27:39,200030.76,4943179.52999999
"18193",2017-11-03 22:27:39,77807.62,5020987.14999999
"18194",2017-11-03 22:34:40,179801.77,5200788.91999999
"18195",2017-11-03 23:37:45,195489.19,5396278.10999999
"18196",2017-11-03 23:44:47,177807.83,5574085.93999999
"18197",2017-11-03 23:49:38,177807.85,5751893.78999999
"4764",2017-11-04 01:00:36,228760.42,5980654.20999999
"4765",2017-11-04 01:00:36,116595.56,6097249.76999998
"4766",2017-11-04 01:00:36,5156.54,6102406.30999998
"18198",2017-11-04 01:00:36,192467.83,6294874.13999998
"18199",2017-11-04 01:00:36,122254.97,6417129.10999998
"18200",2017-11-04 01:00:36,98704.66,6515833.76999998
"4767",2017-11-04 01:12:35,-350512.52,6165321.24999999
"4768",2017-11-04 01:44:44,107587.84,6272909.08999998
"4769",2017-11-04 01:44:44,144592.97,6417502.05999998
"4770",2017-11-04 01:44:44,126047.26,6543549.31999998
"18201",2017-11-04 01:44:44,310480.35,6854029.66999998
"18202",2017-11-04 01:44:44,130811.91,6984841.57999998
"4771",2017-11-04 02:05:22,115357.95,7100199.52999998
"4772",2017-11-04 02:05:22,-378228.07,6721971.45999998
"18203",2017-11-04 02:05:22,197506.58,6919478.03999998
"4773",2017-11-04 02:28:27,-115357.95,6804120.08999998
"18204",2017-11-04 02:28:27,223216.26,7027336.34999998
"18205",2017-11-04 03:15:18,150031.02,7177367.36999998
"18206",2017-11-04 03:15:18,153077.84,7330445.20999998
"18207",2017-11-04 03:53:55,123115.94,7453561.14999998
"18208",2017-11-04 03:53:55,148960.1,7602521.24999998
"4774",2017-11-04 04:17:35,193873.22,7796394.46999998
"18209",2017-11-04 04:17:35,118025.48,7914419.94999998
"18210",2017-11-04 04:17:35,377808.1,8292228.04999998
"4775",2017-11-04 04:33:55,377808.11,8670036.15999998
"4776",2017-11-04 04:33:55,-193873.22,8476162.93999998
"4777",2017-11-04 05:03:03,77808.15,8553971.08999998
"4778",2017-11-04 05:03:03,-377808.11,8176162.97999998
"18211",2017-11-04 05:03:03,377808.14,8553971.11999998
"18212",2017-11-04 05:03:03,78809.12,8632780.23999998
"18213",2017-11-04 05:03:03,140698.31,8773478.54999998
"4779",2017-11-04 05:10:12,-77808.15,8695670.39999998
"18214",2017-11-04 05:24:16,200031.16,8895701.55999998
"4780",2017-11-04 06:44:19,119332.8,9015034.35999998
"18215",2017-11-04 06:44:19,163668.93,9178703.28999998
"4781",2017-11-04 06:56:10,101935.71,9280638.99999998
"4782",2017-11-04 06:56:10,-119332.8,9161306.19999998
"4783",2017-11-04 07:23:00,250031.22,9411337.41999998
"4784",2017-11-04 07:23:00,-101935.71,9309401.70999998
"18216",2017-11-04 07:23:00,250031.21,9559432.91999998
"18217",2017-11-04 07:23:00,111298.67,9670731.58999998
"4785",2017-11-04 07:33:21,-250031.22,9420700.36999998
"18218",2017-11-04 07:33:21,136670.38,9557370.74999998
"18219",2017-11-04 07:33:21,-9420700.37,136670.379999984
"18220",2017-11-04 07:40:47,-136670.38,-1.59488990902901e-08
"18221",2017-11-04 07:43:22,158827.31,158827.309999984
"18222",2017-11-04 07:49:56,377808.27,536635.579999984
"18223",2017-11-04 07:49:56,209199.98,745835.559999984
"18224",2017-11-04 07:49:56,-158827.31,587008.249999984
"18225",2017-11-04 07:49:56,-158827.31,428180.939999984
"18226",2017-11-04 08:17:42,-428180.94,-1.6065314412117e-08
"18227",2017-11-04 09:22:45,110939.09,110939.089999984
"18228",2017-11-04 09:36:15,377808.31,488747.399999984
"18229",2017-11-04 09:36:15,-110939.09,377808.309999984
"4786",2017-11-04 09:43:16,116645.67,494453.979999984
"18230",2017-11-04 09:43:16,-377808.31,116645.669999984
"4787",2017-11-04 09:59:35,-116645.67,-1.60216586664319e-08
"18231",2017-11-04 09:59:35,122042.82,122042.819999984
"18232",2017-11-04 10:07:28,300031.34,422074.159999984
"18233",2017-11-04 10:07:28,-122042.82,300031.339999984
"18234",2017-11-04 10:11:40,-300031.34,-1.60071067512035e-08
"18235",2017-11-04 11:11:50,387505.82,387505.819999984
"18236",2017-11-04 11:44:41,115057.8,502563.619999984
"18237",2017-11-04 11:44:41,377808.41,880372.029999984
"18238",2017-11-04 11:44:41,171403.37,1051775.39999998
"18239",2017-11-04 11:44:41,-387505.82,664269.579999984
"18240",2017-11-04 11:44:41,-387505.82,276763.759999984
"18241",2017-11-04 11:44:41,123702.7,400466.459999984
"4788",2017-11-04 12:26:52,157656.31,558122.769999984
"4789",2017-11-04 12:26:52,135898.91,694021.679999984
"18242",2017-11-04 12:26:52,186431.31,880452.989999984
"18243",2017-11-04 12:26:52,216648.71,1097101.69999998
"18244",2017-11-04 12:26:52,-400466.46,696635.239999984
"18245",2017-11-04 12:30:01,-403080.02,293555.219999984
"4790",2017-11-04 12:33:16,-293555.22,-1.6065314412117e-08
"18246",2017-11-04 12:33:16,314481.03,314481.029999984
"4791",2017-11-04 12:41:32,377808.49,692289.519999984
"18247",2017-11-04 12:41:32,300031.51,992321.029999984
"18248",2017-11-04 12:41:32,-314481.03,677839.999999984
"4792",2017-11-04 12:47:06,-377808.49,300031.509999984
"18249",2017-11-04 12:47:06,-300031.51,-1.6065314412117e-08
"4793",2017-11-04 13:27:16,189195.34,189195.339999984
"18250",2017-11-04 13:27:16,230518.31,419713.649999984
"18251",2017-11-04 13:27:16,166995.01,586708.659999984
"4794",2017-11-04 13:49:07,142087.06,728795.719999984
"4795",2017-11-04 13:49:07,-189195.34,539600.379999984
"18252",2017-11-04 13:49:07,144316.81,683917.189999984
"18253",2017-11-04 13:49:07,172866.76,856783.949999984
"18254",2017-11-04 13:49:07,154358.07,1011142.01999998
"18255",2017-11-04 13:49:07,-397513.32,613628.699999984
"4796",2017-11-04 13:57:11,200697.32,814326.019999984
"4797",2017-11-04 13:57:11,-142087.06,672238.959999984
"18256",2017-11-04 13:57:11,236383.31,908622.269999984
"18257",2017-11-04 13:57:11,-471541.64,437080.629999984
"18258",2017-11-04 13:57:11,7090.94,444171.569999984
"4798",2017-11-04 14:14:15,186249.69,630421.259999984
"4799",2017-11-04 14:14:15,-200697.32,429723.939999984
"18259",2017-11-04 14:14:15,243052.8,672776.739999984
"18260",2017-11-04 14:14:15,267145.01,939921.749999984
"18261",2017-11-04 14:14:15,199960.63,1139882.37999998
"18262",2017-11-04 14:14:15,-243474.25,896408.129999984
"18263",2017-11-04 14:14:15,-243474.25,652933.879999984
"4800",2017-11-04 14:15:16,184129.45,837063.329999984
"18264",2017-11-04 14:19:14,-466684.19,370379.139999984
"4801",2017-11-04 14:25:16,214678.21,585057.349999984
"4802",2017-11-04 14:25:16,-370379.14,214678.209999984
"18265",2017-11-04 14:25:16,239542.08,454220.289999984
"18266",2017-11-04 14:34:21,155506.33,609726.619999984
"18267",2017-11-04 14:34:21,-239542.08,370184.539999984
"4803",2017-11-04 14:36:03,-214678.21,155506.329999984
"18268",2017-11-04 14:36:03,186962.23,342468.559999984
"4804",2017-11-04 14:44:06,300031.74,642500.299999984
"18269",2017-11-04 14:44:06,300031.73,942532.029999984
"18270",2017-11-04 14:44:06,-342468.56,600063.469999984
"4805",2017-11-04 14:52:59,-300031.74,300031.729999984
"18271",2017-11-04 14:52:59,-300031.73,-1.6065314412117e-08
"18272",2017-11-04 15:15:53,152115.45,152115.449999984
"4806",2017-11-04 15:57:56,180595.77,332711.219999984
"18273",2017-11-04 15:57:56,193343.13,526054.349999984
"18274",2017-11-04 15:57:56,172028.54,698082.889999984
"18275",2017-11-04 15:57:56,-152115.45,545967.439999984
"4807",2017-11-04 16:14:52,300031.81,845999.249999984
"4808",2017-11-04 16:14:52,-180595.77,665403.479999984
"18276",2017-11-04 16:14:52,233805.37,899208.849999984
"18277",2017-11-04 16:14:52,300031.8,1199240.64999998
"18278",2017-11-04 16:14:52,-365371.67,833868.979999984
"4809",2017-11-04 16:27:18,252914.07,1086783.04999998
"4810",2017-11-04 16:27:18,-300031.81,786751.239999984
"18279",2017-11-04 16:27:18,-533837.17,252914.069999984
"4811",2017-11-04 16:38:23,-252914.07,-1.61235220730305e-08
"18280",2017-11-04 16:38:23,357801.24,357801.239999984
"18281",2017-11-04 16:42:23,-357801.24,-1.61235220730305e-08
"18282",2017-11-04 20:22:47,77810.03,77810.0299999839
"18283",2017-11-04 20:35:22,-77810.03,-1.61235220730305e-08
"4812",2017-11-04 22:56:04,481363.41,481363.409999984
"4813",2017-11-04 22:56:04,777811.4,1259174.80999998
"18284",2017-11-04 22:56:04,777811.38,2036986.18999998
"18285",2017-11-04 22:56:04,573229.39,2610215.57999998
"4814",2017-11-04 23:03:51,-1259174.81,1351040.76999998
"18286",2017-11-04 23:03:51,-1351040.77,-1.62981450557709e-08
"18287",2017-11-04 23:26:28,351273.41,351273.409999984
"18288",2017-11-04 23:33:21,-351273.41,-1.62981450557709e-08
"18289",2017-11-04 23:44:35,504337.89,504337.889999984
"18290",2017-11-05 00:07:46,-504337.89,-1.62981450557709e-08
"4815",2017-11-05 01:10:28,15062.68,15062.6799999837
"4816",2017-11-05 01:26:32,-15062.68,-1.62981450557709e-08
"18291",2017-11-05 01:47:38,237021.69,237021.689999984
"18292",2017-11-05 01:57:28,-237021.69,-1.62981450557709e-08
"18293",2017-11-05 02:22:09,252541.48,252541.479999984
"18294",2017-11-05 02:28:47,-252541.48,-1.62981450557709e-08
"18295",2017-11-05 13:33:15,177812.86,177812.859999984
"18296",2017-11-05 13:38:19,-177812.86,-1.62981450557709e-08
"4817",2017-11-05 23:54:26,390478.6,390478.599999984
"4818",2017-11-06 00:07:20,-390478.6,-1.62981450557709e-08
"18297",2017-11-06 01:13:44,303511.59,303511.589999984
"18298",2017-11-06 08:50:21,-303511.59,-1.62981450557709e-08
"4819",2017-11-06 10:01:52,709335.7,709335.699999984
"18299",2017-11-06 10:01:52,28162.69,737498.389999984
"4820",2017-11-06 10:08:59,-709335.7,28162.6899999836
"18300",2017-11-06 10:08:59,-28162.69,-1.63527147378772e-08
"4821",2017-11-06 10:18:13,217699.25,217699.249999984
"4822",2017-11-06 10:23:51,-217699.25,-1.63563527166843e-08
"18301",2017-11-06 11:08:01,209796.35,209796.349999984
"18302",2017-11-06 11:17:06,-209796.35,-1.63563527166843e-08
"18303",2017-11-06 12:08:26,355953.6,355953.599999984
"18304",2017-11-06 12:08:26,325087.97,681041.569999984
"18305",2017-11-06 12:18:09,-681041.57,-1.64145603775978e-08
"4823",2017-11-06 13:05:45,460039.59,460039.589999984
"4824",2017-11-06 13:05:45,249697.61,709737.199999984
"18306",2017-11-06 13:05:45,361537.39,1071274.58999998
"4825",2017-11-06 14:00:11,-709737.2,361537.389999984
"18307",2017-11-06 14:00:11,280875.87,642413.259999984
"18308",2017-11-06 14:00:11,-361537.39,280875.869999984
"18309",2017-11-06 14:15:58,-280875.87,-1.64145603775978e-08
"4826",2017-11-06 15:37:10,375922.49,375922.489999984
"4827",2017-11-06 15:52:48,458460.96,834383.449999984
"4828",2017-11-06 15:52:48,-375922.49,458460.959999984
"4829",2017-11-06 16:03:02,-458460.96,-1.63563527166843e-08
"4830",2017-11-06 19:13:03,606686.97,606686.969999984
"4831",2017-11-06 19:20:06,-606686.97,-1.62981450557709e-08
"4832",2017-11-06 19:34:59,449074.41,449074.409999984
"4833",2017-11-06 19:37:37,-449074.41,-1.62981450557709e-08
"4834",2017-11-06 20:03:35,436488.18,436488.179999984
"4835",2017-11-06 20:35:18,-436488.18,-1.62981450557709e-08
"18310",2017-11-06 22:04:31,219942.36,219942.359999984
"18311",2017-11-07 00:03:00,6130.28,226072.639999984
"18312",2017-11-07 00:03:00,10859.34,236931.979999984
"4836",2017-11-07 00:09:22,300039.06,536971.039999984
"18313",2017-11-07 00:09:22,122570.5,659541.539999984
"4837",2017-11-07 00:11:56,-300039.06,359502.479999984
"18314",2017-11-07 00:11:56,77816,437318.479999984
"18315",2017-11-07 00:11:56,88927.01,526245.489999984
"18316",2017-11-07 00:11:56,75039.02,601284.509999984
"18317",2017-11-07 00:11:56,78826.04,680110.549999984
"4838",2017-11-07 00:25:45,264414.42,944524.969999984
"4839",2017-11-07 00:38:36,-264414.42,680110.549999984
"18318",2017-11-07 00:38:36,206525.26,886635.809999984
"18319",2017-11-07 00:56:29,150307.76,1036943.56999998
"4840",2017-11-07 01:09:37,184172.78,1221116.34999998
"4841",2017-11-07 01:16:09,-184172.78,1036943.56999998
"18320",2017-11-07 01:28:40,174224.89,1211168.45999998
"18321",2017-11-07 01:56:50,153725.69,1364894.14999998
"18322",2017-11-07 01:56:50,8340.48,1373234.62999998
"18323",2017-11-07 02:25:01,186414.52,1559649.14999998
"4842",2017-11-07 03:10:53,138846.07,1698495.21999998
"4843",2017-11-07 03:36:03,-138846.07,1559649.14999998
"18324",2017-11-07 03:36:03,158826.3,1718475.44999998
"18325",2017-11-07 04:46:23,157683.24,1876158.68999998
"18326",2017-11-07 04:46:23,196833.79,2072992.47999998
"18327",2017-11-07 04:46:23,300039.2,2373031.67999998
"4844",2017-11-07 05:48:03,184092.54,2557124.21999998
"4845",2017-11-07 06:14:08,-184092.54,2373031.67999998
"18328",2017-11-07 07:26:08,134306.65,2507338.32999998
"4846",2017-11-07 07:49:39,170460.21,2677798.53999998
"4847",2017-11-07 07:55:19,-170460.21,2507338.32999998
"4848",2017-11-07 08:02:51,77816.05,2585154.37999998
"4849",2017-11-07 08:13:10,-77816.05,2507338.32999998
"18329",2017-11-07 08:47:58,148131.3,2655469.62999998
"4850",2017-11-07 08:51:00,77816.25,2733285.87999998
"18330",2017-11-07 08:51:00,50039.26,2783325.13999998
"4851",2017-11-07 08:56:51,-77816.25,2705508.88999998
"4852",2017-11-07 09:52:33,88927.28,2794436.16999998
"4853",2017-11-07 10:11:57,-88927.28,2705508.88999998
"4854",2017-11-07 11:41:07,231124.78,2936633.66999998
"4855",2017-11-07 11:45:06,255039.8,3191673.46999998
"4856",2017-11-07 11:45:06,-231124.78,2960548.68999998
"4857",2017-11-07 12:07:03,-255039.8,2705508.88999998
"4858",2017-11-07 13:38:28,7575.4,2713084.28999998
"4859",2017-11-07 13:52:09,-7575.4,2705508.88999998
"4860",2017-11-07 15:18:52,409531.14,3115040.02999998
"18331",2017-11-07 15:18:52,121580.2,3236620.22999998
"18332",2017-11-07 15:18:52,122494.93,3359115.15999998
"4861",2017-11-07 15:28:39,-409531.14,2949584.01999998
"4862",2017-11-07 15:50:49,6332.47,2955916.48999998
"4863",2017-11-07 16:03:01,-6332.47,2949584.01999998
"18333",2017-11-07 16:45:47,142767.03,3092351.04999998
"18334",2017-11-07 16:45:47,125875.36,3218226.40999998
"4864",2017-11-07 17:09:57,146462.74,3364689.14999998
"4865",2017-11-07 17:17:29,125001.49,3489690.63999998
"4866",2017-11-07 17:17:29,-146462.74,3343227.89999998
"18335",2017-11-07 17:17:29,144833.54,3488061.43999998
"4867",2017-11-07 17:27:57,-125001.49,3363059.94999998
"4868",2017-11-07 17:57:52,100039.6,3463099.54999998
"4869",2017-11-07 18:08:06,-100039.6,3363059.94999998
"4870",2017-11-07 20:44:01,70039.41,3433099.35999998
"4871",2017-11-07 20:46:54,-70039.41,3363059.94999998
"4872",2017-11-07 21:19:19,77818.52,3440878.46999998
"18336",2017-11-07 21:19:19,77818.55,3518697.01999998
"4873",2017-11-07 21:22:30,77818.51,3596515.52999998
"4874",2017-11-07 21:22:30,77818.56,3674334.08999998
"4875",2017-11-07 21:23:50,-77818.52,3596515.56999998
"4876",2017-11-07 21:34:52,-155637.07,3440878.49999998
"4877",2017-11-07 22:50:01,100039.64,3540918.13999998
"4878",2017-11-07 22:50:01,300039.53,3840957.66999998
"4879",2017-11-07 22:50:01,614929.95,4455887.61999998
"18337",2017-11-07 22:50:01,437902.54,4893790.15999998
"4880",2017-11-07 22:58:35,-1015009.12,3878781.03999998
"18338",2017-11-07 22:58:35,77819.41,3956600.44999998
"18339",2017-11-07 23:29:48,199760.95,4156361.39999998
"4881",2017-11-07 23:43:51,12146.32,4168507.71999998
"4882",2017-11-08 00:11:01,150726.46,4319234.17999998
"4883",2017-11-08 00:11:01,-12146.32,4307087.85999998
"18340",2017-11-08 00:15:50,188651.93,4495739.78999998
"4884",2017-11-08 00:18:30,-150726.46,4345013.32999998
"4885",2017-11-08 00:32:07,166242,4511255.32999998
"4886",2017-11-08 00:55:06,-166242,4345013.32999998
"18341",2017-11-08 00:55:06,144056.6,4489069.92999998
"4887",2017-11-08 02:03:49,243581.14,4732651.06999998
"4888",2017-11-08 02:03:49,305267.17,5037918.23999998
"18342",2017-11-08 02:03:49,162145.88,5200064.11999998
"18343",2017-11-08 02:03:49,232476.66,5432540.77999998
"18344",2017-11-08 02:03:49,275594.3,5708135.07999998
"4889",2017-11-08 02:13:03,201433.23,5909568.30999998
"4890",2017-11-08 02:13:03,-548848.31,5360719.99999998
"4891",2017-11-08 02:21:03,-201433.23,5159286.76999998
"4892",2017-11-08 02:26:26,271787.99,5431074.75999998
"4893",2017-11-08 02:43:05,-271787.99,5159286.76999998
"18345",2017-11-08 02:50:36,327811.55,5487098.31999998
"4894",2017-11-08 03:08:39,459611.2,5946709.51999998
"4895",2017-11-08 03:33:07,-459611.2,5487098.31999998
"18346",2017-11-08 03:33:07,170972.46,5658070.77999998
"18347",2017-11-08 03:33:07,167327.73,5825398.50999998
"18348",2017-11-08 03:40:15,200025.52,6025424.02999998
"4896",2017-11-08 03:58:48,210410.01,6235834.03999998
"4897",2017-11-08 04:07:03,-210410.01,6025424.02999998
"18349",2017-11-08 04:20:06,165542.51,6190966.53999998
"4898",2017-11-08 04:47:14,174894.17,6365860.70999998
"4899",2017-11-08 05:11:36,165148.27,6531008.97999998
"4900",2017-11-08 05:11:36,179450.05,6710459.02999998
"4901",2017-11-08 05:11:36,-174894.17,6535564.85999998
"18350",2017-11-08 05:11:36,194416.98,6729981.83999998
"18351",2017-11-08 05:18:31,77818.57,6807800.40999998
"4902",2017-11-08 05:32:54,300042.68,7107843.08999998
"4903",2017-11-08 05:32:54,-344598.32,6763244.76999998
"4904",2017-11-08 05:44:40,-300042.68,6463202.08999998
"4905",2017-11-08 06:23:31,160916.58,6624118.66999998
"18352",2017-11-08 06:23:31,223238.92,6847357.58999998
"4906",2017-11-08 06:29:06,-160916.58,6686441.00999998
"4907",2017-11-08 06:59:06,199838.43,6886279.43999998
"18353",2017-11-08 06:59:06,-6686441.01,199838.429999982
"4908",2017-11-08 07:07:41,-199838.43,-1.79861672222614e-08
"18354",2017-11-08 07:07:41,271376.03,271376.029999982
"18355",2017-11-08 07:21:07,-271376.03,-1.79861672222614e-08
"4909",2017-11-08 07:32:16,237279.32,237279.319999982
"4910",2017-11-08 08:02:57,176443.71,413723.029999982
"4911",2017-11-08 08:02:57,-237279.32,176443.709999982
"18356",2017-11-08 08:02:57,170693.54,347137.249999982
"18357",2017-11-08 08:08:02,-170693.54,176443.709999982
"4912",2017-11-08 08:17:28,-176443.71,-1.80443748831749e-08
"4913",2017-11-08 08:36:21,148798.53,148798.529999982
"4914",2017-11-08 08:50:18,-148798.53,-1.80443748831749e-08
"18358",2017-11-08 08:50:18,157988.13,157988.129999982
"18359",2017-11-08 08:55:52,-157988.13,-1.80443748831749e-08
"18360",2017-11-08 09:14:07,168986.47,168986.469999982
"18361",2017-11-08 09:21:29,-168986.47,-1.80443748831749e-08
"4915",2017-11-08 09:52:50,171947.89,171947.889999982
"4916",2017-11-08 10:01:34,-171947.89,-1.80443748831749e-08
"18362",2017-11-08 10:01:34,177193.55,177193.549999982
"4917",2017-11-08 10:20:33,152930.23,330123.779999982
"18363",2017-11-08 10:20:33,-177193.55,152930.229999982
"4918",2017-11-08 10:32:24,-152930.23,-1.80152710527182e-08
"4919",2017-11-08 11:40:25,312936.31,312936.309999982
"4920",2017-11-08 11:40:25,194602.15,507538.459999982
"18364",2017-11-08 11:40:25,203473.43,711011.889999982
"4921",2017-11-08 11:48:44,191505.12,902517.009999982
"4922",2017-11-08 11:48:44,-507538.46,394978.549999982
"18365",2017-11-08 11:48:44,-203473.43,191505.119999982
"4923",2017-11-08 12:01:27,-191505.12,-1.80443748831749e-08
"18366",2017-11-08 12:01:27,296204.69,296204.689999982
"4924",2017-11-08 12:09:28,247362.34,543567.029999982
"18367",2017-11-08 12:09:28,-296204.69,247362.339999982
"4925",2017-11-08 12:14:14,-247362.34,-1.80152710527182e-08
"4926",2017-11-08 12:28:10,288314.74,288314.739999982
"18368",2017-11-08 12:28:10,294716.52,583031.259999982
"18369",2017-11-08 12:28:10,167778.78,750810.039999982
"4927",2017-11-08 12:36:10,-288314.74,462495.299999982
"18370",2017-11-08 12:36:10,201489.95,663985.249999982
"18371",2017-11-08 12:36:10,-462495.3,201489.949999982
"18372",2017-11-08 12:45:44,193594.75,395084.699999982
"18373",2017-11-08 12:45:44,-201489.95,193594.749999982
"4928",2017-11-08 12:53:46,247944.83,441539.579999982
"18374",2017-11-08 12:53:46,-193594.75,247944.829999982
"4929",2017-11-08 12:58:57,-247944.83,-1.79570633918047e-08
"4930",2017-11-08 13:22:28,229650.08,229650.079999982
"4931",2017-11-08 13:38:34,-229650.08,-1.79570633918047e-08
"18375",2017-11-08 13:42:31,296642.2,296642.199999982
"18376",2017-11-08 13:48:35,-296642.2,-1.79861672222614e-08
"4932",2017-11-08 14:25:15,277829.83,277829.829999982
"18377",2017-11-08 14:25:15,199243.56,477073.389999982
"18378",2017-11-08 14:25:15,223563.56,700636.949999982
"18379",2017-11-08 14:25:15,174972.38,875609.329999982
"18380",2017-11-08 14:25:15,185751.58,1061360.90999998
"4933",2017-11-08 14:39:19,184321.45,1245682.35999998
"4934",2017-11-08 14:39:19,219548.75,1465231.10999998
"4935",2017-11-08 14:39:19,-277829.83,1187401.27999998
"18381",2017-11-08 14:39:19,378723.77,1566125.04999998
"18382",2017-11-08 14:39:19,323333.59,1889458.63999998
"18383",2017-11-08 14:39:19,-783531.08,1105927.55999998
"4936",2017-11-08 15:00:18,182926.5,1288854.05999998
"4937",2017-11-08 15:00:18,-403870.2,884983.859999982
"18384",2017-11-08 15:00:18,387193.96,1272177.81999998
"18385",2017-11-08 15:00:18,-702057.36,570120.459999982
"4938",2017-11-08 15:08:20,218780.91,788901.369999982
"18386",2017-11-08 15:08:20,-387193.96,401707.409999982
"4939",2017-11-08 15:21:00,-182926.5,218780.909999982
"18387",2017-11-08 15:21:00,301499.33,520280.239999982
"4940",2017-11-08 15:30:38,-218780.91,301499.329999982
"18388",2017-11-08 15:30:38,-301499.33,-1.81025825440884e-08
"4941",2017-11-08 15:50:00,260658.74,260658.739999982
"4942",2017-11-08 16:03:18,-260658.74,-1.81025825440884e-08
"18389",2017-11-08 16:03:18,319673.33,319673.329999982
"4943",2017-11-08 16:25:40,300043.12,619716.449999982
"18390",2017-11-08 16:25:40,-319673.33,300043.119999982
"4944",2017-11-08 16:48:44,-300043.12,-1.81025825440884e-08
"4945",2017-11-08 17:14:45,77820.49,77820.4899999819
"18391",2017-11-08 17:14:45,77820.47,155640.959999982
"18392",2017-11-08 17:14:45,88931.5,244572.459999982
"4946",2017-11-08 17:28:50,-77820.49,166751.969999982
"18393",2017-11-08 17:28:50,-166751.97,-1.80734787136316e-08
"18394",2017-11-08 21:25:46,30045.09,30045.0899999819
"18395",2017-11-08 21:46:03,-30045.09,-1.80734787136316e-08
"4947",2017-11-08 23:51:00,777822.94,777822.939999982
"18396",2017-11-08 23:51:00,777822.93,1555645.86999998
"4948",2017-11-09 00:02:53,777822.97,2333468.83999998
"18397",2017-11-09 00:02:53,777822.96,3111291.79999998
"18398",2017-11-09 00:02:53,-777822.93,2333468.86999998
"4949",2017-11-09 00:21:44,-777822.94,1555645.92999998
"18399",2017-11-09 00:21:44,528630.87,2084276.79999998
"18400",2017-11-09 00:21:44,777822.99,2862099.78999998
"18401",2017-11-09 00:21:44,-777822.96,2084276.82999998
"18402",2017-11-09 00:27:23,-1306453.86,777822.969999982
"4950",2017-11-09 00:58:40,254032.92,1031855.88999998
"18403",2017-11-09 00:58:40,325212.26,1357068.14999998
"18404",2017-11-09 00:58:40,320368.73,1677436.87999998
"4951",2017-11-09 01:06:06,-777822.97,899613.909999982
"18405",2017-11-09 01:06:06,-645580.99,254032.919999982
"4952",2017-11-09 01:21:41,231903.15,485936.069999982
"4953",2017-11-09 01:23:21,-254032.92,231903.149999982
"4954",2017-11-09 01:39:23,13045.47,244948.619999982
"4955",2017-11-09 01:39:23,319394.57,564343.189999982
"4956",2017-11-09 01:39:23,-231903.15,332440.039999982
"4957",2017-11-09 02:02:08,218542.14,550982.179999982
"4958",2017-11-09 02:02:08,-332440.04,218542.139999982
"4959",2017-11-09 02:40:19,408942.91,627485.049999982
"18406",2017-11-09 02:40:19,278871.23,906356.279999982
"18407",2017-11-09 03:03:35,273068.81,1179425.08999998
"18408",2017-11-09 03:03:35,-278871.23,900553.859999982
"4960",2017-11-09 03:28:24,300046.13,1200599.98999998
"18409",2017-11-09 03:28:24,-273068.81,927531.179999982
"4961",2017-11-09 03:40:02,-218542.14,708989.039999982
"4962",2017-11-09 03:53:28,-708989.04,-1.80443748831749e-08
"4963",2017-11-09 04:27:18,186978.09,186978.089999982
"4964",2017-11-09 04:35:47,-186978.09,-1.80443748831749e-08
"4965",2017-11-09 05:05:40,251208.48,251208.479999982
"18410",2017-11-09 05:05:40,190628.93,441837.409999982
"18411",2017-11-09 05:09:23,-190628.93,251208.479999982
"4966",2017-11-09 05:22:46,231561.34,482769.819999982
"4967",2017-11-09 05:22:46,-251208.48,231561.339999982
"18412",2017-11-09 05:26:31,262205.33,493766.669999982
"4968",2017-11-09 05:44:10,396425.07,890191.739999982
"4969",2017-11-09 05:44:10,219715.39,1109907.12999998
"4970",2017-11-09 05:44:10,-231561.34,878345.789999982
"18413",2017-11-09 05:44:10,-262205.33,616140.459999982
"4971",2017-11-09 05:52:39,-616140.46,-1.76951289176941e-08
"18414",2017-11-09 06:16:55,304175.38,304175.379999982
"4972",2017-11-09 07:11:58,406833.44,711008.819999982
"18415",2017-11-09 07:11:58,325932.35,1036941.16999998
"18416",2017-11-09 07:11:58,277665.19,1314606.35999998
"18417",2017-11-09 07:11:58,-304175.38,1010430.97999998
"18418",2017-11-09 07:16:00,-603597.54,406833.439999982
"4973",2017-11-09 07:24:53,-406833.44,-1.76369212567806e-08
"18419",2017-11-09 07:44:48,247749.12,247749.119999982
"18420",2017-11-09 07:50:30,-247749.12,-1.76369212567806e-08
"18421",2017-11-09 08:09:54,523404.39,523404.389999982
"18422",2017-11-09 08:15:38,-523404.39,-1.76369212567806e-08
"4974",2017-11-09 08:49:22,233975.15,233975.149999982
"4975",2017-11-09 09:12:15,-233975.15,-1.76369212567806e-08
"4976",2017-11-09 09:26:51,300473.17,300473.169999982
"4977",2017-11-09 09:35:29,-300473.17,-1.76369212567806e-08
"4978",2017-11-09 10:16:11,346622.52,346622.519999982
"4979",2017-11-09 10:20:49,-346622.52,-1.76369212567806e-08
"4980",2017-11-09 12:03:00,229730.26,229730.259999982
"4981",2017-11-09 12:08:35,-229730.26,-1.76369212567806e-08
"4982",2017-11-09 12:26:38,344155.01,344155.009999982
"18423",2017-11-09 12:26:38,249991.97,594146.979999982
"18424",2017-11-09 12:34:15,-249991.97,344155.009999982
"4983",2017-11-09 12:46:53,212855.54,557010.549999982
"4984",2017-11-09 12:46:53,-344155.01,212855.539999982
"4985",2017-11-09 13:07:59,-212855.54,-1.75496097654104e-08
"4986",2017-11-09 13:14:40,189480.31,189480.309999982
"4987",2017-11-09 13:23:14,-189480.31,-1.75496097654104e-08
"18425",2017-11-09 14:14:37,300763.19,300763.189999982
"18426",2017-11-09 14:14:37,192720.24,493483.429999982
"4988",2017-11-09 14:21:33,293513.32,786996.749999983
"18427",2017-11-09 14:21:33,-493483.43,293513.319999983
"4989",2017-11-09 14:29:55,-293513.32,-1.74622982740402e-08
"18428",2017-11-09 15:02:36,391862.67,391862.669999983
"18429",2017-11-09 15:18:33,-391862.67,-1.74622982740402e-08
"4990",2017-11-09 16:11:02,345135.24,345135.239999983
"18430",2017-11-09 16:11:02,307849.45,652984.689999982
"18431",2017-11-09 16:26:41,-307849.45,345135.239999982
"4991",2017-11-09 16:29:40,-345135.24,-1.75205059349537e-08
"18432",2017-11-09 17:40:05,100046.97,100046.969999982
"18433",2017-11-09 17:42:03,50046.92,150093.889999982
"18434",2017-11-09 17:48:07,-150093.89,-1.75205059349537e-08
"18435",2017-11-09 18:04:33,77824.21,77824.2099999825
"18436",2017-11-09 18:27:19,-77824.21,-1.75205059349537e-08
"4992",2017-11-10 01:01:37,777827.81,777827.809999983
"4993",2017-11-10 01:01:37,357803.82,1135631.62999998
"18437",2017-11-10 01:01:37,454461.8,1590093.42999998
"18438",2017-11-10 01:01:37,777827.79,2367921.21999998
"18439",2017-11-10 01:04:23,-1232289.59,1135631.62999998
"4994",2017-11-10 01:17:45,-1135631.63,-1.69966369867325e-08
"18440",2017-11-10 01:17:45,388938.85,388938.849999983
"18441",2017-11-10 01:17:45,777827.86,1166766.70999998
"4995",2017-11-10 01:35:52,236048.69,1402815.39999998
"4996",2017-11-10 01:35:52,316351.16,1719166.55999998
"4997",2017-11-10 01:43:50,204356.91,1923523.46999998
"4998",2017-11-10 01:43:50,-552399.85,1371123.61999998
"18442",2017-11-10 01:48:25,354914.17,1726037.78999998
"4999",2017-11-10 01:54:56,257704.58,1983742.36999998
"5000",2017-11-10 01:54:56,-204356.91,1779385.45999998
"18443",2017-11-10 02:02:00,239408.94,2018794.39999998
"5001",2017-11-10 02:15:36,392313.85,2411108.24999998
"5002",2017-11-10 02:15:36,-257704.58,2153403.66999998
"18444",2017-11-10 02:15:36,406299.21,2559702.87999998
"5003",2017-11-10 02:28:01,-392313.85,2167389.02999998
"18445",2017-11-10 02:28:01,295044.05,2462433.07999998
"18446",2017-11-10 02:42:12,365090.93,2827524.00999998
"18447",2017-11-10 03:35:56,543707.7,3371231.70999998
"5004",2017-11-10 04:35:29,305405.22,3676636.92999998
"18448",2017-11-10 04:35:29,388816.3,4065453.22999998
"5005",2017-11-10 04:50:36,17278.29,4082731.51999998
"5006",2017-11-10 04:50:36,-305405.22,3777326.29999998
"5007",2017-11-10 05:08:36,-17278.29,3760048.00999998
"18449",2017-11-10 05:08:36,364127.65,4124175.65999998
"5008",2017-11-10 07:25:04,310375.46,4434551.11999998
"5009",2017-11-10 07:41:16,-310375.46,4124175.65999998
"18450",2017-11-10 07:41:16,505745.26,4629920.91999998
"18451",2017-11-10 07:41:16,-4124175.66,505745.259999982
"18452",2017-11-10 07:41:16,9290.23,515035.489999982
"18453",2017-11-10 07:50:57,-515035.49,-1.7927959561348e-08
"18454",2017-11-10 08:43:55,272286.79,272286.789999982
"18455",2017-11-10 08:51:25,-272286.79,-1.7927959561348e-08
"18456",2017-11-10 09:08:26,267615.25,267615.249999982
"5010",2017-11-10 09:10:38,210230.35,477845.599999982
"18457",2017-11-10 09:13:12,-267615.25,210230.349999982
"5011",2017-11-10 09:22:50,-210230.35,-1.79570633918047e-08
"18458",2017-11-10 10:05:31,16571.78,16571.779999982
"18459",2017-11-10 10:08:34,205207.1,221778.879999982
"18460",2017-11-10 10:08:34,-16571.78,205207.099999982
"18461",2017-11-10 10:17:53,333339.71,538546.809999982
"18462",2017-11-10 10:17:53,407850.62,946397.429999982
"18463",2017-11-10 10:17:53,-205207.1,741190.329999982
"18464",2017-11-10 10:17:53,-205207.1,535983.229999982
"18465",2017-11-10 10:42:53,652916.39,1188899.61999998
"18466",2017-11-10 10:42:53,297501.75,1486401.36999998
"18467",2017-11-10 10:42:53,-535983.23,950418.139999982
"18468",2017-11-10 10:49:13,-950418.14,-1.7811544239521e-08
"18469",2017-11-10 11:18:38,266971.09,266971.089999982
"18470",2017-11-10 11:18:38,272253.65,539224.739999982
"18471",2017-11-10 11:18:38,197014.44,736239.179999982
"18472",2017-11-10 11:34:18,-736239.18,-1.7811544239521e-08
"18473",2017-11-10 11:41:37,361709.87,361709.869999982
"18474",2017-11-10 11:59:16,-361709.87,-1.7811544239521e-08
"5012",2017-11-10 12:13:29,214326.62,214326.619999982
"18475",2017-11-10 12:13:29,699252.58,913579.199999982
"5013",2017-11-10 12:21:04,211023.09,1124602.28999998
"5014",2017-11-10 12:21:04,-214326.62,910275.669999982
"18476",2017-11-10 12:21:04,370272,1280547.66999998
"18477",2017-11-10 12:21:04,316379.81,1596927.47999998
"18478",2017-11-10 12:21:04,-699252.58,897674.899999982
"5015",2017-11-10 12:47:09,272246.64,1169921.53999998
"5016",2017-11-10 12:47:09,221738.57,1391660.10999998
"5017",2017-11-10 12:47:09,-211023.09,1180637.01999998
"18479",2017-11-10 12:47:09,356974.04,1537611.05999998
"18480",2017-11-10 12:47:09,-686651.81,850959.249999982
"18481",2017-11-10 12:51:14,-356974.04,493985.209999982
"5018",2017-11-10 13:22:44,309798.28,803783.489999982
"5019",2017-11-10 13:22:44,300051.47,1103834.95999998
"5020",2017-11-10 13:22:44,-493985.21,609849.749999982
"18482",2017-11-10 13:22:44,290520.87,900370.619999982
"18483",2017-11-10 13:22:44,306026.23,1206396.84999998
"5021",2017-11-10 13:54:38,-609849.75,596547.099999982
"18484",2017-11-10 13:54:38,-596547.1,-1.75787135958672e-08
"18485",2017-11-10 14:13:55,364485.74,364485.739999982
"5022",2017-11-10 14:24:37,506497.87,870983.609999982
"18486",2017-11-10 14:24:37,-364485.74,506497.869999982
"5023",2017-11-10 14:39:21,777828.55,1284326.41999998
"5024",2017-11-10 14:39:21,-506497.87,777828.549999982
"5025",2017-11-10 15:19:38,-777828.55,-1.75787135958672e-08
"18487",2017-11-10 15:19:38,315200.84,315200.839999982
"18488",2017-11-10 15:19:38,311777.4,626978.239999983
"18489",2017-11-10 15:33:53,204761.63,831739.869999983
"18490",2017-11-10 15:33:53,646728.51,1478468.37999998
"18491",2017-11-10 15:33:53,-626978.24,851490.139999983
"5026",2017-11-10 16:03:25,616395.38,1467885.51999998
"18492",2017-11-10 16:03:25,777828.63,2245714.14999998
"18493",2017-11-10 16:03:25,355481.78,2601195.92999998
"18494",2017-11-10 16:03:25,-851490.14,1749705.78999998
"18495",2017-11-10 16:09:13,-1133310.41,616395.379999983
"5027",2017-11-10 16:10:03,-616395.38,-1.71130523085594e-08
"18496",2017-11-10 16:28:10,532893.61,532893.609999983
"18497",2017-11-10 16:48:35,-532893.61,-1.71130523085594e-08
"18498",2017-11-10 17:29:19,333648.73,333648.729999983
"5028",2017-11-10 17:34:03,353687.18,687335.909999983
"18499",2017-11-10 17:34:03,-333648.73,353687.179999983
"5029",2017-11-10 17:57:02,302941.46,656628.639999983
"5030",2017-11-10 18:13:23,-353687.18,302941.459999983
"5031",2017-11-10 19:04:07,777828.76,1080770.21999998
"5032",2017-11-10 19:04:07,-302941.46,777828.759999983
"5033",2017-11-10 19:11:33,-777828.76,-1.69966369867325e-08
"18500",2017-11-10 19:42:43,633571.42,633571.419999983
"5034",2017-11-10 20:02:47,472771.85,1106343.26999998
"5035",2017-11-10 20:02:47,235097.21,1341440.47999998
"18501",2017-11-10 20:02:47,245504.61,1586945.08999998
"18502",2017-11-10 20:02:47,-633571.42,953373.669999983
"5036",2017-11-10 20:04:50,77828.81,1031202.47999998
"5037",2017-11-10 20:04:50,88939.83,1120142.30999998
"5038",2017-11-10 20:04:50,88939.84,1209082.14999998
"18503",2017-11-10 20:04:50,314521.75,1523603.89999998
"18504",2017-11-10 20:22:48,-560026.36,963577.539999983
"5039",2017-11-10 20:33:08,-707869.06,255708.479999983
"5040",2017-11-10 20:33:08,88939.87,344648.349999983
"18505",2017-11-10 20:33:08,88939.85,433588.199999983
"18506",2017-11-10 20:33:08,88939.86,522528.059999983
"18507",2017-11-10 20:40:08,-177879.71,344648.349999983
"18508",2017-11-10 20:42:17,777828.89,1122477.23999998
"5041",2017-11-10 20:54:41,777828.91,1900306.14999998
"18509",2017-11-10 20:54:41,222384.9,2122691.04999998
"18510",2017-11-10 20:54:41,-777828.89,1344862.15999998
"5042",2017-11-10 20:58:13,-344648.35,1000213.80999998
"18511",2017-11-10 20:58:13,504752.58,1504966.38999998
"18512",2017-11-10 21:16:29,217052.59,1722018.97999998
"18513",2017-11-10 21:16:29,-727137.48,994881.499999983
"5043",2017-11-10 21:18:04,-777828.91,217052.589999983
"18514",2017-11-10 21:34:39,692747.44,909800.029999983
"18515",2017-11-10 21:34:39,-217052.59,692747.439999983
"18516",2017-11-10 21:34:39,-217052.59,475694.849999983
"18517",2017-11-10 21:44:03,-475694.85,-1.69966369867325e-08
"5044",2017-11-10 22:03:22,700051.97,700051.969999983
"5045",2017-11-10 22:08:42,-700051.97,-1.69966369867325e-08
"18518",2017-11-10 22:59:54,265737.38,265737.379999983
"18519",2017-11-10 22:59:54,219837.39,485574.769999983
"18520",2017-11-10 23:09:54,-485574.77,-1.69966369867325e-08
"18521",2017-11-10 23:09:54,488940,488939.999999983
"5046",2017-11-11 00:01:01,436590.52,925530.519999983
"5047",2017-11-11 00:01:01,226790.44,1152320.95999998
"18522",2017-11-11 00:01:01,413540.89,1565861.84999998
"18523",2017-11-11 00:01:01,-488940,1076921.84999998
"18524",2017-11-11 00:09:09,-413540.89,663380.959999983
"5048",2017-11-11 00:34:16,700052.05,1363433.00999998
"18525",2017-11-11 04:43:05,743364.55,2106797.55999998
"18526",2017-11-11 04:43:05,-743364.55,1363433.00999998
"5049",2017-11-11 05:40:16,-663380.96,700052.049999983
"18527",2017-11-11 05:40:16,777829.12,1477881.16999998
"18528",2017-11-11 06:45:47,357672.6,1835553.76999998
"18529",2017-11-11 06:45:47,217513.29,2053067.05999998
"18530",2017-11-11 07:04:59,-1353015.01,700052.049999983
"18531",2017-11-11 11:02:12,777829.26,1477881.30999998
"18532",2017-11-11 11:02:12,127414.27,1605295.57999998
"18533",2017-11-11 11:29:44,-905243.53,700052.049999983
"18534",2017-11-11 12:04:37,66567.3,766619.349999983
"18535",2017-11-11 12:04:37,777829.29,1544448.63999998
"18536",2017-11-11 12:29:45,-844396.59,700052.049999983
"18537",2017-11-11 14:01:40,777829.39,1477881.43999998
"18538",2017-11-11 14:11:32,-777829.39,700052.049999983
"18539",2017-11-11 16:04:32,665222.71,1365274.75999998
"5050",2017-11-11 16:11:28,366377.43,1731652.18999998
"18540",2017-11-11 16:11:28,-665222.71,1066429.47999998
"18541",2017-11-11 17:52:57,447243.84,1513673.31999998
"18542",2017-11-11 17:52:57,459796.48,1973469.79999998
"5051",2017-11-11 18:31:45,7e+05,2673469.79999998
"18543",2017-11-11 19:12:37,315099.92,2988569.71999998
"18544",2017-11-11 19:12:37,399553.65,3388123.36999998
"18545",2017-11-11 19:34:08,290063.95,3678187.31999998
"5052",2017-11-11 20:46:23,8e+05,4478187.31999998
"5053",2017-11-11 22:29:35,1e+06,5478187.31999998
"18546",2017-11-11 22:46:52,777829.57,6256016.88999998
"18547",2017-11-11 22:46:52,134911.58,6390928.46999998
"5054",2017-11-12 01:05:13,1e+06,7390928.46999998
"18548",2017-11-12 01:05:13,330695.44,7721623.90999998
"18549",2017-11-12 01:05:13,347682.5,8069306.40999998
"18550",2017-11-12 03:21:30,289887.12,8359193.52999998
"18551",2017-11-12 03:26:05,489001.25,8848194.77999998
"18552",2017-11-12 03:26:05,317212.36,9165407.13999998
"18553",2017-11-12 03:50:55,497909.49,9663316.62999998
"18554",2017-11-12 23:04:46,7415.68,9670732.30999998
"18555",2017-11-12 23:04:46,777829.67,10448561.98
"18556",2017-11-12 23:04:46,283132.51,10731694.49
"18557",2017-11-12 23:04:46,443002.14,11174696.63
"5055",2017-11-13 01:51:34,1e+06,12174696.63
"18558",2017-11-13 01:51:34,-5096887.15,7077809.47999998
"18559",2017-11-13 01:51:34,-907040.32,6170769.15999998
"5056",2017-11-13 01:52:52,88939.95,6259709.10999998
"5057",2017-11-13 01:52:52,88939.88,6348648.98999998
"18560",2017-11-13 02:03:53,-604339.68,5744309.30999998
"18561",2017-11-13 02:08:57,776692.79,6521002.09999998
"18562",2017-11-13 03:03:28,777829.78,7298831.87999998
"18563",2017-11-13 03:03:28,-776692.79,6522139.08999998
"18564",2017-11-13 03:03:28,-776692.79,5745446.29999998
"18565",2017-11-13 03:10:29,-1136.99,5744309.30999998
"5058",2017-11-13 04:00:15,-700052.05,5044257.25999998
"5059",2017-11-13 07:34:13,-5044257.26,-1.58324837684631e-08
"5060",2017-11-13 10:16:40,399299.28,399299.279999984
"5061",2017-11-13 10:26:59,-399299.28,-1.58324837684631e-08
"5062",2017-11-13 13:58:50,1165196.72,1165196.71999998
"5063",2017-11-13 14:06:56,-1165196.72,-1.58324837684631e-08
"5064",2017-11-13 14:25:39,352281.9,352281.899999984
"5065",2017-11-13 14:32:44,-352281.9,-1.58324837684631e-08
"5066",2017-11-13 14:32:44,481381.08,481381.079999984
"5067",2017-11-13 14:44:53,-481381.08,-1.58324837684631e-08
"5068",2017-11-13 18:36:09,777830.16,777830.159999984
"18566",2017-11-13 18:36:09,440427.44,1218257.59999998
"5069",2017-11-13 18:45:34,-777830.16,440427.439999984
"5070",2017-11-13 18:45:34,351113.62,791541.059999984
"5071",2017-11-13 19:18:16,-351113.62,440427.439999984
"18567",2017-11-13 21:11:53,777830.19,1218257.62999998
"18568",2017-11-13 21:11:53,187405.2,1405662.82999998
"5072",2017-11-13 21:32:00,500053.21,1905716.03999998
"5073",2017-11-13 21:38:20,-500053.21,1405662.82999998
"5074",2017-11-13 21:38:20,500053.22,1905716.04999998
"5075",2017-11-13 21:38:20,332821.54,2238537.58999998
"5076",2017-11-13 21:38:20,465584.65,2704122.23999998
"18569",2017-11-13 21:38:20,-440427.44,2263694.79999998
"18570",2017-11-13 21:38:20,-440427.44,1823267.35999998
"18571",2017-11-13 21:38:20,-440427.44,1382839.91999998
"5077",2017-11-13 21:52:46,-1298459.41,84380.5099999842
"18572",2017-11-13 21:52:46,-84380.51,-1.58179318532348e-08
"5078",2017-11-14 00:14:41,574525.74,574525.739999984
"18573",2017-11-14 00:14:41,462377.83,1036903.56999998
"5079",2017-11-14 00:32:31,-574525.74,462377.829999984
"18574",2017-11-14 00:32:31,395516.15,857893.979999984
"5080",2017-11-14 02:35:32,453510.34,1311404.31999998
"5081",2017-11-14 02:49:51,-453510.34,857893.979999984
"5082",2017-11-14 03:01:10,686326.94,1544220.91999998
"5083",2017-11-14 03:13:13,-686326.94,857893.979999984
"18575",2017-11-14 03:13:13,443607.18,1301501.15999998
"18576",2017-11-14 09:41:40,378664.39,1680165.54999998
"5084",2017-11-14 09:58:22,327893.32,2008058.86999998
"5085",2017-11-14 10:31:30,-327893.32,1680165.54999998
"18577",2017-11-14 11:12:49,447013.62,2127179.16999998
"5086",2017-11-14 11:38:05,777830.45,2905009.61999998
"5087",2017-11-14 11:52:00,-777830.45,2127179.16999998
"5088",2017-11-14 11:52:00,136325.46,2263504.62999998
"5089",2017-11-14 11:57:32,-136325.46,2127179.16999998
"18578",2017-11-14 12:13:28,662547.27,2789726.43999998
"18579",2017-11-14 13:45:29,537130.43,3326856.86999998
"18580",2017-11-14 19:39:32,413669.84,3740526.70999998
"18581",2017-11-14 20:24:21,457538.12,4198064.82999998
"18582",2017-11-14 22:52:00,483390.83,4681455.65999998
"5090",2017-11-15 01:24:02,356247.82,5037703.47999998
"18583",2017-11-15 01:24:02,455056.61,5492760.08999998
"5091",2017-11-15 01:30:06,-356247.82,5136512.26999998
"5092",2017-11-15 02:45:56,774626.2,5911138.46999998
"5093",2017-11-15 02:45:56,398904.99,6310043.45999999
"5094",2017-11-15 02:59:05,-1173531.19,5136512.26999998
"5095",2017-11-15 03:10:05,641333.08,5777845.34999998
"5096",2017-11-15 03:16:50,-641333.08,5136512.26999998
"5097",2017-11-15 03:30:50,645111.43,5781623.69999998
"5098",2017-11-15 03:38:25,-645111.43,5136512.26999998
"5099",2017-11-15 04:45:10,452852.34,5589364.60999998
"5100",2017-11-15 05:00:22,-452852.34,5136512.26999998
"5101",2017-11-15 10:55:57,255935.38,5392447.64999998
"5102",2017-11-15 11:30:54,-255935.38,5136512.26999998
"5103",2017-11-15 11:30:54,777830.75,5914343.01999998
"5104",2017-11-15 11:30:54,388864.54,6303207.55999998
"5105",2017-11-15 12:19:51,-1166695.29,5136512.26999998
"5106",2017-11-15 13:19:42,150050.82,5286563.08999998
"5107",2017-11-15 13:31:45,-150050.82,5136512.26999998
"5108",2017-11-15 14:58:31,777830.84,5914343.10999998
"5109",2017-11-15 14:58:31,380050.39,6294393.49999998
"5110",2017-11-15 15:15:36,-1157881.23,5136512.26999998
"5111",2017-11-15 19:24:23,620359.14,5756871.40999998
"5112",2017-11-15 19:38:56,-620359.14,5136512.26999998
"5113",2017-11-15 20:26:01,325459.5,5461971.76999998
"5114",2017-11-15 20:28:25,305994.79,5767966.55999998
"5115",2017-11-15 20:30:21,-325459.5,5442507.05999998
"5116",2017-11-15 20:43:19,-305994.79,5136512.26999998
"5117",2017-11-15 20:43:19,490420.83,5626933.09999998
"18584",2017-11-15 20:43:19,512765.19,6139698.28999999
"18585",2017-11-15 20:43:19,-5136512.27,1003186.01999999
"5118",2017-11-15 21:03:58,-490420.83,512765.189999986
"18586",2017-11-15 21:06:32,-512765.19,-1.44354999065399e-08
"5119",2017-11-15 22:08:57,15945.32,15945.3199999856
"5120",2017-11-15 22:17:39,-15945.32,-1.44354999065399e-08
"18587",2017-11-15 22:17:39,393437.93,393437.929999986
"18588",2017-11-15 22:25:40,-393437.93,-1.44354999065399e-08
"18589",2017-11-15 23:20:26,381303.93,381303.929999986
"18590",2017-11-15 23:58:27,413424.57,794728.499999986
"18591",2017-11-16 00:05:15,-794728.5,-1.44354999065399e-08
"5121",2017-11-16 01:02:37,494491.39,494491.389999986
"5122",2017-11-16 01:29:27,-494491.39,-1.44354999065399e-08
"18592",2017-11-16 01:29:27,371046.95,371046.949999986
"18593",2017-11-16 01:29:27,391271.73,762318.679999985
"5123",2017-11-16 02:13:46,405610.8,1167929.47999999
"18594",2017-11-16 02:13:46,482314.85,1650244.32999999
"18595",2017-11-16 02:16:21,-762318.68,887925.649999986
"18596",2017-11-16 03:13:48,318368.23,1206293.87999999
"18597",2017-11-16 03:13:48,443717.57,1650011.44999999
"18598",2017-11-16 03:16:23,14916.2,1664927.64999999
"18599",2017-11-16 03:19:14,-1259316.85,405610.799999985
"5124",2017-11-16 04:21:24,-405610.8,-1.46101228892803e-08
"5125",2017-11-16 04:21:24,114185.9,114185.899999985
"5126",2017-11-16 04:21:24,777831.89,892017.789999985
"18600",2017-11-16 04:27:04,403143.36,1295161.14999999
"18601",2017-11-16 04:35:32,-403143.36,892017.789999985
"5127",2017-11-16 04:41:12,-892017.79,-1.45519152283669e-08
"18602",2017-11-16 04:47:14,355808.45,355808.449999985
"5128",2017-11-16 04:58:08,583760.62,939569.069999985
"18603",2017-11-16 04:58:08,-355808.45,583760.619999985
"5129",2017-11-16 05:03:02,-583760.62,-1.45519152283669e-08
"18604",2017-11-16 05:09:35,644319.38,644319.379999985
"18605",2017-11-16 05:40:01,-644319.38,-1.45519152283669e-08
"18606",2017-11-16 06:27:02,401266.57,401266.569999985
"18607",2017-11-16 06:45:20,-401266.57,-1.45519152283669e-08
"18608",2017-11-16 07:00:32,575976.48,575976.479999985
"18609",2017-11-16 07:17:14,-575976.48,-1.45519152283669e-08
"5130",2017-11-16 07:59:57,490914.87,490914.869999985
"18610",2017-11-16 07:59:57,582356.63,1073271.49999999
"5131",2017-11-16 08:43:09,-490914.87,582356.629999986
"5132",2017-11-16 08:43:09,729910.97,1312267.59999999
"18611",2017-11-16 08:48:08,-582356.63,729910.969999986
"5133",2017-11-16 08:58:48,-729910.97,-1.4319084584713e-08
"18612",2017-11-16 10:18:41,768455.67,768455.669999986
"18613",2017-11-16 10:26:38,-768455.67,-1.4319084584713e-08
"5134",2017-11-16 10:45:52,771203.31,771203.309999986
"5135",2017-11-16 10:49:09,-771203.31,-1.4319084584713e-08
"5136",2017-11-16 11:46:07,740542.33,740542.329999986
"5137",2017-11-16 12:02:55,-740542.33,-1.4319084584713e-08
"18614",2017-11-16 12:26:52,727933.06,727933.059999986
"5138",2017-11-16 13:55:45,704015.22,1431948.27999999
"5139",2017-11-16 13:55:45,698181.5,2130129.77999999
"5140",2017-11-16 14:15:53,-1402196.72,727933.059999986
"18615",2017-11-16 14:15:53,646724.48,1374657.53999999
"18616",2017-11-16 14:34:29,478896.47,1853554.00999999
"18617",2017-11-16 14:54:19,517207.22,2370761.22999999
"5141",2017-11-16 15:35:24,459924.36,2830685.58999999
"5142",2017-11-16 15:50:28,-459924.36,2370761.22999999
"18618",2017-11-16 16:19:08,702357.84,3073119.06999999
"5143",2017-11-16 16:40:40,777832.13,3850951.19999999
"5144",2017-11-16 16:40:40,48172.14,3899123.33999999
"5145",2017-11-16 17:04:25,-826004.27,3073119.06999999
"5146",2017-11-16 17:53:09,777832.16,3850951.22999999
"5147",2017-11-16 17:53:09,143075.17,3994026.39999999
"18619",2017-11-16 17:53:09,777832.18,4771858.57999999
"18620",2017-11-16 17:53:09,715854.1,5487712.67999998
"18621",2017-11-16 17:53:09,107396.19,5595108.86999999
"18622",2017-11-16 17:53:09,-3073119.07,2521989.79999999
"5148",2017-11-16 17:57:44,-920907.33,1601082.46999999
"18623",2017-11-16 17:57:44,-1601082.47,-1.46683305501938e-08
"5149",2017-11-16 18:00:39,209229.21,209229.209999985
"5150",2017-11-16 18:03:20,777832.2,987061.409999985
"5151",2017-11-16 18:36:47,-987061.41,-1.47847458720207e-08
"5152",2017-11-16 18:36:47,492333.78,492333.779999985
"18624",2017-11-16 18:36:47,31977.23,524311.009999985
"18625",2017-11-16 18:36:47,777832.22,1302143.22999999
"5153",2017-11-16 18:53:15,-492333.78,809809.449999985
"5154",2017-11-16 19:13:16,777832.28,1587641.72999999
"5155",2017-11-16 19:13:49,494163.52,2081805.24999999
"18626",2017-11-16 19:13:49,-809809.45,1271995.79999999
"5156",2017-11-16 19:36:42,-1271995.8,-1.49011611938477e-08
"5157",2017-11-16 19:39:58,636952.47,636952.469999985
"5158",2017-11-16 19:50:18,-636952.47,-1.49011611938477e-08
"18627",2017-11-16 20:29:54,720231.86,720231.859999985
"18628",2017-11-16 20:41:33,-720231.86,-1.49011611938477e-08
"5159",2017-11-16 21:02:09,442769.06,442769.059999985
"5160",2017-11-16 21:21:55,-442769.06,-1.49011611938477e-08
"5161",2017-11-16 21:42:56,75437.34,75437.3399999851
"5162",2017-11-16 21:42:56,777832.33,853269.669999985
"5163",2017-11-16 21:42:56,777832.32,1631101.98999998
"5164",2017-11-16 21:55:44,-1631101.99,-1.51339918375015e-08
"18629",2017-11-16 21:55:44,133135.36,133135.359999985
"18630",2017-11-16 21:55:44,777832.35,910967.709999985
"5165",2017-11-16 22:07:37,777832.37,1688800.07999998
"18631",2017-11-16 22:07:37,320267.39,2009067.46999998
"18632",2017-11-16 22:07:37,777832.38,2786899.84999998
"18633",2017-11-16 22:07:37,-910967.71,1875932.13999998
"18634",2017-11-16 22:07:37,-910967.71,964964.429999985
"5166",2017-11-16 22:20:58,-777832.37,187132.059999985
"5167",2017-11-16 22:20:58,489861.41,676993.469999985
"5168",2017-11-16 22:20:58,777832.4,1454825.86999998
"18635",2017-11-16 22:20:58,-187132.06,1267693.80999998
"5169",2017-11-16 22:35:47,-1267693.81,-1.53668224811554e-08
"5170",2017-11-16 22:35:47,204230.44,204230.439999985
"5171",2017-11-16 22:35:47,777832.43,982062.869999985
"5172",2017-11-16 22:53:42,-982062.87,-1.52504071593285e-08
"5173",2017-11-17 00:31:58,508350.46,508350.459999985
"5174",2017-11-17 00:31:58,777832.45,1286182.90999998
"18636",2017-11-17 00:31:58,328486.48,1614669.38999998
"18637",2017-11-17 00:31:58,777832.47,2392501.85999998
"5175",2017-11-17 00:41:23,-1286182.91,1106318.94999998
"5176",2017-11-17 00:41:23,777832.49,1884151.43999998
"5177",2017-11-17 00:41:23,381141.5,2265292.93999998
"18638",2017-11-17 00:41:23,-1106318.95,1158973.98999998
"5178",2017-11-17 01:18:35,-1158973.99,-1.53668224811554e-08
"5179",2017-11-17 01:18:35,204725.54,204725.539999985
"18639",2017-11-17 01:18:35,543399.52,748125.059999985
"18640",2017-11-17 01:18:35,777832.51,1525957.56999998
"5180",2017-11-17 01:34:35,-204725.54,1321232.02999998
"18641",2017-11-17 01:34:35,-1321232.03,-1.53668224811554e-08
"5181",2017-11-17 02:24:54,777826.78,777826.779999985
"5182",2017-11-17 02:29:31,-777826.78,-1.53668224811554e-08
"5183",2017-11-17 09:48:19,777828.03,777828.029999985
"5184",2017-11-17 09:53:24,100057.24,877885.269999985
"5185",2017-11-17 12:48:03,777835.1,1655720.36999998
"5186",2017-11-17 12:48:03,777832.53,2433552.89999998
"5187",2017-11-17 12:48:03,140301.11,2573854.00999998
"18642",2017-11-17 12:54:59,166454.09,2740308.09999998
"18643",2017-11-17 12:54:59,777835.05,3518143.14999998
"18644",2017-11-17 12:54:59,777835.07,4295978.21999998
"18645",2017-11-17 12:54:59,777835.08,5073813.29999998
"18646",2017-11-17 12:54:59,777835.06,5851648.35999998
"5188",2017-11-17 13:09:57,377828.19,6229476.54999998
"18647",2017-11-17 15:05:13,547881.48,6777358.02999998
"5189",2017-11-17 16:57:51,-2951682.2,3825675.82999998
"5190",2017-11-17 22:33:41,565299.2,4390975.02999998
"5191",2017-11-17 23:05:18,613325.45,5004300.47999998
"5192",2017-11-17 23:40:03,562501.76,5566802.23999998
"5193",2017-11-18 00:24:01,888946.2,6455748.43999998
"5194",2017-11-18 00:24:01,888946.19,7344694.62999998
"5195",2017-11-18 00:31:53,-1741126.41,5603568.21999998
"5196",2017-11-18 00:48:10,-1777892.39,3825675.82999998
"5197",2017-11-18 09:03:02,458545.16,4284220.98999998
"5198",2017-11-18 09:11:05,-458545.16,3825675.82999998
"5199",2017-11-18 10:13:40,641025.24,4466701.06999998
"5200",2017-11-18 10:27:58,-641025.24,3825675.82999998
"18648",2017-11-18 11:27:10,431540.29,4257216.11999998
"18649",2017-11-18 11:37:21,59716.31,4316932.42999998
"18650",2017-11-18 11:42:08,777835.3,5094767.72999998
"5201",2017-11-18 11:54:52,659532.16,5754299.88999998
"5202",2017-11-18 12:02:11,-659532.16,5094767.72999998
"5203",2017-11-18 12:40:09,453686.38,5548454.10999998
"5204",2017-11-18 12:55:18,-453686.38,5094767.72999998
"18651",2017-11-18 13:09:58,642254.54,5737022.26999998
"5205",2017-11-18 13:45:15,682525.07,6419547.33999998
"5206",2017-11-18 14:01:48,-682525.07,5737022.26999998
"5207",2017-11-18 14:27:50,744237.36,6481259.62999998
"5208",2017-11-18 14:38:07,-744237.36,5737022.26999998
"5209",2017-11-18 14:38:07,449108.52,6186130.78999998
"5210",2017-11-18 14:46:58,-449108.52,5737022.26999998
"5211",2017-11-18 16:38:10,34151.54,5771173.80999998
"5212",2017-11-18 16:44:17,-34151.54,5737022.26999998
"18652",2017-11-18 17:52:40,769597.66,6506619.92999998
"5213",2017-11-18 18:34:18,449583.59,6956203.51999998
"5214",2017-11-18 18:42:21,-449583.59,6506619.92999998
"5215",2017-11-18 19:08:28,217226.44,6723846.36999999
"5216",2017-11-18 19:08:28,777835.43,7501681.79999998
"5217",2017-11-18 19:34:56,-995061.87,6506619.92999998
"5218",2017-11-18 19:34:56,479890.88,6986510.80999998
"5219",2017-11-18 19:47:34,-479890.88,6506619.92999998
"18653",2017-11-18 20:11:58,526496.53,7033116.45999999
"18654",2017-11-18 21:27:55,395326.47,7428442.92999998
"18655",2017-11-18 21:27:55,777835.46,8206278.38999998
"18656",2017-11-18 22:59:55,777835.49,8984113.87999998
"18657",2017-11-18 22:59:55,260782.5,9244896.37999998
"18658",2017-11-19 00:03:10,777835.51,10022731.89
"18659",2017-11-19 00:03:10,315311.52,10338043.41
"18660",2017-11-19 06:05:12,-10338043.41,-1.67638063430786e-08
"5220",2017-11-19 17:54:23,716845.58,716845.579999983
"18661",2017-11-19 17:54:23,777835.55,1494681.12999998
"18662",2017-11-19 17:54:23,490591.56,1985272.68999998
"5221",2017-11-19 18:10:38,-716845.58,1268427.10999998
"5222",2017-11-19 18:10:38,777835.57,2046262.67999998
"18663",2017-11-19 18:10:38,777835.6,2824098.27999998
"18664",2017-11-19 18:10:38,169802.62,2993900.89999998
"18665",2017-11-19 18:10:38,777835.61,3771736.50999998
"18666",2017-11-19 18:10:38,-1268427.11,2503309.39999998
"18667",2017-11-19 18:14:49,-1725473.83,777835.569999983
"5223",2017-11-19 18:27:00,-777835.57,-1.73458829522133e-08
"5224",2017-11-19 18:27:00,560576.64,560576.639999983
"5225",2017-11-19 18:27:00,777835.63,1338412.26999998
"18668",2017-11-19 18:27:00,777835.65,2116247.91999998
"18669",2017-11-19 18:27:00,145582.66,2261830.57999998
"5226",2017-11-19 18:37:19,-1338412.27,923418.309999983
"18670",2017-11-19 18:37:19,207379.68,1130797.98999998
"18671",2017-11-19 18:37:19,777835.67,1908633.65999998
"18672",2017-11-19 18:37:19,-923418.31,985215.349999983
"18673",2017-11-19 18:49:40,-985215.35,-1.71130523085594e-08
"18674",2017-11-20 12:23:55,1264479.12,1264479.11999998
"5227",2017-11-20 16:16:17,342374.81,1606853.92999998
"5228",2017-11-20 16:16:17,777835.8,2384689.72999998
"5229",2017-11-20 16:20:22,-1120210.61,1264479.11999998
"18675",2017-11-20 20:47:56,-1264479.12,-1.74622982740402e-08
"18676",2017-11-21 00:02:17,3680009.19,3680009.18999998
"18677",2017-11-21 00:20:29,-3680009.19,-1.72294676303864e-08
"5230",2017-11-22 10:46:16,95496.68,95496.6799999828
"5231",2017-11-22 10:59:56,-95496.68,-1.72294676303864e-08
"5232",2017-11-22 11:26:35,61713.99,61713.9899999828
"5233",2017-11-22 11:34:30,-61713.99,-1.72294676303864e-08
"5234",2017-11-22 13:26:07,36370.31,36370.3099999828
"5235",2017-11-22 13:29:20,-36370.31,-1.72294676303864e-08
"5236",2017-11-22 13:50:39,210144.44,210144.439999983
"5237",2017-11-22 14:19:30,173115.18,383259.619999983
"5238",2017-11-22 14:19:30,-210144.44,173115.179999983
"5239",2017-11-22 14:30:13,-173115.18,-1.72294676303864e-08
"5240",2017-11-22 16:04:04,113369.62,113369.619999983
"5241",2017-11-22 16:23:49,-113369.62,-1.72294676303864e-08
"5242",2017-11-22 21:55:40,56852.46,56852.4599999828
"5243",2017-11-22 22:08:51,-56852.46,-1.72294676303864e-08
"5244",2017-11-23 05:06:45,777844.44,777844.439999983
"5245",2017-11-23 05:26:13,777844.49,1555688.92999998
"5246",2017-11-23 05:26:13,-777844.44,777844.489999983
"5247",2017-11-23 05:39:46,-777844.49,-1.72294676303864e-08
"5248",2017-11-23 10:44:47,777846.62,777846.619999983
"5249",2017-11-23 10:51:40,777846.71,1555693.32999998
"5250",2017-11-23 10:51:40,777846.69,2333540.01999998
"5251",2017-11-23 11:01:05,-777846.62,1555693.39999998
"5252",2017-11-23 11:11:15,-1555693.4,-1.72294676303864e-08
"5253",2017-11-23 12:05:06,777847.14,777847.139999983
"5254",2017-11-23 12:08:50,-777847.14,-1.72294676303864e-08
"5255",2017-11-23 14:35:44,777848.29,777848.289999983
"5256",2017-11-23 14:47:25,-777848.29,-1.72294676303864e-08
"18678",2017-11-23 17:59:26,437365.93,437365.929999983
"18679",2017-11-23 18:17:01,311252.96,748618.889999983
"18680",2017-11-23 18:21:43,438058.35,1186677.23999998
"18681",2017-11-23 19:03:57,408164.91,1594842.14999998
"5257",2017-11-23 19:54:12,313408.87,1908251.01999998
"5258",2017-11-23 20:03:09,335331.75,2243582.76999998
"5259",2017-11-23 20:03:09,-313408.87,1930173.89999998
"5260",2017-11-23 20:18:29,-335331.75,1594842.14999998
"18682",2017-11-23 20:40:20,-1594842.15,-1.72294676303864e-08
"5261",2017-11-23 20:50:33,129171.68,129171.679999983
"5262",2017-11-23 20:50:33,591036.36,720208.039999983
"18683",2017-11-23 20:50:33,23991.32,744199.359999983
"5263",2017-11-23 20:59:38,-720208.04,23991.3199999827
"18684",2017-11-23 20:59:38,-23991.32,-1.72803993336856e-08
"18685",2017-11-23 22:43:18,351597.86,351597.859999983
"18686",2017-11-23 22:45:54,-351597.86,-1.72876752912998e-08
"18687",2017-11-24 00:37:31,389582.49,389582.489999983
"18688",2017-11-24 00:42:26,-389582.49,-1.72876752912998e-08
"5264",2017-11-24 01:16:34,303092.72,303092.719999983
"5265",2017-11-24 01:41:24,-303092.72,-1.72876752912998e-08
"18689",2017-11-24 01:41:24,324836.48,324836.479999983
"5266",2017-11-24 03:54:13,266031.24,590867.719999983
"5267",2017-11-24 04:08:25,-266031.24,324836.479999983
"5268",2017-11-24 06:23:21,320418.95,645255.429999983
"5269",2017-11-24 06:31:19,-320418.95,324836.479999983
"18690",2017-11-24 07:20:46,283933.34,608769.819999983
"5270",2017-11-24 08:27:30,597153.99,1205923.80999998
"5271",2017-11-24 08:27:30,356559.05,1562482.85999998
"5272",2017-11-24 08:43:21,402713.61,1965196.46999998
"5273",2017-11-24 08:43:21,-953713.04,1011483.42999998
"5274",2017-11-24 09:00:01,274593.37,1286076.79999998
"5275",2017-11-24 09:00:01,-402713.61,883363.189999983
"5276",2017-11-24 09:10:36,-274593.37,608769.819999983
"5277",2017-11-24 09:43:17,463246.21,1072016.02999998
"5278",2017-11-24 09:50:45,-463246.21,608769.819999983
"18691",2017-11-24 09:50:45,649053.47,1257823.28999998
"18692",2017-11-24 10:08:05,400733.04,1658556.32999998
"18693",2017-11-24 10:08:05,301457.64,1960013.96999998
"18694",2017-11-24 10:41:24,386768.46,2346782.42999998
"18695",2017-11-24 11:20:53,627661.64,2974444.06999998
"5279",2017-11-24 11:47:07,403917.83,3378361.89999998
"5280",2017-11-24 11:58:37,-403917.83,2974444.06999998
"5281",2017-11-24 12:33:50,338880.65,3313324.71999998
"5282",2017-11-24 12:38:04,368815.79,3682140.50999998
"5283",2017-11-24 12:57:52,-707696.44,2974444.06999998
"5284",2017-11-24 13:39:08,887911.51,3862355.57999998
"18696",2017-11-24 13:39:08,447675.21,4310030.78999998
"5285",2017-11-24 14:14:41,-887911.51,3422119.27999998
"5286",2017-11-24 14:42:17,477827.96,3899947.23999998
"5287",2017-11-24 14:54:39,-477827.96,3422119.27999998
"5288",2017-11-24 15:23:11,19068.4,3441187.67999998
"5289",2017-11-24 15:35:03,483911.19,3925098.86999998
"5290",2017-11-24 15:35:03,-19068.4,3906030.46999998
"5291",2017-11-24 15:56:30,-483911.19,3422119.27999998
"5292",2017-11-24 16:48:43,406419.76,3828539.03999998
"5293",2017-11-24 16:52:41,-406419.76,3422119.27999998
"18697",2017-11-24 17:12:20,390115.03,3812234.30999998
"18698",2017-11-24 17:15:10,716057.99,4528292.29999998
"18699",2017-11-24 17:26:32,730030.93,5258323.22999998
"18700",2017-11-24 17:26:32,-4528292.3,730030.929999984
"18701",2017-11-24 17:30:33,-730030.93,-1.61817297339439e-08
"5294",2017-11-24 17:58:58,726518.02,726518.019999984
"5295",2017-11-24 18:04:31,-726518.02,-1.61817297339439e-08
"18702",2017-11-24 19:21:50,637086.91,637086.909999984
"18703",2017-11-24 19:30:33,-637086.91,-1.61817297339439e-08
"18704",2017-11-24 19:53:16,137060.46,137060.459999984
"18705",2017-11-24 19:53:16,777850.45,914910.909999984
"18706",2017-11-24 19:56:46,-914910.91,-1.62981450557709e-08
"5296",2017-11-24 20:27:58,437784.47,437784.469999984
"5297",2017-11-24 20:50:34,-437784.47,-1.62981450557709e-08
"18707",2017-11-24 22:53:56,458023.45,458023.449999984
"18708",2017-11-24 23:18:22,-458023.45,-1.62981450557709e-08
"5298",2017-11-24 23:30:00,633749.35,633749.349999984
"18709",2017-11-24 23:30:00,191525.5,825274.849999984
"18710",2017-11-24 23:30:00,777850.49,1603125.33999998
"5299",2017-11-24 23:49:16,-633749.35,969375.989999984
"18711",2017-11-24 23:49:16,437039.32,1406415.30999998
"18712",2017-11-24 23:49:16,-969375.99,437039.319999984
"18713",2017-11-25 00:04:40,-437039.32,-1.64727680385113e-08
"18714",2017-11-25 00:18:58,565681.48,565681.479999983
"18715",2017-11-25 00:21:42,-565681.48,-1.65309756994247e-08
"18716",2017-11-25 01:27:10,116648.55,116648.549999983
"18717",2017-11-25 01:27:10,777850.54,894499.089999984
"5300",2017-11-25 01:38:38,475124.27,1369623.35999998
"18718",2017-11-25 01:38:38,-894499.09,475124.269999984
"5301",2017-11-25 02:06:19,-475124.27,-1.64145603775978e-08
"18719",2017-11-25 02:40:06,548055.51,548055.509999984
"18720",2017-11-25 02:56:54,-548055.51,-1.64145603775978e-08
"5302",2017-11-25 05:15:59,697647.39,697647.389999984
"5303",2017-11-25 05:46:50,-697647.39,-1.64145603775978e-08
"5304",2017-11-25 07:09:51,35373.72,35373.7199999836
"5305",2017-11-25 07:24:31,-35373.72,-1.64145603775978e-08
"18721",2017-11-25 07:48:11,28554.65,28554.6499999836
"18722",2017-11-25 07:48:11,777850.64,806405.289999984
"18723",2017-11-25 08:02:14,-806405.29,-1.64145603775978e-08
"5306",2017-11-25 08:33:13,777850.66,777850.659999984
"5307",2017-11-25 08:33:13,636619.07,1414469.72999998
"5308",2017-11-25 08:33:13,286629.67,1701099.39999998
"5309",2017-11-25 08:54:06,-1701099.4,-1.62981450557709e-08
"5310",2017-11-25 09:07:14,121590.7,121590.699999984
"5311",2017-11-25 09:07:14,777850.69,899441.389999984
"5312",2017-11-25 09:19:18,-899441.39,-1.64145603775978e-08
"5313",2017-11-25 09:29:01,743434.44,743434.439999984
"18724",2017-11-25 09:29:01,727389.95,1470824.38999998
"5314",2017-11-25 09:33:19,-743434.44,727389.949999983
"18725",2017-11-25 09:33:19,564197.61,1291587.55999998
"5315",2017-11-25 09:41:47,621472.11,1913059.66999998
"5316",2017-11-25 09:59:36,-621472.11,1291587.55999998
"18726",2017-11-25 09:59:36,763201.11,2054788.66999998
"5317",2017-11-25 10:38:54,105626.77,2160415.43999998
"5318",2017-11-25 10:38:54,777850.76,2938266.19999998
"5319",2017-11-25 10:52:48,-883477.53,2054788.66999998
"18727",2017-11-25 11:13:10,115994.79,2170783.45999998
"18728",2017-11-25 11:13:10,777850.78,2948634.23999998
"5320",2017-11-25 13:32:56,88962.45,3037596.68999998
"5321",2017-11-25 13:32:56,300074.51,3337671.19999998
"5322",2017-11-25 13:51:49,-389036.96,2948634.23999998
"18729",2017-11-25 14:27:37,78289.27,3026923.50999998
"18730",2017-11-25 14:56:45,18676.87,3045600.37999998
"18731",2017-11-25 15:27:34,4091.84,3049692.21999998
"5323",2017-11-25 17:03:44,53005.8,3102698.01999998
"5324",2017-11-25 17:16:28,-53005.8,3049692.21999998
"5325",2017-11-25 17:36:26,59949.16,3109641.37999998
"5326",2017-11-25 17:44:48,-59949.16,3049692.21999998
"5327",2017-11-25 18:00:15,89746.45,3139438.66999998
"5328",2017-11-25 18:04:43,-89746.45,3049692.21999998
"5329",2017-11-25 18:44:51,75483.59,3125175.80999998
"5330",2017-11-25 18:52:25,-75483.59,3049692.21999998
"5331",2017-11-25 20:04:27,113721.93,3163414.14999998
"5332",2017-11-25 20:33:52,-113721.93,3049692.21999998
"5333",2017-11-25 23:22:39,300075.26,3349767.47999998
"5334",2017-11-25 23:26:44,-300075.26,3049692.21999998
"5335",2017-11-26 01:04:06,364595.74,3414287.95999998
"5336",2017-11-26 01:25:27,-364595.74,3049692.21999998
"5337",2017-11-26 01:35:38,207436.55,3257128.76999998
"5338",2017-11-26 02:13:41,-207436.55,3049692.21999998
"5339",2017-11-26 03:03:58,352091.14,3401783.35999998
"5340",2017-11-26 03:14:48,-352091.14,3049692.21999998
"5341",2017-11-26 04:03:28,236190.39,3285882.60999998
"5342",2017-11-26 04:30:13,-236190.39,3049692.21999998
"5343",2017-11-26 06:16:20,270017.41,3319709.62999998
"18732",2017-11-26 06:16:20,-3049692.22,270017.409999984
"5344",2017-11-26 06:17:14,230868.6,500886.009999984
"5345",2017-11-26 06:30:01,-500886.01,-1.61817297339439e-08
"5346",2017-11-26 06:30:01,230802.12,230802.119999984
"5347",2017-11-26 06:38:37,-230802.12,-1.61817297339439e-08
"5348",2017-11-26 07:23:02,228934.78,228934.779999984
"5349",2017-11-26 07:31:37,-228934.78,-1.61817297339439e-08
"5350",2017-11-26 08:21:16,10190.2,10190.1999999838
"5351",2017-11-26 08:29:28,-10190.2,-1.61817297339439e-08
"5352",2017-11-26 08:29:28,198336.43,198336.429999984
"5353",2017-11-26 08:38:46,-198336.43,-1.61817297339439e-08
"5354",2017-11-26 09:41:46,355244.14,355244.139999984
"5355",2017-11-26 09:41:46,196750.62,551994.759999984
"5356",2017-11-26 09:47:49,-551994.76,-1.61817297339439e-08
"18733",2017-11-26 10:13:18,227395.56,227395.559999984
"18734",2017-11-26 10:24:31,-227395.56,-1.61817297339439e-08
"18735",2017-11-26 11:20:04,313980.59,313980.589999984
"18736",2017-11-26 11:28:15,-313980.59,-1.61817297339439e-08
"18737",2017-11-26 13:06:17,337421.49,337421.489999984
"18738",2017-11-26 13:16:59,-337421.49,-1.61817297339439e-08
"18739",2017-11-26 15:49:51,424100.72,424100.719999984
"18740",2017-11-26 16:03:49,-424100.72,-1.61817297339439e-08
"18741",2017-11-26 16:25:08,546294.94,546294.939999984
"18742",2017-11-26 16:28:42,-546294.94,-1.61817297339439e-08
"18743",2017-11-26 17:03:12,388966.76,388966.759999984
"18744",2017-11-26 17:29:03,325709.96,714676.719999984
"18745",2017-11-26 17:29:03,-388966.76,325709.959999984
"18746",2017-11-26 17:38:22,-325709.96,-1.61235220730305e-08
"5357",2017-11-26 18:15:05,367824.89,367824.889999984
"5358",2017-11-26 18:28:03,-367824.89,-1.61235220730305e-08
"18747",2017-11-26 19:11:44,57769.53,57769.5299999839
"18748",2017-11-26 19:31:53,269802.23,327571.759999984
"18749",2017-11-26 19:31:53,122132.21,449703.969999984
"18750",2017-11-26 19:31:53,17246.34,466950.309999984
"18751",2017-11-26 19:31:53,-57769.53,409180.779999984
"18752",2017-11-26 19:36:26,-409180.78,-1.61817297339439e-08
"5359",2017-11-26 19:58:10,16770.06,16770.0599999838
"18753",2017-11-26 19:58:10,302299.63,319069.689999984
"5360",2017-11-26 20:14:41,-16770.06,302299.629999984
"5361",2017-11-26 20:14:41,147372.17,449671.799999984
"18754",2017-11-26 20:14:41,-302299.63,147372.169999984
"18755",2017-11-26 20:22:56,6106.49,153478.659999984
"5362",2017-11-26 20:31:25,-147372.17,6106.48999998384
"18756",2017-11-26 20:31:25,-6106.49,-1.61617208505049e-08
"18757",2017-11-26 21:14:21,95014.62,95014.6199999838
"5363",2017-11-26 21:34:21,114038.71,209053.329999984
"18758",2017-11-26 21:34:21,-95014.62,114038.709999984
"5364",2017-11-26 21:47:15,-114038.71,-1.61671778187156e-08
"5365",2017-11-26 21:47:15,78793.55,78793.5499999838
"5366",2017-11-26 22:01:16,-78793.55,-1.61671778187156e-08
"5367",2017-11-26 22:09:53,7807.88,7807.87999998383
"5368",2017-11-26 22:32:10,-7807.88,-1.61671778187156e-08
"18759",2017-11-26 22:46:01,5595.65,5595.64999998383
"18760",2017-11-26 22:48:44,-5595.65,-1.61671778187156e-08
"18761",2017-11-26 23:16:28,89073.82,89073.8199999838
"18762",2017-11-26 23:16:28,2087.61,91161.4299999838
"18763",2017-11-26 23:19:57,-91161.43,-1.61526259034872e-08
"18764",2017-11-26 23:29:00,1397.96,1397.95999998385
"18765",2017-11-26 23:35:33,-1397.96,-1.61526259034872e-08
"5369",2017-11-26 23:36:36,777853.4,777853.399999984
"5370",2017-11-26 23:38:21,777853.42,1555706.81999998
"18766",2017-11-26 23:38:21,777853.41,2333560.22999998
"18767",2017-11-26 23:38:21,777853.45,3111413.67999998
"5371",2017-11-26 23:49:04,777853.44,3889267.11999998
"5372",2017-11-26 23:49:04,777853.46,4667120.57999998
"5373",2017-11-26 23:49:04,-1555706.82,3111413.75999998
"18768",2017-11-26 23:49:04,777853.43,3889267.18999998
"18769",2017-11-26 23:49:04,777853.48,4667120.66999998
"18770",2017-11-26 23:49:04,777853.47,5444974.13999998
"18771",2017-11-26 23:49:04,-1555706.86,3889267.27999998
"18772",2017-11-26 23:52:38,-2333560.38,1555706.89999998
"5374",2017-11-27 00:10:24,888964.49,2444671.38999998
"5375",2017-11-27 00:10:24,777853.53,3222524.91999998
"5376",2017-11-27 00:10:24,-1555706.9,1666818.01999998
"18773",2017-11-27 00:10:24,777853.5,2444671.51999998
"18774",2017-11-27 00:10:24,777853.52,3222525.03999998
"5377",2017-11-27 00:20:55,777853.55,4000378.58999998
"5378",2017-11-27 00:20:55,-1666818.02,2333560.56999998
"18775",2017-11-27 00:20:55,777853.54,3111414.10999998
"18776",2017-11-27 00:20:55,777853.57,3889267.67999998
"18777",2017-11-27 00:20:55,777853.56,4667121.23999998
"18778",2017-11-27 00:20:55,-1555707.02,3111414.21999998
"5379",2017-11-27 00:32:52,777853.58,3889267.79999998
"5380",2017-11-27 00:32:52,-777853.55,3111414.24999998
"18779",2017-11-27 00:32:52,777853.59,3889267.83999998
"18780",2017-11-27 00:32:52,-2333560.67,1555707.16999998
"18781",2017-11-27 00:37:16,-777853.59,777853.579999983
"5381",2017-11-27 00:46:30,-777853.58,-1.67638063430786e-08
"18782",2017-11-27 00:50:18,213421.61,213421.609999983
"18783",2017-11-27 00:57:39,-213421.61,-1.67638063430786e-08
"18784",2017-11-27 01:22:43,206988.64,206988.639999983
"18785",2017-11-27 06:49:49,150077.45,357066.089999983
"5382",2017-11-27 12:07:58,461002.66,818068.749999983
"5383",2017-11-27 12:07:58,777853.65,1595922.39999998
"5384",2017-11-27 12:07:58,888965.85,2484888.24999998
"5385",2017-11-27 12:07:58,888965.81,3373854.05999998
"5386",2017-11-27 12:07:58,777854.83,4151708.88999998
"18786",2017-11-27 12:07:58,777853.63,4929562.51999998
"18787",2017-11-27 12:07:58,888965.86,5818528.37999998
"18788",2017-11-27 12:07:58,888965.84,6707494.21999998
"18789",2017-11-27 12:07:58,777853.6,7485347.81999998
"18790",2017-11-27 12:07:58,777854.82,8263202.63999998
"5387",2017-11-27 12:24:30,888965.87,9152168.50999998
"5388",2017-11-27 12:24:30,888965.89,10041134.4
"5389",2017-11-27 12:24:30,-3794642.8,6246491.59999998
"18791",2017-11-27 12:24:30,888965.88,7135457.47999998
"5390",2017-11-27 12:34:05,-1777931.76,5357525.71999998
"5391",2017-11-27 12:45:07,888965.9,6246491.61999998
"5392",2017-11-27 12:58:19,-888965.9,5357525.71999998
"5393",2017-11-27 13:02:40,88965.91,5446491.62999998
"5394",2017-11-27 13:07:20,-88965.91,5357525.71999998
"5395",2017-11-27 13:32:36,888965.94,6246491.65999998
"5396",2017-11-27 13:32:36,888965.93,7135457.58999998
"18792",2017-11-27 13:32:36,888965.95,8024423.53999998
"5397",2017-11-27 13:57:50,-1777931.87,6246491.66999998
"5398",2017-11-27 14:21:05,888965.96,7135457.62999998
"5399",2017-11-27 14:33:35,-888965.96,6246491.66999998
"5400",2017-11-27 15:32:55,888966,7135457.66999998
"18793",2017-11-27 15:32:55,777854.97,7913312.63999998
"18794",2017-11-27 15:35:50,634969.98,8548282.61999998
"18795",2017-11-27 15:35:50,888965.99,9437248.60999998
"5401",2017-11-27 15:44:17,-888966,8548282.60999998
"5402",2017-11-27 17:07:00,777855.04,9326137.64999998
"5403",2017-11-27 17:17:41,-777855.04,8548282.60999998
"5404",2017-11-27 21:03:56,777855.07,9326137.67999998
"5405",2017-11-27 21:03:56,377748.08,9703885.75999998
"5406",2017-11-27 21:16:34,-1155603.15,8548282.60999998
"5407",2017-11-27 22:19:08,603696.16,9151978.76999998
"5408",2017-11-27 22:32:14,-603696.16,8548282.60999998
"18796",2017-11-27 23:29:20,777855.1,9326137.70999998
"5409",2017-11-28 00:56:04,33057.39,9359195.09999998
"5410",2017-11-28 01:21:18,-33057.39,9326137.70999998
"5411",2017-11-28 04:04:34,65503.24,9391640.94999998
"5412",2017-11-28 04:13:57,-65503.24,9326137.70999998
"5413",2017-11-28 07:15:23,77855.73,9403993.43999998
"5414",2017-11-28 07:15:23,777855.71,10181849.15
"18797",2017-11-28 07:15:23,-9326137.71,855711.439999983
"5415",2017-11-28 07:28:48,522139.31,1377850.74999998
"5416",2017-11-28 07:28:48,777855.79,2155706.53999998
"5417",2017-11-28 07:28:48,-855711.44,1299995.09999998
"5418",2017-11-28 07:51:55,-1299995.1,-1.72294676303864e-08
"5419",2017-11-28 12:57:45,738473.42,738473.419999983
"18798",2017-11-28 12:57:45,777856.05,1516329.46999998
"18799",2017-11-28 12:57:45,323040.11,1839369.57999998
"18800",2017-11-28 12:57:45,330263.07,2169632.64999998
"18801",2017-11-28 12:57:45,777856.06,2947488.70999998
"5420",2017-11-28 13:08:49,-738473.42,2209015.28999998
"18802",2017-11-28 13:08:49,-2209015.29,-1.72294676303864e-08
"5421",2017-11-28 14:22:52,888967.13,888967.129999983
"5422",2017-11-28 14:22:52,888967.09,1777934.21999998
"18803",2017-11-28 14:22:52,888967.14,2666901.35999998
"18804",2017-11-28 14:22:52,888967.1,3555868.45999998
"5423",2017-11-28 14:41:17,888967.11,4444835.56999998
"5424",2017-11-28 14:41:17,-1777934.22,2666901.34999998
"18805",2017-11-28 14:41:17,888967.12,3555868.46999998
"5425",2017-11-28 14:52:12,-888967.11,2666901.35999998
"18806",2017-11-28 22:53:25,1131687.55,3798588.90999998
"18807",2017-11-29 01:03:33,103562.75,3902151.65999998
"18808",2017-11-29 01:13:28,254120.22,4156271.87999998
"18809",2017-11-29 01:13:28,777856.21,4934128.08999998
"18810",2017-11-29 01:27:07,888967.25,5823095.33999998
"18811",2017-11-29 01:27:07,888967.24,6712062.57999998
"5426",2017-11-29 01:58:09,888967.27,7601029.84999998
"18812",2017-11-29 01:58:09,888967.28,8489997.12999998
"5427",2017-11-29 02:07:32,-888967.27,7601029.85999998
"5428",2017-11-29 02:58:30,888967.29,8489997.14999998
"5429",2017-11-29 03:31:23,-888967.29,7601029.85999998
"5430",2017-11-29 04:31:20,777856.31,8378886.16999998
"5431",2017-11-29 04:43:38,-777856.31,7601029.85999998
"18813",2017-11-29 05:27:44,1070306.5,8671336.35999998
"18814",2017-11-29 05:49:41,47425.45,8718761.80999998
"18815",2017-11-29 05:52:58,1479342.87,10198104.68
"18816",2017-11-29 06:16:34,14600.17,10212704.85
"18817",2017-11-29 06:16:34,66091.84,10278796.69
"18818",2017-11-29 06:27:08,12956.74,10291753.43
"18819",2017-11-29 06:38:54,11205.06,10302958.49
"18820",2017-11-29 06:49:27,7081.87,10310040.36
"5432",2017-11-29 08:11:21,888967.71,11199008.07
"5433",2017-11-29 08:11:21,888967.69,12087975.76
"18821",2017-11-29 08:11:21,888967.72,12976943.48
"5434",2017-11-29 08:20:49,-1777935.4,11199008.08
"5435",2017-11-29 08:38:54,888967.81,12087975.89
"5436",2017-11-29 08:38:54,888967.75,12976943.64
"5437",2017-11-29 08:38:54,888967.73,13865911.37
"5438",2017-11-29 08:38:54,888967.79,14754879.16
"18822",2017-11-29 08:38:54,888967.68,15643846.84
"18823",2017-11-29 08:38:54,888967.8,16532814.64
"18824",2017-11-29 08:38:54,888967.7,17421782.34
"18825",2017-11-29 08:38:54,888967.74,18310750.08
"18826",2017-11-29 08:40:03,888967.76,19199717.84
"18827",2017-11-29 08:40:03,888967.78,20088685.62
"5439",2017-11-29 08:47:38,888967.77,20977653.39
"5440",2017-11-29 08:47:38,-3555871.08,17421782.31
"5441",2017-11-29 08:58:14,-888967.77,16532814.54
"18828",2017-11-29 11:05:25,971900.98,17504715.52
"18829",2017-11-29 12:14:14,888967.87,18393683.39
"18830",2017-11-29 13:06:02,777856.89,19171540.28
"18831",2017-11-29 13:06:02,777856.88,19949397.16
"18832",2017-11-29 13:06:02,555978.9,20505376.06
"18833",2017-11-29 13:23:17,777856.91,21283232.97
"18834",2017-11-29 13:23:17,777856.92,22061089.89
"18835",2017-11-29 13:23:17,651063.93,22712153.82
"5442",2017-11-29 16:46:12,95745.16,22807898.98
"5443",2017-11-29 17:11:07,-95745.16,22712153.82
"5444",2017-11-29 17:38:07,777857.11,23490010.93
"5445",2017-11-29 17:50:13,888968.12,24378979.05
"5446",2017-11-29 17:53:04,-777857.11,23601121.94
"5447",2017-11-29 18:13:02,-888968.12,22712153.82
"5448",2017-11-29 18:54:57,392815.75,23104969.57
"5449",2017-11-29 19:05:14,292772.15,23397741.72
"5450",2017-11-29 19:05:14,777857.14,24175598.86
"5451",2017-11-29 19:05:14,-392815.75,23782783.11
"18836",2017-11-29 19:50:08,574309.92,24357093.03
"5452",2017-11-29 19:56:44,-1070629.29,23286463.74
"18837",2017-11-29 21:29:24,777857.23,24064320.97
"18838",2017-11-29 21:29:24,53221.24,24117542.21
"5453",2017-11-29 22:18:48,494093.27,24611635.48
"5454",2017-11-29 22:18:48,777857.28,25389492.76
"5455",2017-11-29 22:18:48,777857.26,26167350.02
"5456",2017-11-29 22:18:48,777857.25,26945207.27
"18839",2017-11-29 22:41:11,275481.3,27220688.57
"18840",2017-11-29 22:41:11,777857.29,27998545.86
"5457",2017-11-29 22:45:48,-2827665.06,25170880.8
"18841",2017-11-29 23:30:13,187043.32,25357924.12
"18842",2017-11-29 23:30:13,777857.31,26135781.43
"5458",2017-11-29 23:45:59,900720.94,27036502.37
"5459",2017-11-29 23:48:24,5666.35,27042168.72
"5460",2017-11-29 23:48:24,777857.34,27820026.06
"5461",2017-11-29 23:50:21,-900720.94,26919305.12
"5462",2017-11-30 00:09:38,777857.39,27697162.51
"5463",2017-11-30 00:09:38,197009.37,27894171.88
"5464",2017-11-30 00:09:38,777857.36,28672029.24
"5465",2017-11-30 00:09:38,-783523.69,27888505.55
"18843",2017-11-30 00:09:38,22228.16,27910733.71
"5466",2017-11-30 00:20:23,-1752724.12,26158009.59
"5467",2017-11-30 00:33:58,777857.4,26935866.99
"5468",2017-11-30 00:33:58,381455.41,27317322.4
"5469",2017-11-30 00:39:09,-1159312.81,26158009.59
"18844",2017-11-30 00:57:20,660288.3,26818297.89
"5470",2017-11-30 01:13:59,579456.18,27397754.07
"5471",2017-11-30 01:25:35,-579456.18,26818297.89
"5472",2017-11-30 01:31:17,632743.53,27451041.42
"5473",2017-11-30 01:31:17,472435.65,27923477.07
"5474",2017-11-30 01:54:03,-1105179.18,26818297.89
"18845",2017-11-30 02:09:13,574476.15,27392774.04
"18846",2017-11-30 02:18:13,78536.48,27471310.52
"18847",2017-11-30 02:18:13,777857.47,28249167.99
"18848",2017-11-30 02:23:08,777857.49,29027025.48
"18849",2017-11-30 02:23:08,240398.5,29267423.98
"18850",2017-11-30 04:28:23,506354.02,29773778
"18851",2017-11-30 07:37:15,777858.3,30551636.3
"18852",2017-11-30 08:12:11,1587533.61,32139169.91
"5475",2017-11-30 08:30:33,777858.41,32917028.32
"5476",2017-11-30 08:30:33,343090.42,33260118.74
"5477",2017-11-30 08:54:34,-1120948.83,32139169.91
"18853",2017-11-30 09:17:20,475148.56,32614318.47
"18854",2017-11-30 10:05:41,660536.48,33274854.95
"5478",2017-11-30 10:08:23,467828.79,33742683.74
"5479",2017-11-30 10:22:28,-467828.79,33274854.95
"5480",2017-11-30 12:02:04,390499.52,33665354.47
"5481",2017-11-30 12:07:53,-390499.52,33274854.95
"5482",2017-11-30 12:57:46,766070.85,34040925.8
"5483",2017-11-30 13:26:28,-766070.85,33274854.95
"18855",2017-11-30 14:34:50,777858.57,34052713.52
"18856",2017-11-30 14:34:50,126931.58,34179645.1
"18857",2017-11-30 14:41:50,777858.59,34957503.69
"18858",2017-11-30 14:41:50,278444.6,35235948.29
"5484",2017-11-30 15:13:42,543445.73,35779394.02
"5485",2017-11-30 15:13:42,675035.48,36454429.5
"5486",2017-11-30 15:30:39,-1218481.21,35235948.29
"5487",2017-11-30 15:56:26,480947.36,35716895.65
"5488",2017-11-30 16:32:23,468519.35,36185415
"5489",2017-11-30 16:32:23,447538.43,36632953.43
"5490",2017-11-30 16:32:23,583892.45,37216845.88
"5491",2017-11-30 17:33:21,777858.67,37994704.55
"18859",2017-11-30 18:07:58,489821.58,38484526.13
"18860",2017-11-30 19:22:00,595862.03,39080388.16
"18861",2017-11-30 19:46:19,463577.26,39543965.42
"5492",2017-11-30 19:47:01,-480947.36,39063018.06
"5493",2017-11-30 19:58:32,-2277808.9,36785209.16
"18862",2017-11-30 20:17:12,888969.82,37674178.98
"18863",2017-11-30 20:31:06,777858.91,38452037.89
"5494",2017-11-30 20:39:38,777858.94,39229896.83
"5495",2017-11-30 20:39:38,334531.95,39564428.78
"5496",2017-11-30 20:39:38,580013.22,40144442
"18864",2017-11-30 20:39:38,392983.93,40537425.93
"18865",2017-11-30 20:39:38,777858.92,41315284.85
"5497",2017-11-30 21:10:17,888969.98,42204254.83
"5498",2017-11-30 21:10:17,-1692404.11,40511850.72
"18866",2017-11-30 21:10:17,733081.9,41244932.62
"5499",2017-11-30 21:30:54,-888969.98,40355962.64
"18867",2017-11-30 21:37:50,619899.35,40975861.99
"18868",2017-11-30 21:48:55,720999.24,41696861.23
"5500",2017-11-30 22:23:15,745209.08,42442070.31
"5501",2017-11-30 22:23:15,689149.44,43131219.75
"5502",2017-11-30 22:29:09,-1434358.52,41696861.23
"18869",2017-11-30 22:51:14,777859.03,42474720.26
"18870",2017-11-30 22:51:14,15557.04,42490277.3
"5503",2017-11-30 23:16:41,3158.07,42493435.37
"5504",2017-11-30 23:16:41,777859.06,43271294.43
"5505",2017-11-30 23:16:41,517700.31,43788994.74
"5506",2017-11-30 23:24:41,-1298717.44,42490277.3
"5507",2017-11-30 23:29:35,508170.06,42998447.36
"5508",2017-11-30 23:42:12,-508170.06,42490277.3
"18871",2017-12-01 00:38:39,520527.56,43010804.86
"18872",2017-12-01 01:44:44,776754.52,43787559.38
"5509",2017-12-01 02:44:07,582316.2,44369875.58
"5510",2017-12-01 02:50:29,-582316.2,43787559.38
"5511",2017-12-01 03:04:16,582828.22,44370387.6
"5512",2017-12-01 03:46:32,-582828.22,43787559.38
"5513",2017-12-01 04:27:06,598711.29,44386270.67
"5514",2017-12-01 04:47:00,26081.25,44412351.92
"5515",2017-12-01 04:47:00,-598711.29,43813640.63
"5516",2017-12-01 04:55:04,492325.55,44305966.18
"5517",2017-12-01 04:57:43,-26081.25,44279884.93
"5518",2017-12-01 05:10:46,-492325.55,43787559.38
"18873",2017-12-01 06:38:27,456252.01,44243811.39
"5519",2017-12-01 08:48:48,593274.71,44837086.1
"5520",2017-12-01 09:04:30,529676.94,45366763.04
"5521",2017-12-01 09:04:30,-593274.71,44773488.33
"5522",2017-12-01 09:30:23,-529676.94,44243811.39
"5523",2017-12-01 09:44:35,777859.21,45021670.6
"5524",2017-12-01 09:44:35,237010.22,45258680.82
"5525",2017-12-01 09:52:52,-1014869.43,44243811.39
"18874",2017-12-01 09:52:52,486055.11,44729866.5
"5526",2017-12-01 10:08:04,777859.24,45507725.74
"5527",2017-12-01 10:08:04,324118.25,45831843.99
"5528",2017-12-01 10:18:31,-1101977.49,44729866.5
"18875",2017-12-01 10:18:31,777859.26,45507725.76
"18876",2017-12-01 10:18:31,43198.27,45550924.03
"5529",2017-12-01 11:08:24,530885.3,46081809.33
"5530",2017-12-01 11:16:56,-530885.3,45550924.03
"5531",2017-12-01 12:23:29,777859.32,46328783.35
"5532",2017-12-01 12:23:29,629837.33,46958620.68
"18877",2017-12-01 12:23:29,777859.34,47736480.02
"18878",2017-12-01 12:23:29,777859.3,48514339.32
"18879",2017-12-01 12:23:29,217306.35,48731645.67
"5533",2017-12-01 12:32:23,-1407696.65,47323949.02
"5534",2017-12-01 12:33:05,777859.36,48101808.38
"5535",2017-12-01 12:34:17,194083.37,48295891.75
"5536",2017-12-01 12:50:24,-971942.73,47323949.02
"18880",2017-12-01 12:50:24,123989.39,47447938.41
"5537",2017-12-02 00:32:47,777861.15,48225799.56
"5538",2017-12-02 00:32:47,777861.17,49003660.73
"5539",2017-12-02 00:32:47,777861.16,49781521.89
"5540",2017-12-02 00:32:47,777861.14,50559383.03
"5541",2017-12-02 00:32:47,252653.18,50812036.21
"18881",2017-12-02 00:32:47,777861.11,51589897.32
"18882",2017-12-02 00:32:47,777861.09,52367758.41
"18883",2017-12-02 00:32:47,777861.12,53145619.53
"18884",2017-12-02 00:32:47,484454.13,53630073.66
"18885",2017-12-02 00:32:47,777861.1,54407934.76
"5542",2017-12-02 00:41:50,-3364097.8,51043836.96
"5543",2017-12-02 00:43:17,888972.2,51932809.16
"5544",2017-12-02 00:53:55,-888972.2,51043836.96
"18886",2017-12-02 00:58:35,618895.39,51662732.35
"18887",2017-12-02 00:58:35,24424.22,51687156.57
"18888",2017-12-02 00:58:35,777861.21,52465017.78
"18889",2017-12-02 01:07:16,1055874.59,53520892.37
"18890",2017-12-02 01:21:48,462997.94,53983890.31
"18891",2017-12-02 01:28:56,777861.25,54761751.56
"18892",2017-12-02 01:28:56,888972.26,55650723.82
"5545",2017-12-02 01:40:54,777861.28,56428585.1
"5546",2017-12-02 01:40:54,167487.29,56596072.39
"5547",2017-12-02 01:54:41,888972.31,57485044.7
"5548",2017-12-02 01:54:41,-945348.57,56539696.13
"5549",2017-12-02 02:45:05,-888972.31,55650723.82
"18893",2017-12-02 02:45:05,122837.34,55773561.16
"18894",2017-12-02 02:45:05,777861.33,56551422.49
"18895",2017-12-02 02:45:05,563728.64,57115151.13
"5550",2017-12-02 03:07:52,87126.36,57202277.49
"5551",2017-12-02 03:07:52,777861.35,57980138.84
"5552",2017-12-02 03:24:55,-864987.71,57115151.13
"18896",2017-12-02 06:25:45,888972.37,58004123.5
"5553",2017-12-02 06:56:14,777861.38,58781984.88
"5554",2017-12-02 07:12:02,138313.03,58920297.91
"5555",2017-12-02 07:12:02,-777861.38,58142436.53
"5556",2017-12-02 07:55:21,-138313.03,58004123.5
"18897",2017-12-02 07:55:21,888972.39,58893095.89
"18898",2017-12-02 07:55:21,-58004123.5,888972.389999993
"5557",2017-12-02 07:57:37,1493192.2,2382164.58999999
"18899",2017-12-02 08:05:33,-888972.39,1493192.19999999
"5558",2017-12-02 08:25:32,-1493192.2,-6.75208866596222e-09
"5559",2017-12-02 14:23:52,119319.49,119319.489999993
"5560",2017-12-02 14:23:52,777863.48,897182.969999993
"5561",2017-12-02 14:31:54,-897182.97,-6.75208866596222e-09
"18900",2017-12-02 16:06:24,511504.51,511504.509999993
"18901",2017-12-02 16:17:14,-511504.51,-6.75208866596222e-09
"18902",2017-12-02 16:57:43,541706.34,541706.339999993
"18903",2017-12-02 21:01:11,769799.73,1311506.06999999
"18904",2017-12-03 04:54:03,494673.99,1806180.05999999
"5562",2017-12-03 05:11:37,550584.88,2356764.93999999
"5563",2017-12-03 05:38:08,777863.68,3134628.61999999
"5564",2017-12-03 05:38:08,661712,3796340.61999999
"5565",2017-12-03 05:38:08,51717.69,3848058.30999999
"5566",2017-12-03 05:38:08,53611.23,3901669.53999999
"5567",2017-12-03 05:38:08,-550584.88,3351084.65999999
"5568",2017-12-03 05:52:55,-1544904.6,1806180.05999999
"18905",2017-12-03 06:01:37,686612.61,2492792.66999999
"5569",2017-12-03 06:48:05,741535.19,3234327.85999999
"5570",2017-12-03 07:06:15,-741535.19,2492792.66999999
"18906",2017-12-03 07:06:15,476573.88,2969366.54999999
"18907",2017-12-03 07:14:52,595791.86,3565158.40999999
"5571",2017-12-03 09:27:06,605839.4,4170997.80999999
"5572",2017-12-03 09:37:51,-605839.4,3565158.40999999
"18908",2017-12-03 11:16:56,100569.77,3665728.17999999
"18909",2017-12-03 11:16:56,777863.76,4443591.93999999
"5573",2017-12-03 11:22:51,397401.79,4840993.72999999
"5574",2017-12-03 11:22:51,777863.78,5618857.50999999
"5575",2017-12-03 11:30:23,448032.84,6066890.34999999
"5576",2017-12-03 11:30:23,777863.83,6844754.17999999
"18910",2017-12-03 11:30:23,777863.8,7622617.97999999
"18911",2017-12-03 11:30:23,774779.82,8397397.79999999
"18912",2017-12-03 11:30:23,777863.81,9175261.60999999
"18913",2017-12-03 11:32:10,494559.87,9669821.47999999
"18914",2017-12-03 11:32:10,777863.86,10447685.34
"5577",2017-12-03 11:33:32,-1175265.57,9272419.76999999
"5578",2017-12-03 11:47:09,777863.88,10050283.65
"5579",2017-12-03 11:47:09,117207.89,10167491.54
"5580",2017-12-03 11:47:09,-1225896.67,8941594.86999999
"5581",2017-12-03 12:04:15,777863.91,9719458.77999999
"5582",2017-12-03 12:04:15,777863.9,10497322.68
"5583",2017-12-03 12:04:15,509952.92,11007275.6
"5584",2017-12-03 12:04:15,-895071.77,10112203.83
"5585",2017-12-03 12:13:26,230670.99,10342874.82
"5586",2017-12-03 12:13:26,888975,11231849.82
"5587",2017-12-03 12:13:26,777863.98,12009713.8
"5588",2017-12-03 12:13:26,777863.97,12787577.77
"5589",2017-12-03 12:13:26,888975.01,13676552.78
"18915",2017-12-03 12:13:26,777863.94,14454416.72
"18916",2017-12-03 12:13:26,777863.93,15232280.65
"18917",2017-12-03 12:13:26,210312.95,15442593.6
"5590",2017-12-03 12:16:34,888975.02,16331568.62
"5591",2017-12-03 12:17:39,-5630029.68,10701538.94
"18918",2017-12-03 12:17:39,888975.03,11590513.97
"5592",2017-12-03 12:27:58,-888975.02,10701538.95
"18919",2017-12-03 18:53:35,777864.08,11479403.03
"18920",2017-12-03 18:53:35,256053.09,11735456.12
"18921",2017-12-03 20:18:03,777864.1,12513320.22
"18922",2017-12-03 20:18:03,122686.11,12636006.33
"18923",2017-12-03 22:37:17,51548.34,12687554.67
"18924",2017-12-04 05:19:30,635798.26,13323352.93
"18925",2017-12-04 20:33:34,502289.99,13825642.92
"5593",2017-12-04 20:54:20,493995.22,14319638.14
"5594",2017-12-04 20:54:20,300087.44,14619725.58
"18926",2017-12-04 20:54:20,768347.82,15388073.4
"5595",2017-12-04 21:00:51,772666.53,16160739.93
"5596",2017-12-04 21:19:34,-794082.66,15366657.27
"18927",2017-12-04 21:19:34,777864.66,16144521.93
"18928",2017-12-04 21:19:34,99100.67,16243622.6
"18929",2017-12-04 21:19:34,483540.6,16727163.2
"5597",2017-12-04 21:40:54,-772666.53,15954496.67
"18930",2017-12-04 23:11:20,777864.68,16732361.35
"18931",2017-12-04 23:11:20,160500.69,16892862.04
"5598",2017-12-04 23:20:53,485450.01,17378312.05
"5599",2017-12-04 23:36:49,-485450.01,16892862.04
"5600",2017-12-04 23:57:37,49315.72,16942177.76
"5601",2017-12-04 23:57:37,777864.71,17720042.47
"18932",2017-12-05 00:25:55,505105.67,18225148.14
"5602",2017-12-05 00:29:40,-827180.43,17397967.71
"18933",2017-12-05 06:56:50,810030.69,18207998.4
"18934",2017-12-05 07:51:03,777864.86,18985863.26
"18935",2017-12-05 07:51:03,7121.87,18992985.13
"18936",2017-12-05 08:33:31,623708.9,19616694.03
"18937",2017-12-05 08:33:31,777864.89,20394558.92
"18938",2017-12-05 10:49:45,777864.92,21172423.84
"18939",2017-12-05 10:49:45,422363.93,21594787.77
"18940",2017-12-05 12:43:13,646736.24,22241524.01
"5603",2017-12-06 02:16:01,308642.31,22550166.32
"5604",2017-12-06 02:30:42,503239.23,23053405.55
"5605",2017-12-06 02:30:42,-308642.31,22744763.24
"18941",2017-12-06 02:30:42,576327.1,23321090.34
"5606",2017-12-06 02:46:26,536872.77,23857963.11
"5607",2017-12-06 02:46:26,-503239.23,23354723.88
"5608",2017-12-06 03:24:02,-536872.77,22817851.11
"18942",2017-12-06 03:40:44,398954.6,23216805.71
"18943",2017-12-06 04:43:05,475552.32,23692358.03
"5609",2017-12-06 06:13:53,79872.61,23772230.64
"5610",2017-12-06 06:13:53,777865.6,24550096.24
"18944",2017-12-06 06:13:53,336451.99,24886548.23
"5611",2017-12-06 06:29:11,-857738.21,24028810.02
"18945",2017-12-06 09:19:44,-24028810.02,-3.72529029846191e-09
"18946",2017-12-06 10:14:59,655490.12,655490.119999996
"18947",2017-12-06 10:17:51,-655490.12,-3.72529029846191e-09
"18948",2017-12-06 10:52:46,1027320.5,1027320.5
"18949",2017-12-06 12:18:05,632880.25,1660200.75
"18950",2017-12-06 12:38:18,602835.07,2263035.82
"18951",2017-12-06 12:49:45,569176.4,2832212.22
"18952",2017-12-06 14:40:29,462940.58,3295152.8
"18953",2017-12-06 15:11:13,75822.77,3370975.57
"18954",2017-12-06 15:12:01,568153.27,3939128.84
"18955",2017-12-06 15:22:17,655103.77,4594232.61
"18956",2017-12-06 15:46:33,530958.72,5125191.33
"18957",2017-12-06 18:02:33,353871.58,5479062.91
"18958",2017-12-06 18:55:05,476259.86,5955322.77
"18959",2017-12-06 19:27:03,437139.17,6392461.94
"5612",2017-12-06 19:48:22,378500.22,6770962.16
"5613",2017-12-06 19:58:50,-378500.22,6392461.94
"5614",2017-12-06 20:20:20,465972.22,6858434.16
"5615",2017-12-06 20:36:40,529917.68,7388351.84
"5616",2017-12-06 20:36:40,-465972.22,6922379.62
"5617",2017-12-06 20:44:04,-529917.68,6392461.94
"18960",2017-12-06 21:40:57,402190.13,6794652.07
"18961",2017-12-06 22:52:53,217172.64,7011824.71
"18962",2017-12-06 23:10:58,309355.11,7321179.82
"18963",2017-12-06 23:10:58,629769.5,7950949.32
"5618",2017-12-06 23:44:26,681262.04,8632211.36
"18964",2017-12-06 23:44:26,300958.14,8933169.5
"5619",2017-12-06 23:57:21,-681262.04,8251907.46
"5620",2017-12-07 00:57:42,665715.33,8917622.79
"18965",2017-12-07 00:57:42,352794.56,9270417.35
"5621",2017-12-07 01:03:08,-665715.33,8604702.02
"18966",2017-12-07 01:18:49,513388.33,9118090.35
"18967",2017-12-07 01:34:24,484259.69,9602350.04
"18968",2017-12-07 01:56:13,360274.64,9962624.68
"18969",2017-12-07 02:16:27,377704.6,10340329.28
"18970",2017-12-07 02:36:47,652856.55,10993185.83
"18971",2017-12-07 02:53:19,426062.12,11419247.95
"18972",2017-12-07 02:53:19,336847.54,11756095.49
"18973",2017-12-07 03:05:45,314343.01,12070438.5
"18974",2017-12-07 03:29:21,724091.61,12794530.11
"18975",2017-12-07 03:46:55,450218.82,13244748.93
"5622",2017-12-07 04:28:57,587825.86,13832574.79
"5623",2017-12-07 04:52:46,-587825.86,13244748.93
"18976",2017-12-07 04:59:54,514409.61,13759158.54
"18977",2017-12-07 05:03:44,607221.75,14366380.29
"18978",2017-12-07 07:38:00,338832.23,14705212.52
"18979",2017-12-07 08:06:15,335334.85,15040547.37
"18980",2017-12-07 08:06:15,360739.39,15401286.76
"18981",2017-12-07 08:21:24,438294.39,15839581.15
"18982",2017-12-07 08:21:24,287135.58,16126716.73
"18983",2017-12-07 10:14:44,371130,16497846.73
"18984",2017-12-07 13:41:02,808062.17,17305908.9
"5624",2017-12-07 15:25:40,314163.26,17620072.16
"5625",2017-12-07 15:34:59,-314163.26,17305908.9
"18985",2017-12-07 17:11:01,336164.67,17642073.57
"18986",2017-12-07 17:19:38,274354.04,17916427.61
"18987",2017-12-07 17:19:38,508308.7,18424736.31
"18988",2017-12-07 18:17:34,777865.9,19202602.21
"18989",2017-12-07 18:26:45,600581.99,19803184.2
"18990",2017-12-07 18:59:17,777865.98,20581050.18
"18991",2017-12-07 18:59:17,396488.99,20977539.17
"18992",2017-12-07 21:35:23,888977,21866516.17
"18993",2017-12-07 21:35:23,888977.02,22755493.19
"18994",2017-12-07 21:35:23,888977.01,23644470.2
"5626",2017-12-08 00:31:58,3e+06,26644470.2
"18995",2017-12-08 03:35:00,777866.03,27422336.23
"18996",2017-12-08 03:35:00,68769.04,27491105.27
"18997",2017-12-08 03:57:54,777866.06,28268971.33
"18998",2017-12-08 03:57:54,777219.07,29046190.4
"18999",2017-12-08 03:57:54,777866.05,29824056.45
"19000",2017-12-08 05:02:23,777866.1,30601922.55
"19001",2017-12-08 05:02:23,777866.09,31379788.64
"19002",2017-12-08 05:02:23,22252.11,31402040.75
"19003",2017-12-08 05:03:43,777866.08,32179906.83
"5627",2017-12-08 07:44:27,1999998,34179904.83
"19004",2017-12-08 07:44:27,777866.14,34957770.97
"19005",2017-12-08 07:44:27,91874.15,35049645.12
"19006",2017-12-08 07:44:27,777866.13,35827511.25
"19007",2017-12-08 07:44:27,777866.12,36605377.37
"5628",2017-12-08 17:39:13,-4999998,31605379.37
"5629",2017-12-08 18:33:01,753905.59,32359284.96
"5630",2017-12-08 18:33:01,499026.77,32858311.73
"5631",2017-12-08 18:54:17,-1252932.36,31605379.37
"5632",2017-12-08 19:28:07,24450.24,31629829.61
"5633",2017-12-08 19:28:07,777866.23,32407695.84
"19008",2017-12-08 19:33:42,523543.27,32931239.11
"5634",2017-12-08 20:21:24,-802316.47,32128922.64
"19009",2017-12-08 21:14:34,523743.35,32652665.99
"5635",2017-12-08 21:46:31,734625.37,33387291.36
"5636",2017-12-08 21:49:14,708864.84,34096156.2
"5637",2017-12-08 21:59:42,-734625.37,33361530.83
"5638",2017-12-08 22:24:44,-708864.84,32652665.99
"19010",2017-12-08 23:55:00,771420.4,33424086.39
"5639",2017-12-09 00:12:41,737085.49,34161171.88
"5640",2017-12-09 00:23:56,-737085.49,33424086.39
"5641",2017-12-09 00:32:37,543295.02,33967381.41
"19011",2017-12-09 00:32:37,777866.35,34745247.76
"19012",2017-12-09 00:32:37,381919.36,35127167.12
"5642",2017-12-09 00:43:49,-543295.02,34583872.1
"19013",2017-12-09 02:16:55,7806.42,34591678.52
"19014",2017-12-09 02:16:55,777866.41,35369544.93
"19015",2017-12-09 02:32:38,763347.72,36132892.65
"5643",2017-12-09 02:51:31,831433.02,36964325.67
"5644",2017-12-09 03:01:11,679156.2,37643481.87
"5645",2017-12-09 03:01:11,-831433.02,36812048.85
"5646",2017-12-09 03:06:46,519136.88,37331185.73
"5647",2017-12-09 03:18:39,596475.07,37927660.8
"5648",2017-12-09 03:18:39,-679156.2,37248504.6
"5649",2017-12-09 03:43:09,-1115611.95,36132892.65
"19016",2017-12-09 03:43:09,625224.17,36758116.82
"19017",2017-12-09 05:25:34,540531.3,37298648.12
"19018",2017-12-09 06:07:24,649533.01,37948181.13
"19019",2017-12-09 06:07:24,733326.11,38681507.24
"19020",2017-12-09 07:03:05,548147.41,39229654.65
"19021",2017-12-09 07:06:21,777866.55,40007521.2
"19022",2017-12-09 07:06:21,16011.56,40023532.76
"19023",2017-12-09 08:30:40,893164.26,40916697.02
"19024",2017-12-09 09:30:15,545984.65,41462681.67
"19025",2017-12-09 09:30:15,777866.64,42240548.31
"19026",2017-12-09 09:30:15,777866.63,43018414.94
"19027",2017-12-09 09:52:55,777866.66,43796281.6
"19028",2017-12-09 09:52:55,777866.67,44574148.27
"19029",2017-12-09 09:52:55,23673.68,44597821.95
"5650",2017-12-09 10:09:54,888977.7,45486799.65
"5651",2017-12-09 10:21:24,-888977.7,44597821.95
"5652",2017-12-09 11:29:25,300084.61,44897906.56
"5653",2017-12-09 11:29:25,300084.69,45197991.25
"5654",2017-12-09 11:40:03,-600169.3,44597821.95
"19030",2017-12-09 12:46:47,497139.74,45094961.69
"19031",2017-12-09 13:20:45,777866.73,45872828.42
"19032",2017-12-09 13:55:28,18346.84,45891175.26
"5655",2017-12-09 14:36:42,777866.76,46669042.02
"5656",2017-12-09 14:36:42,54640.77,46723682.79
"19033",2017-12-09 14:36:42,734473.5,47458156.29
"5657",2017-12-09 14:50:06,-832507.53,46625648.76
"5658",2017-12-09 17:13:12,638930.85,47264579.61
"5659",2017-12-09 17:13:12,777866.84,48042446.45
"5660",2017-12-09 17:27:40,-1416797.69,46625648.76
"19034",2017-12-09 17:27:40,388977.88,47014626.64
"5661",2017-12-09 17:32:17,777866.9,47792493.54
"5662",2017-12-09 17:32:17,169612.91,47962106.45
"19035",2017-12-09 17:37:35,777866.92,48739973.37
"5663",2017-12-09 17:54:21,724162.38,49464135.75
"5664",2017-12-09 17:54:21,-947479.81,48516655.94
"19036",2017-12-09 17:54:21,777866.93,49294522.87
"5665",2017-12-09 18:05:48,682313.96,49976836.83
"5666",2017-12-09 18:05:48,777866.95,50754703.78
"5667",2017-12-09 18:05:48,-724162.38,50030541.4
"5668",2017-12-09 18:19:21,123775.98,50154317.38
"5669",2017-12-09 18:19:21,777866.97,50932184.35
"5670",2017-12-09 18:19:21,-1460180.91,49472003.44
"19037",2017-12-09 18:19:21,777866.99,50249870.43
"5671",2017-12-09 18:29:23,-901642.95,49348227.48
"5672",2017-12-09 19:23:59,720871.21,50069098.69
"5673",2017-12-09 19:45:47,687949.05,50757047.74
"5674",2017-12-09 19:45:47,-720871.21,50036176.53
"5675",2017-12-09 19:56:13,-687949.05,49348227.48
"19038",2017-12-09 20:25:08,888978.07,50237205.55
"19039",2017-12-09 20:25:08,888978.05,51126183.6
"5676",2017-12-09 22:54:15,587735.61,51713919.21
"5677",2017-12-09 23:01:34,-587735.61,51126183.6
"19040",2017-12-09 23:01:34,888978.09,52015161.69
"19041",2017-12-09 23:05:02,463567.48,52478729.17
"19042",2017-12-09 23:08:20,685263.28,53163992.45
"5678",2017-12-10 00:57:09,573036.89,53737029.34
"5679",2017-12-10 01:23:57,-573036.89,53163992.45
"5680",2017-12-10 01:41:58,461205.29,53625197.74
"5681",2017-12-10 01:48:33,-461205.29,53163992.45
"5682",2017-12-10 01:59:09,777867.18,53941859.63
"5683",2017-12-10 01:59:09,52482.19,53994341.82
"5684",2017-12-10 02:16:31,776890.37,54771232.19
"5685",2017-12-10 02:16:31,-830349.37,53940882.82
"5686",2017-12-10 02:36:28,534967.36,54475850.18
"5687",2017-12-10 02:36:28,-776890.37,53698959.81
"5688",2017-12-10 02:55:00,-534967.36,53163992.45
"5689",2017-12-10 03:58:10,378984.71,53542977.16
"5690",2017-12-10 04:10:53,-378984.71,53163992.45
"5691",2017-12-10 04:49:07,132622.74,53296615.19
"5692",2017-12-10 04:49:07,167048.79,53463663.98
"5693",2017-12-10 04:49:07,223735.84,53687399.82
"5694",2017-12-10 04:49:07,226490.49,53913890.31
"5695",2017-12-10 05:14:33,-749897.86,53163992.45
"19043",2017-12-10 05:17:31,-53163992.45,-7.45058059692383e-09
"5696",2017-12-10 05:32:33,1580238.2,1580238.19999999
"5697",2017-12-10 05:46:31,-1580238.2,-7.45058059692383e-09
"19044",2017-12-10 05:52:07,79279.32,79279.3199999926
"19045",2017-12-10 05:52:07,777867.31,857146.629999993
"19046",2017-12-10 06:01:51,-857146.63,-7.33416527509689e-09
"5698",2017-12-10 06:23:19,767045.86,767045.859999993
"5699",2017-12-10 06:34:21,-767045.86,-7.33416527509689e-09
"19047",2017-12-10 06:57:37,419216.88,419216.879999993
"19048",2017-12-10 07:08:29,-419216.88,-7.33416527509689e-09
"19049",2017-12-10 08:19:52,564580.84,564580.839999993
"19050",2017-12-10 08:41:45,777867.38,1342448.21999999
"19051",2017-12-10 08:41:45,128747.39,1471195.60999999
"5700",2017-12-10 09:30:27,595589.06,2066784.66999999
"5701",2017-12-10 09:40:00,-595589.06,1471195.60999999
"19052",2017-12-10 09:48:54,777867.41,2249063.01999999
"19053",2017-12-10 09:48:54,219769.42,2468832.43999999
"5702",2017-12-10 09:58:36,28209.67,2497042.10999999
"5703",2017-12-10 10:12:21,-28209.67,2468832.43999999
"19054",2017-12-10 10:12:21,133828.45,2602660.88999999
"19055",2017-12-10 10:12:21,777867.44,3380528.32999999
"5704",2017-12-10 10:51:03,618310.58,3998838.90999999
"5705",2017-12-10 11:07:01,-618310.58,3380528.32999999
"19056",2017-12-10 14:05:38,777867.49,4158395.81999999
"5706",2017-12-10 14:13:49,84482.72,4242878.53999999
"19057",2017-12-10 14:13:49,41415.5,4284294.03999999
"5707",2017-12-10 14:33:48,15306.57,4299600.60999999
"5708",2017-12-10 14:33:48,777867.56,5077468.16999999
"5709",2017-12-10 14:33:48,-84482.72,4992985.44999999
"19058",2017-12-10 14:33:48,722611.55,5715596.99999999
"19059",2017-12-10 14:33:48,777867.54,6493464.53999999
"19060",2017-12-10 14:33:48,777867.58,7271332.11999999
"19061",2017-12-10 14:33:48,179044.59,7450376.70999999
"5710",2017-12-10 14:42:24,530646.34,7981023.04999999
"5711",2017-12-10 14:42:24,-793174.13,7187848.91999999
"5712",2017-12-10 14:59:36,499418.62,7687267.53999999
"5713",2017-12-10 14:59:36,777867.61,8465135.14999999
"5714",2017-12-10 14:59:36,-530646.34,7934488.80999999
"19062",2017-12-10 14:59:36,746030.51,8680519.31999999
"5715",2017-12-10 15:15:51,-1277286.23,7403233.08999999
"5716",2017-12-10 15:18:48,777867.64,8181100.72999999
"5717",2017-12-10 15:21:55,182909.65,8364010.37999999
"19063",2017-12-10 15:23:29,777867.67,9141878.04999999
"5718",2017-12-10 15:53:21,193478.7,9335356.74999999
"5719",2017-12-10 15:53:21,-960777.29,8374579.45999999
"5720",2017-12-10 16:07:50,777867.69,9152447.14999999
"5721",2017-12-10 16:07:50,-193478.7,8958968.44999999
"5722",2017-12-10 16:21:03,-777867.69,8181100.75999999
"19064",2017-12-10 17:37:44,183069.68,8364170.43999999
"5723",2017-12-10 19:11:26,693776.86,9057947.29999999
"5724",2017-12-10 19:27:08,-693776.86,8364170.43999999
"19065",2017-12-11 02:43:39,300090.81,8664261.24999999
"19066",2017-12-11 03:42:42,777867.82,9442129.06999999
"19067",2017-12-11 03:42:42,777867.84,10219996.91
"19068",2017-12-11 03:42:42,777867.83,10997864.74
"19069",2017-12-11 03:51:10,260464.85,11258329.59
"19070",2017-12-11 07:31:33,-11258329.59,-7.45058059692383e-09
"5725",2017-12-11 09:58:58,777868.24,777868.239999993
"5726",2017-12-11 09:58:58,777868.25,1555736.48999999
"5727",2017-12-11 09:58:58,777868.26,2333604.74999999
"19071",2017-12-11 09:58:58,777868.21,3111472.95999999
"19072",2017-12-11 09:58:58,777868.22,3889341.17999999
"19073",2017-12-11 09:58:58,777868.19,4667209.36999999
"19074",2017-12-11 10:00:39,777868.2,5445077.56999999
"5728",2017-12-11 10:04:15,504255.27,5949332.83999999
"19075",2017-12-11 10:04:15,165191.23,6114524.06999999
"5729",2017-12-11 10:14:55,-2333604.75,3780919.31999999
"19076",2017-12-11 10:14:55,777868.28,4558787.59999999
"5730",2017-12-11 10:56:10,-504255.27,4054532.32999999
"5731",2017-12-11 11:02:32,32605.84,4087138.16999999
"5732",2017-12-11 11:38:24,-32605.84,4054532.32999999
"19077",2017-12-11 12:37:41,104484.33,4159016.65999999
"19078",2017-12-11 12:37:41,777868.32,4936884.97999999
"19079",2017-12-11 13:49:02,722143.1,5659028.07999999
"19080",2017-12-11 14:34:37,664066.98,6323095.05999999
"19081",2017-12-11 14:46:09,634602.04,6957697.09999999
"19082",2017-12-11 15:31:45,335181.38,7292878.47999999
"19083",2017-12-11 15:31:45,777868.37,8070746.84999999
"19084",2017-12-11 15:31:45,777868.39,8848615.23999999
"19085",2017-12-11 15:31:45,192765.4,9041380.63999999
"5733",2017-12-11 16:04:31,688240.14,9729620.77999999
"5734",2017-12-11 16:12:59,777868.42,10507489.2
"5735",2017-12-11 16:12:59,414827.43,10922316.63
"5736",2017-12-11 16:12:59,-688240.14,10234076.49
"5737",2017-12-11 16:25:29,-1192695.85,9041380.63999999
"19086",2017-12-11 16:59:05,729300.41,9770681.04999999
"19087",2017-12-11 20:23:45,944008.47,10714689.52
"19088",2017-12-11 20:23:45,849428.15,11564117.67
"5738",2017-12-11 20:43:00,27704.31,11591821.98
"5739",2017-12-11 20:43:00,580655.62,12172477.6
"5740",2017-12-11 20:43:00,121529.07,12294006.67
"5741",2017-12-11 20:56:00,-729889,11564117.67
"5742",2017-12-11 21:11:24,461068.68,12025186.35
"19089",2017-12-11 21:11:24,32590.93,12057777.28
"5743",2017-12-11 21:27:03,-461068.68,11596708.6
"19090",2017-12-11 21:30:22,7269.49,11603978.09
"19091",2017-12-11 21:45:12,61352.94,11665331.03
"19092",2017-12-11 21:45:12,149530,11814861.03
"19093",2017-12-11 21:45:12,7800.51,11822661.54
"19094",2017-12-11 21:59:36,240011.62,12062673.16
"19095",2017-12-11 22:45:27,164050.35,12226723.51
"5744",2017-12-11 23:57:47,3183.35,12229906.86
"19096",2017-12-11 23:57:47,5882.92,12235789.78
"19097",2017-12-11 23:57:47,1786.96,12237576.74
"5745",2017-12-12 00:17:53,-3183.35,12234393.39
"19098",2017-12-12 01:52:17,1033.92,12235427.31
"19099",2017-12-12 02:16:57,31335.89,12266763.2
"19100",2017-12-12 02:29:24,25095.1,12291858.3
"19101",2017-12-12 03:27:22,20101.24,12311959.54
"5746",2017-12-12 03:35:06,860.33,12312819.87
"5747",2017-12-12 04:00:41,-860.33,12311959.54
"19102",2017-12-12 04:05:14,17681.76,12329641.3
"19103",2017-12-12 04:05:14,744.75,12330386.05
"19104",2017-12-12 05:24:47,29030.13,12359416.18
"5748",2017-12-12 06:45:47,19460.56,12378876.74
"5749",2017-12-12 07:12:12,-19460.56,12359416.18
"19105",2017-12-12 07:28:46,155227.34,12514643.52
"19106",2017-12-12 09:41:35,2762.29,12517405.81
"19107",2017-12-12 12:26:09,19264.59,12536670.4
"19108",2017-12-12 12:26:09,16984.69,12553655.09
"19109",2017-12-12 12:33:34,2182.77,12555837.86
"19110",2017-12-12 13:13:10,830.43,12556668.29
"19111",2017-12-12 13:24:28,17380.19,12574048.48
"19112",2017-12-12 14:26:35,25204.65,12599253.13
"5750",2017-12-12 15:43:57,26988.64,12626241.77
"5751",2017-12-12 15:43:57,18699.39,12644941.16
"5752",2017-12-12 16:30:15,12355.44,12657296.6
"5753",2017-12-12 17:24:29,-45688.03,12611608.57
"5754",2017-12-12 17:26:56,11968.26,12623576.83
"5755",2017-12-12 17:26:56,5118.98,12628695.81
"19113",2017-12-12 17:59:37,11033.87,12639729.68
"5756",2017-12-12 18:17:55,-29442.68,12610287
"19114",2017-12-12 18:43:00,24697.88,12634984.88
"5757",2017-12-12 19:06:09,841.71,12635826.59
"5758",2017-12-12 20:00:43,-841.71,12634984.88
"5759",2017-12-12 21:44:37,14469.83,12649454.71
"5760",2017-12-12 22:01:24,-14469.83,12634984.88
"19115",2017-12-12 22:22:31,15626.51,12650611.39
"19116",2017-12-13 00:20:16,24254.65,12674866.04
"19117",2017-12-13 00:20:16,9629.47,12684495.51
"19118",2017-12-13 01:08:29,3473.44,12687968.95
"19119",2017-12-13 01:08:29,987.48,12688956.43
"5761",2017-12-13 01:45:36,1777869.78,14466826.21
"5762",2017-12-13 02:18:14,777869.82,15244696.03
"5763",2017-12-13 02:18:14,-1777869.78,13466826.25
"19120",2017-12-13 02:18:14,777869.83,14244696.08
"19121",2017-12-13 02:18:14,777868.46,15022564.54
"19122",2017-12-13 02:18:14,777869.77,15800434.31
"19123",2017-12-13 02:18:14,690391.5,16490825.81
"19124",2017-12-13 02:18:14,220826.47,16711652.28
"19125",2017-12-13 02:18:14,23730.49,16735382.77
"19126",2017-12-13 02:18:14,888980.81,17624363.58
"19127",2017-12-13 02:18:14,777868.48,18402232.06
"19128",2017-12-13 02:18:14,2578.3,18404810.36
"19129",2017-12-13 02:18:14,1657.21,18406467.57
"19130",2017-12-13 02:18:14,3936.2,18410403.77
"5764",2017-12-13 03:12:42,-777869.82,17632533.95
"19131",2017-12-13 07:00:55,77870.7,17710404.65
"19132",2017-12-13 07:17:36,1073.55,17711478.2
"19133",2017-12-13 07:25:46,-17711478.2,-3.72529029846191e-09
"5765",2017-12-13 07:58:35,16397.56,16397.5599999963
"19134",2017-12-13 15:06:17,77872.42,94269.9799999963
"19135",2017-12-13 16:46:41,777872.61,872142.589999996
"19136",2017-12-13 16:46:41,777872.59,1650015.18
"19137",2017-12-13 16:46:41,777872.62,2427887.8
"19138",2017-12-13 16:46:41,777872.63,3205760.43
"19139",2017-12-13 16:58:16,53037.64,3258798.07
"19140",2017-12-13 16:58:16,777872.6,4036670.67
"19141",2017-12-13 17:13:05,47919.72,4084590.39
"19142",2017-12-13 17:13:05,777872.69,4862463.08
"19143",2017-12-13 17:13:05,777872.68,5640335.76
"19144",2017-12-13 17:13:05,777872.71,6418208.47
"19145",2017-12-13 17:13:05,777872.67,7196081.14
"19146",2017-12-13 17:13:05,777872.7,7973953.84
"19147",2017-12-13 17:37:02,777872.74,8751826.58
"5766",2017-12-13 18:01:54,888983.78,9640810.36
"19148",2017-12-13 18:01:54,888983.75,10529794.11
"19149",2017-12-13 18:01:54,888983.76,11418777.87
"19150",2017-12-13 18:01:54,888983.77,12307761.64
"5767",2017-12-13 18:12:26,-16397.56,12291364.08
"5768",2017-12-13 18:45:09,-888983.78,11402380.3
"5769",2017-12-13 19:15:38,60842.74,11463223.04
"19151",2017-12-13 19:15:38,247131.3,11710354.34
"5770",2017-12-13 19:46:53,-60842.74,11649511.6
"19152",2017-12-13 20:09:30,11181.94,11660693.54
"19153",2017-12-13 20:10:58,15781.68,11676475.22
"5771",2017-12-13 20:21:26,8492.73,11684967.95
"19154",2017-12-13 20:21:26,15835.18,11700803.13
"5772",2017-12-13 20:50:48,-8492.73,11692310.4
"5773",2017-12-13 20:50:48,1236.17,11693546.57
"5774",2017-12-13 21:01:02,-1236.17,11692310.4
"19155",2017-12-13 21:01:02,7754.25,11700064.65
"5775",2017-12-13 21:22:41,7535.99,11707600.64
"5776",2017-12-13 21:25:39,888983.79,12596584.43
"5777",2017-12-13 21:25:39,888983.8,13485568.23
"5778",2017-12-13 21:32:24,777872.82,14263441.05
"19156",2017-12-13 21:32:24,777872.81,15041313.86
"5779",2017-12-13 21:37:19,-1785503.58,13255810.28
"5780",2017-12-13 22:02:22,-777872.82,12477937.46
"5781",2017-12-13 22:02:22,43639.69,12521577.15
"19157",2017-12-13 22:02:22,777873.33,13299450.48
"5782",2017-12-13 22:12:55,888984.39,14188434.87
"5783",2017-12-13 22:12:55,888984.35,15077419.22
"5784",2017-12-13 22:12:55,777873.34,15855292.56
"19158",2017-12-13 22:12:55,888984.41,16744276.97
"5785",2017-12-13 22:24:26,888984.37,17633261.34
"5786",2017-12-13 22:24:26,-2599481.77,15033779.57
"19159",2017-12-13 22:24:26,888984.36,15922763.93
"19160",2017-12-13 22:24:26,246540.43,16169304.36
"19161",2017-12-13 22:24:26,777873.42,16947177.78
"19162",2017-12-13 22:24:26,888984.38,17836162.16
"19163",2017-12-13 22:24:26,777873.4,18614035.56
"5787",2017-12-13 22:34:57,-888984.37,17725051.19
"19164",2017-12-13 23:17:42,888984.6,18614035.79
"5788",2017-12-13 23:55:16,88984.88,18703020.67
"19165",2017-12-13 23:55:16,88984.87,18792005.54
"5789",2017-12-14 00:09:55,-88984.88,18703020.66
"19166",2017-12-14 00:17:34,173207.96,18876228.62
"5790",2017-12-14 00:31:34,39384.97,18915613.59
"5791",2017-12-14 00:48:08,88985.17,19004598.76
"5792",2017-12-14 00:48:08,-39384.97,18965213.79
"5793",2017-12-14 00:48:08,10038.16,18975251.95
"5794",2017-12-14 00:48:08,4491.1,18979743.05
"19167",2017-12-14 00:48:08,88985.16,19068728.21
"19168",2017-12-14 00:52:56,88985.25,19157713.46
"5795",2017-12-14 01:07:29,-103514.43,19054199.03
"19169",2017-12-14 01:52:06,4634.19,19058833.22
"19170",2017-12-14 02:13:58,2087.96,19060921.18
"5796",2017-12-14 02:54:54,1349.26,19062270.44
"5797",2017-12-14 03:25:17,-1349.26,19060921.18
"19171",2017-12-14 04:49:06,16094.91,19077016.09
"19172",2017-12-14 05:30:54,5772.29,19082788.38
"19173",2017-12-14 05:55:39,8569.28,19091357.66
"19174",2017-12-14 06:10:30,1130.84,19092488.5
"19175",2017-12-14 08:11:40,582.08,19093070.58
"19176",2017-12-14 08:22:58,11546.52,19104617.1
"19177",2017-12-14 09:17:34,2811.24,19107428.34
"19178",2017-12-14 09:17:34,4853.95,19112282.29
"19179",2017-12-14 09:17:34,3965.39,19116247.68
"19180",2017-12-14 09:19:47,2280.21,19118527.89
"19181",2017-12-14 09:19:47,1482.84,19120010.73
"19182",2017-12-14 09:33:18,9901.86,19129912.59
"19183",2017-12-14 09:45:20,4483.14,19134395.73
"19184",2017-12-14 09:55:05,1323.27,19135719
"19185",2017-12-14 10:17:25,947.52,19136666.52
"5798",2017-12-14 10:28:24,653.71,19137320.23
"5799",2017-12-14 10:36:43,11710.02,19149030.25
"5800",2017-12-14 10:36:43,403.93,19149434.18
"19186",2017-12-14 10:36:43,1365.24,19150799.42
"19187",2017-12-14 10:36:43,1745.3,19152544.72
"19188",2017-12-14 10:36:43,309.83,19152854.55
"19189",2017-12-14 10:36:43,411.53,19153266.08
"5801",2017-12-14 10:55:27,777873.46,19931139.54
"5802",2017-12-14 10:55:27,888986.7,20820126.24
"5803",2017-12-14 10:55:27,777873.45,21597999.69
"5804",2017-12-14 10:55:27,639141.47,22237141.16
"19190",2017-12-14 10:55:27,888986.69,23126127.85
"5805",2017-12-14 11:14:20,888986.72,24015114.57
"5806",2017-12-14 11:14:20,888986.76,24904101.33
"5807",2017-12-14 11:14:20,888986.74,25793088.07
"19191",2017-12-14 11:14:20,888986.75,26682074.82
"19192",2017-12-14 11:14:20,888986.71,27571061.53
"19193",2017-12-14 11:14:20,888986.73,28460048.26
"5808",2017-12-14 12:10:21,777875.8,29237924.06
"5809",2017-12-14 12:10:21,406790.82,29644714.88
"5810",2017-12-14 12:10:21,777875.81,30422590.69
"19194",2017-12-14 12:10:21,637797.89,31060388.58
"19195",2017-12-14 12:10:21,777875.78,31838264.36
"19196",2017-12-14 12:10:21,634620.79,32472885.15
"5811",2017-12-14 12:17:17,-12767.66,32460117.49
"5812",2017-12-14 12:44:01,-7713377.73,24746739.76
"5813",2017-12-14 13:15:22,408320.62,25155060.38
"19197",2017-12-14 13:15:22,859205.2,26014265.58
"19198",2017-12-14 13:15:22,1192716.32,27206981.9
"5814",2017-12-14 13:17:57,777875.89,27984857.79
"5815",2017-12-14 13:21:11,521377.9,28506235.69
"5816",2017-12-14 13:42:08,888986.94,29395222.63
"5817",2017-12-14 13:42:08,888986.93,30284209.56
"5818",2017-12-14 13:48:33,-1186196.51,29098013.05
"19199",2017-12-14 14:05:49,665711.06,29763724.11
"5819",2017-12-14 14:39:49,-2299351.77,27464372.34
"5820",2017-12-14 16:07:16,777875.98,28242248.32
"19200",2017-12-14 18:14:04,118659.74,28360908.06
"19201",2017-12-14 18:14:04,97029.19,28457937.25
"19202",2017-12-14 18:14:04,43665.5,28501602.75
"19203",2017-12-14 18:19:47,777876.08,29279478.83
"5821",2017-12-14 18:20:58,888987.09,30168465.92
"5822",2017-12-14 18:24:58,888987.12,31057453.04
"19204",2017-12-14 18:24:58,777876.11,31835329.15
"19205",2017-12-14 18:24:58,300090.34,32135419.49
"5823",2017-12-14 18:43:11,777876.13,32913295.62
"5824",2017-12-14 18:43:11,-777875.98,32135419.64
"19206",2017-12-14 18:43:11,487854.95,32623274.59
"5825",2017-12-14 18:46:20,114579.14,32737853.73
"19207",2017-12-14 19:00:50,286139.18,33023992.91
"19208",2017-12-14 19:00:50,777876.17,33801869.08
"5826",2017-12-14 19:15:04,34550.24,33836419.32
"5827",2017-12-14 19:15:04,777876.23,34614295.55
"5828",2017-12-14 19:15:04,222093.21,34836388.76
"5829",2017-12-14 19:15:04,777876.2,35614264.96
"19209",2017-12-14 19:15:04,754944.59,36369209.55
"5830",2017-12-14 19:18:05,777876.25,37147085.8
"5831",2017-12-14 19:18:05,-2670429.48,34476656.32
"5832",2017-12-14 19:48:32,777876.27,35254532.59
"5833",2017-12-14 19:48:32,303088.28,35557620.87
"5834",2017-12-14 19:48:32,-2590272.13,32967348.74
"19210",2017-12-14 19:56:10,630809.83,33598158.57
"5835",2017-12-14 19:59:00,-1080964.55,32517194.02
"19211",2017-12-14 20:08:41,763771.22,33280965.24
"19212",2017-12-14 20:16:05,734030.85,34014996.09
"19213",2017-12-14 20:16:05,-33280965.24,734030.850000005
"19214",2017-12-14 20:30:50,-734030.85,5.23868948221207e-09
"19215",2017-12-14 21:45:18,477622.69,477622.690000005
"5836",2017-12-14 21:57:41,777876.37,1255499.06000001
"5837",2017-12-14 22:26:39,777876.35,2033375.41000001
"5838",2017-12-14 22:26:39,777876.39,2811251.80000001
"5839",2017-12-14 22:26:39,777876.36,3589128.16000001
"5840",2017-12-14 22:26:39,640182.38,4229310.54000001
"5841",2017-12-14 22:26:39,-777876.37,3451434.17000001
"19216",2017-12-14 22:32:28,821230.68,4272664.85000001
"5842",2017-12-14 22:47:29,300099.43,4572764.28
"5843",2017-12-14 22:50:08,-2973811.48,1598952.8
"5844",2017-12-14 23:00:44,-300099.43,1298853.37000001
"19217",2017-12-14 23:05:13,-477622.69,821230.680000005
"19218",2017-12-14 23:05:13,-477622.69,343607.990000005
"19219",2017-12-14 23:05:13,27560.57,371168.560000005
"5845",2017-12-14 23:30:07,32817,403985.560000005
"19220",2017-12-14 23:30:07,34400.68,438386.240000005
"19221",2017-12-14 23:30:07,-371168.56,67217.6800000051
"19222",2017-12-14 23:48:50,765528.63,832746.310000005
"19223",2017-12-14 23:48:50,777876.62,1610622.93000001
"19224",2017-12-14 23:48:50,777876.61,2388499.54000001
"5846",2017-12-15 00:01:45,-32817,2355682.54000001
"5847",2017-12-15 00:21:52,590496.65,2946179.19000001
"5848",2017-12-15 00:21:52,777876.64,3724055.83000001
"5849",2017-12-15 00:29:23,593122.57,4317178.40000001
"19225",2017-12-15 00:29:23,412465.67,4729644.07
"19226",2017-12-15 00:29:23,777876.66,5507520.73000001
"5850",2017-12-15 00:50:30,389769.7,5897290.43000001
"5851",2017-12-15 00:50:30,777876.69,6675167.12
"5852",2017-12-15 00:50:30,-1961495.86,4713671.26
"5853",2017-12-15 00:50:53,1072773.64,5786444.9
"5854",2017-12-15 01:33:55,-2240420.03,3546024.87
"5855",2017-12-15 03:39:43,1169344.07,4715368.94
"5856",2017-12-15 04:11:11,388481.79,5103850.73
"5857",2017-12-15 04:11:11,777876.78,5881727.51
"19227",2017-12-15 04:12:49,-3546024.87,2335702.64
"5858",2017-12-15 04:44:22,209789.81,2545492.45
"5859",2017-12-15 04:44:22,777876.8,3323369.25
"5860",2017-12-15 04:57:24,777876.83,4101246.08
"5861",2017-12-15 04:57:24,271231.84,4372477.92
"5862",2017-12-15 04:57:24,-2335702.64,2036775.28
"5863",2017-12-15 05:37:20,-2036775.28,4.42378222942352e-09
"19228",2017-12-15 06:00:36,995598.61,995598.610000004
"5864",2017-12-15 06:04:55,51727.54,1047326.15
"5865",2017-12-15 06:49:32,-51727.54,995598.610000004
"19229",2017-12-15 06:49:32,777876.88,1773475.49
"5866",2017-12-15 06:53:44,88940.24,1862415.73
"19230",2017-12-15 06:53:44,102168.89,1964584.62
"19231",2017-12-15 06:53:44,777876.87,2742461.49
"5867",2017-12-15 07:27:57,-88940.24,2653521.25
"5868",2017-12-15 08:21:51,77831.06,2731352.31
"5869",2017-12-15 09:05:09,-77831.06,2653521.25
"19232",2017-12-15 09:05:09,777876.93,3431398.18
"19233",2017-12-15 09:05:09,654783.94,4086182.12
"5870",2017-12-15 10:40:27,410843.99,4497026.11
"5871",2017-12-15 10:40:27,777876.98,5274903.09
"5872",2017-12-15 11:06:22,372866.03,5647769.12
"5873",2017-12-15 11:06:22,777877,6425646.12
"5874",2017-12-15 11:06:22,777877.01,7203523.13
"5875",2017-12-15 11:06:22,777877.02,7981400.15
"19234",2017-12-15 11:06:22,777877.04,8759277.19000001
"19235",2017-12-15 11:06:22,416761.05,9176038.24000001
"5876",2017-12-15 11:30:44,777877.06,9953915.30000001
"5877",2017-12-15 11:30:44,777037.07,10730952.37
"5878",2017-12-15 11:50:53,320013.1,11050965.47
"5879",2017-12-15 11:50:53,777877.09,11828842.56
"5880",2017-12-15 12:18:46,777877.13,12606719.69
"5881",2017-12-15 12:18:46,777877.12,13384596.81
"19236",2017-12-15 12:18:46,777877.15,14162473.96
"19237",2017-12-15 12:18:46,656071.16,14818545.12
"5882",2017-12-15 12:21:09,356681.14,15175226.26
"5883",2017-12-15 12:33:54,777877.17,15953103.43
"5884",2017-12-15 12:33:54,277035.18,16230138.61
"5885",2017-12-15 12:43:03,777877.19,17008015.8
"5886",2017-12-15 12:43:03,297251.2,17305267
"5887",2017-12-15 13:04:52,777877.23,18083144.23
"5888",2017-12-15 13:04:52,301291.25,18384435.48
"5889",2017-12-15 13:04:52,777877.24,19162312.72
"19238",2017-12-15 13:04:52,777877.26,19940189.98
"19239",2017-12-15 13:04:52,50559.27,19990749.25
"5890",2017-12-15 13:18:16,777877.28,20768626.53
"5891",2017-12-15 13:31:52,617250.29,21385876.82
"19240",2017-12-15 13:31:52,583218.43,21969095.25
"5892",2017-12-15 13:39:30,777877.31,22746972.56
"5893",2017-12-15 13:39:30,91069.48,22838042.04
"19241",2017-12-15 13:39:30,466286.82,23304328.86
"19242",2017-12-15 13:39:30,446315.37,23750644.23
"19243",2017-12-15 13:48:18,467967.06,24218611.29
"5894",2017-12-15 14:03:01,777877.36,24996488.65
"5895",2017-12-15 14:03:01,777877.37,25774366.02
"5896",2017-12-15 14:03:01,61856.38,25836222.4
"5897",2017-12-15 14:25:09,507847.77,26344070.17
"5898",2017-12-15 14:25:09,27849.86,26371920.03
"19244",2017-12-15 14:25:09,777877.4,27149797.43
"19245",2017-12-15 14:25:09,6612.41,27156409.84
"19246",2017-12-15 14:25:09,44325.28,27200735.12
"19247",2017-12-15 15:30:01,91973.07,27292708.19
"19248",2017-12-15 16:00:13,182323.81,27475032
"19249",2017-12-15 16:08:55,6922.47,27481954.47
"19250",2017-12-15 16:23:04,384504.68,27866459.15
"19251",2017-12-15 16:43:02,156393.97,28022853.12
"19252",2017-12-15 16:50:11,111654.41,28134507.53
"5899",2017-12-15 17:52:06,-16864927.3,11269580.23
"19253",2017-12-15 18:51:02,5824639.64,17094219.87
"19254",2017-12-16 06:46:56,-17094219.87,0
"5900",2017-12-16 12:51:05,888994.74,888994.74
"5901",2017-12-16 12:51:05,888994.69,1777989.43
"5902",2017-12-16 12:51:05,888994.72,2666984.15
"5903",2017-12-16 12:51:05,888994.75,3555978.9
"5904",2017-12-16 12:51:05,888994.71,4444973.61
"5905",2017-12-16 12:51:05,888994.73,5333968.34
"5906",2017-12-16 12:51:05,888994.7,6222963.04
"19255",2017-12-16 12:51:05,777883.63,7000846.67
"19256",2017-12-16 12:51:05,309997.66,7310844.33
"19257",2017-12-16 12:51:05,777883.62,8088727.95
"19258",2017-12-16 12:51:05,777883.59,8866611.54
"19259",2017-12-16 12:51:05,777883.65,9644495.19
"19260",2017-12-16 12:51:05,777883.6,10422378.79
"19261",2017-12-16 12:51:05,777883.64,11200262.43
"19262",2017-12-16 12:51:05,777883.61,11978146.04
"5907",2017-12-16 13:02:17,-6222963.04,5755183
"19263",2017-12-16 15:48:41,486065.78,6241248.78
"19264",2017-12-16 15:48:41,777883.77,7019132.55
"19265",2017-12-16 21:38:49,587887.86,7607020.41
"19266",2017-12-16 21:38:49,777883.85,8384904.26
"19267",2017-12-16 22:42:06,777883.88,9162788.14
"19268",2017-12-16 22:42:06,777883.87,9940672.01
"19269",2017-12-16 22:42:06,148517.89,10089189.9
"19270",2017-12-17 00:19:27,777883.91,10867073.81
"19271",2017-12-17 00:29:55,777883.92,11644957.73
"19272",2017-12-17 00:29:55,254334.93,11899292.66
"5908",2017-12-17 00:47:33,888994.94,12788287.6
"5909",2017-12-17 00:47:33,888994.95,13677282.55
"5910",2017-12-17 00:47:33,888994.97,14566277.52
"19273",2017-12-17 00:47:33,888994.96,15455272.48
"5911",2017-12-17 01:19:20,-2666984.86,12788287.62
"5912",2017-12-17 04:15:50,777883.98,13566171.6
"5913",2017-12-17 04:15:50,888995,14455166.6
"5914",2017-12-17 04:22:10,777884.08,15233050.68
"5915",2017-12-17 04:22:10,777884.02,16010934.7
"5916",2017-12-17 04:22:10,777884.06,16788818.76
"5917",2017-12-17 04:22:10,888995.01,17677813.77
"5918",2017-12-17 04:22:10,777884.04,18455697.81
"5919",2017-12-17 04:22:10,777884.03,19233581.84
"5920",2017-12-17 04:22:10,777884.05,20011465.89
"5921",2017-12-17 04:22:10,327423.07,20338888.96
"5922",2017-12-17 04:23:05,777883.99,21116772.95
"5923",2017-12-17 04:44:11,-8328485.33,12788287.62
"5924",2017-12-17 07:20:54,290275.12,13078562.74
"5925",2017-12-17 07:20:54,777884.11,13856446.85
"5926",2017-12-17 07:32:31,777884.16,14634331.01
"5927",2017-12-17 07:32:31,250997.17,14885328.18
"5928",2017-12-17 07:32:31,777884.15,15663212.33
"5929",2017-12-17 07:46:46,-1068159.23,14595053.1
"5930",2017-12-17 07:57:28,1332909.9,15927963
"5931",2017-12-17 08:13:17,-1806765.48,14121197.52
"5932",2017-12-17 08:31:56,-1332909.9,12788287.62
"19274",2017-12-17 09:56:34,777884.21,13566171.83
"19275",2017-12-17 09:57:46,431269.22,13997441.05
"5933",2017-12-17 10:06:01,777884.23,14775325.28
"5934",2017-12-17 10:06:01,456041.24,15231366.52
"19276",2017-12-17 10:06:01,777884.2,16009250.72
"5935",2017-12-17 10:30:02,777884.25,16787134.97
"5936",2017-12-17 10:30:02,502324.26,17289459.23
"5937",2017-12-17 10:30:02,-1233925.47,16055533.76
"5938",2017-12-17 11:10:31,-1280208.51,14775325.25
"19277",2017-12-17 11:35:01,777884.28,15553209.53
"19278",2017-12-17 11:35:01,777884.29,16331093.82
"19279",2017-12-17 11:35:01,274604.3,16605698.12
"5939",2017-12-17 14:57:54,755832.38,17361530.5
"5940",2017-12-17 14:57:54,777884.37,18139414.87
"5941",2017-12-17 15:25:24,-1533716.75,16605698.12
"5942",2017-12-17 15:38:22,777884.41,17383582.53
"5943",2017-12-17 15:38:22,777884.4,18161466.93
"5944",2017-12-17 15:38:22,73775.42,18235242.35
"5945",2017-12-17 15:38:22,777884.39,19013126.74
"5946",2017-12-17 16:03:56,777884.45,19791011.19
"5947",2017-12-17 16:21:28,777884.44,20568895.63
"5948",2017-12-17 16:21:28,209363.46,20778259.09
"5949",2017-12-17 16:21:28,-2407428.62,18370830.47
"5950",2017-12-17 16:38:40,-1765132.35,16605698.12
"19280",2017-12-17 17:05:28,-16605698.12,7.45058059692383e-09
"19281",2017-12-17 19:41:24,53850.76,53850.7600000075
"19282",2017-12-17 19:50:39,777884.5,831735.260000007
"19283",2017-12-17 19:50:39,558632.51,1390367.77000001
"19284",2017-12-17 19:55:12,-1390367.77,7.45058059692383e-09
"5951",2017-12-17 20:16:51,445418.54,445418.540000007
"5952",2017-12-17 20:16:51,777884.53,1223303.07000001
"5953",2017-12-17 20:26:51,-1223303.07,7.45058059692383e-09
"5954",2017-12-17 20:26:51,63345.19,63345.1900000075
"5955",2017-12-17 20:58:14,-63345.19,7.45058059692383e-09
"19285",2017-12-17 21:12:52,1748969.99,1748969.99000001
"5956",2017-12-17 23:42:24,777884.58,2526854.57000001
"5957",2017-12-17 23:42:24,252356.6,2779211.17000001
"5958",2017-12-17 23:42:24,777884.59,3557095.76000001
"5959",2017-12-18 00:09:49,-1808125.77,1748969.99000001
"19286",2017-12-18 01:24:42,481424.67,2230394.66000001
"5960",2017-12-18 02:15:34,48904.16,2279298.82000001
"5961",2017-12-18 02:22:08,-48904.16,2230394.66000001
"19287",2017-12-18 02:46:39,32245.95,2262640.61000001
"19288",2017-12-18 02:50:07,31621.69,2294262.30000001
"5962",2017-12-18 03:40:26,117247.93,2411510.23000001
"5963",2017-12-18 03:40:26,31237.7,2442747.93000001
"5964",2017-12-18 03:40:26,118612.15,2561360.08000001
"5965",2017-12-18 03:40:26,19494.1,2580854.18000001
"5966",2017-12-18 04:34:15,-286591.88,2294262.30000001
"19289",2017-12-18 04:34:15,130881.59,2425143.89000001
"19290",2017-12-18 04:34:15,177968.89,2603112.78000001
"5967",2017-12-18 04:40:38,7736.01,2610848.79000001
"5968",2017-12-18 05:10:06,-7736.01,2603112.78000001
"19291",2017-12-18 05:23:28,261476.77,2864589.55000001
"19292",2017-12-18 05:26:48,20234.57,2884824.12000001
"5969",2017-12-18 05:49:17,777884.68,3662708.80000001
"5970",2017-12-18 05:49:17,777884.69,4440593.49000001
"19293",2017-12-18 05:49:17,777884.65,5218478.14000001
"19294",2017-12-18 05:49:17,777884.61,5996362.75000001
"19295",2017-12-18 05:49:17,777884.62,6774247.37000001
"19296",2017-12-18 05:49:17,777884.66,7552132.03000001
"5971",2017-12-18 06:09:28,-1555769.37,5996362.66000001
"5972",2017-12-18 06:09:28,1418598.26,7414960.92000001
"19297",2017-12-18 06:09:28,155280.59,7570241.51000001
"5973",2017-12-18 06:42:11,-1418598.26,6151643.25000001
"19298",2017-12-18 07:02:49,428184.16,6579827.41000001
"19299",2017-12-18 07:11:36,720557.63,7300385.04000001
"19300",2017-12-18 07:11:36,767680.27,8068065.31000001
"5974",2017-12-18 07:13:59,888995.71,8957061.02000001
"5975",2017-12-18 07:13:59,888995.72,9846056.74000001
"5976",2017-12-18 07:29:48,540337.08,10386393.82
"5977",2017-12-18 07:49:36,-2318328.51,8068065.31000001
"19301",2017-12-18 07:49:36,777885.07,8845950.38000001
"19302",2017-12-18 07:49:36,81120.08,8927070.46000001
"19303",2017-12-18 08:41:38,484713.15,9411783.61000001
"19304",2017-12-18 08:57:05,78495.12,9490278.73000001
"19305",2017-12-18 08:57:05,777885.11,10268163.84
"19306",2017-12-18 10:43:25,407848.27,10676012.11
"19307",2017-12-18 11:00:35,491768.88,11167780.99
"19308",2017-12-18 11:12:51,27567.27,11195348.26
"19309",2017-12-18 11:22:44,154369.13,11349717.39
"5978",2017-12-18 13:38:32,532591.24,11882308.63
"5979",2017-12-18 13:38:32,777885.23,12660193.86
"19310",2017-12-18 13:55:20,190095.26,12850289.12
"19311",2017-12-18 13:55:20,777885.25,13628174.37
"5980",2017-12-18 14:09:01,-1310476.47,12317697.9
"19312",2017-12-18 16:31:41,756187.85,13073885.75
"19313",2017-12-18 17:25:35,598081.85,13671967.6
"19314",2017-12-18 17:26:23,538119.07,14210086.67
"19315",2017-12-18 17:30:25,513351.63,14723438.3
"5981",2017-12-18 18:32:31,777885.42,15501323.72
"5982",2017-12-18 18:32:31,119611.43,15620935.15
"19316",2017-12-18 18:35:25,23317.33,15644252.48
"5983",2017-12-18 19:05:31,61236.48,15705488.96
"5984",2017-12-18 19:05:31,777885.47,16483374.43
"19317",2017-12-18 19:05:31,39328.46,16522702.89
"19318",2017-12-18 19:05:31,777885.44,17300588.33
"19319",2017-12-18 19:05:31,777885.45,18078473.78
"5985",2017-12-18 19:33:56,-1736618.8,16341854.98
"19320",2017-12-19 04:19:15,209.22,16342064.2
"19321",2017-12-19 04:19:15,777888.19,17119952.39
"19322",2017-12-19 04:19:15,38474.2,17158426.59
"19323",2017-12-19 04:19:15,777888.21,17936314.8
"5986",2017-12-19 04:40:18,777888.23,18714203.03
"5987",2017-12-19 04:40:18,3716.24,18717919.27
"19324",2017-12-19 04:40:18,136333.26,18854252.53
"19325",2017-12-19 04:40:18,777888.25,19632140.78
"5988",2017-12-19 05:25:13,-781604.47,18850536.31
"19326",2017-12-19 05:53:42,777888.28,19628424.59
"19327",2017-12-19 05:53:42,246466.29,19874890.88
"19328",2017-12-19 07:23:44,1179512.23,21054403.11
"5989",2017-12-19 08:28:51,401349.34,21455752.45
"5990",2017-12-19 08:28:51,777888.33,22233640.78
"19329",2017-12-19 09:02:26,627659.64,22861300.42
"5991",2017-12-19 09:33:54,-1179237.67,21682062.75
"19330",2017-12-19 09:33:54,777888.36,22459951.11
"19331",2017-12-19 09:33:54,153236.37,22613187.48
"19332",2017-12-19 10:52:44,3597.85,22616785.33
"19333",2017-12-19 10:57:00,12217.2,22629002.53
"19334",2017-12-19 11:14:29,89420.75,22718423.28
"19335",2017-12-19 11:14:29,64563.52,22782986.8
"19336",2017-12-19 11:14:29,24710.46,22807697.26
"19337",2017-12-19 11:16:24,48720.35,22856417.61
"19338",2017-12-19 11:16:24,10526.92,22866944.53
"19339",2017-12-19 11:16:24,10556.53,22877501.06
"19340",2017-12-19 11:16:24,5275.69,22882776.75
"19341",2017-12-19 11:16:24,10395.47,22893172.22
"19342",2017-12-19 13:27:36,-22893172.22,1.49011611938477e-08
"19343",2017-12-19 13:27:36,50462.63,50462.6300000149
"5992",2017-12-19 14:07:16,678331.71,728794.340000015
"5993",2017-12-19 14:13:18,777888.69,1506683.03000001
"5994",2017-12-19 14:13:18,777888.71,2284571.74000001
"5995",2017-12-19 14:30:59,308205.72,2592777.46000001
"5996",2017-12-19 15:01:39,-2234109.11,358668.350000015
"5997",2017-12-19 15:51:12,-308205.72,50462.630000015
"5998",2017-12-19 17:13:29,777888.83,828351.460000015
"19344",2017-12-19 17:13:29,777888.85,1606240.31000001
"19345",2017-12-19 17:13:29,475498.95,2081739.26000001
"5999",2017-12-19 19:17:00,-777888.83,1303850.43000002
"6000",2017-12-19 22:38:34,777888.92,2081739.35000001
"6001",2017-12-19 22:38:34,777888.7,2859628.05000001
"19346",2017-12-19 22:38:34,122654.89,2982282.94000001
"19347",2017-12-19 22:38:34,777888.88,3760171.82000001
"19348",2017-12-19 22:38:34,777888.91,4538060.73000001
"6002",2017-12-19 23:05:18,-1555777.62,2982283.11000001
"6003",2017-12-19 23:35:35,888999.94,3871283.05000001
"19349",2017-12-19 23:35:35,777888.93,4649171.98000001
"6004",2017-12-20 00:10:19,-888999.94,3760172.04000001
"6005",2017-12-20 05:05:35,777888.96,4538061.00000001
"6006",2017-12-20 05:05:35,234744.98,4772805.98000002
"6007",2017-12-20 05:05:35,777888.97,5550694.95000002
"19350",2017-12-20 05:05:35,247020.11,5797715.06000002
"19351",2017-12-20 05:05:35,743491.15,6541206.21000002
"19352",2017-12-20 05:05:35,504816.76,7046022.97000002
"6008",2017-12-20 05:08:24,595832.53,7641855.50000002
"19353",2017-12-20 05:08:24,751003.66,8392859.16000002
"6009",2017-12-20 05:35:32,-2386355.44,6006503.72000002
"19354",2017-12-20 05:35:32,290704.1,6297207.82000002
"19355",2017-12-20 05:35:32,777889.09,7075096.91000002
"19356",2017-12-20 09:10:36,300112.16,7375209.07000002
"6010",2017-12-20 09:14:21,563335.23,7938544.30000002
"19357",2017-12-20 09:14:21,300112.17,8238656.47000002
"6011",2017-12-20 09:47:39,-563335.23,7675321.24000002
"19358",2017-12-20 10:15:04,777889.19,8453210.43000001
"19359",2017-12-20 11:53:10,300112.22,8753322.65000002
"6012",2017-12-20 15:52:07,300112.33,9053434.98000002
"6013",2017-12-20 16:24:58,-300112.33,8753322.65000002
"6014",2017-12-20 18:39:41,888992.53,9642315.18000001
"6015",2017-12-20 18:51:11,-888992.53,8753322.65000002
"19360",2017-12-20 19:12:02,-8753322.65,1.49011611938477e-08
"19361",2017-12-20 19:55:26,389000.61,389000.610000015
"6016",2017-12-20 22:41:13,300112.69,689113.300000015
"6017",2017-12-20 23:36:01,-300112.69,389000.610000015
"19362",2017-12-21 02:05:29,103218.19,492218.800000015
"19363",2017-12-21 03:26:33,228772.46,720991.260000015
"6018",2017-12-21 06:00:54,720180.64,1441171.90000001
"6019",2017-12-21 06:31:32,-720180.64,720991.260000015
"6020",2017-12-21 10:12:26,117486.89,838478.150000015
"6021",2017-12-21 10:12:26,120424.84,958902.990000015
"6022",2017-12-21 10:12:26,207705.86,1166608.85000001
"6023",2017-12-21 10:12:26,146714.26,1313323.11000001
"6024",2017-12-21 10:12:26,85821.55,1399144.66000001
"6025",2017-12-21 10:12:26,70569.12,1469713.78000001
"6026",2017-12-21 10:12:26,101496.07,1571209.85000001
"19364",2017-12-21 10:12:26,246165.6,1817375.45000001
"19365",2017-12-21 10:12:26,442188.46,2259563.91000002
"6027",2017-12-21 10:59:51,-850218.59,1409345.32000002
"19366",2017-12-21 21:19:44,550725.29,1960070.61000002
"19367",2017-12-21 21:40:10,777890.38,2737960.99000002
"19368",2017-12-21 21:40:10,640145.39,3378106.38000002
"19369",2017-12-21 22:29:48,777890.41,4155996.79000002
"6028",2017-12-22 00:09:57,286953.71,4442950.50000002
"6029",2017-12-22 00:09:57,777890.7,5220841.20000002
"19370",2017-12-22 00:09:57,413544.69,5634385.89000002
"19371",2017-12-22 00:09:57,777890.68,6412276.57000002
"19372",2017-12-22 00:26:14,342711.84,6754988.41000002
"6030",2017-12-22 00:44:33,-1064844.41,5690144.00000002
"19373",2017-12-22 00:59:39,85927.54,5776071.54000002
"19374",2017-12-22 00:59:39,40089.96,5816161.50000002
"19375",2017-12-22 00:59:39,184735.4,6000896.90000002
"19376",2017-12-22 00:59:39,236071.45,6236968.35000002
"19377",2017-12-22 00:59:39,171855.07,6408823.42000002
"6031",2017-12-22 01:53:51,189130.56,6597953.98000002
"6032",2017-12-22 01:53:51,168578.49,6766532.47000002
"6033",2017-12-22 01:53:51,238287.14,7004819.61000002
"19378",2017-12-22 01:53:51,311475.11,7316294.72000002
"19379",2017-12-22 01:53:51,173242.33,7489537.05000002
"19380",2017-12-22 02:03:46,150148.77,7639685.82000002
"19381",2017-12-22 02:10:28,167922.8,7807608.62000002
"19382",2017-12-22 02:10:28,142357.98,7949966.60000002
"19383",2017-12-22 02:18:02,155548.54,8105515.14000002
"6034",2017-12-22 02:44:41,-595996.19,7509518.95000002
"19384",2017-12-22 03:08:12,294843.46,7804362.41000002
"19385",2017-12-22 03:08:12,554558.46,8358920.87000002
"19386",2017-12-22 04:25:39,427677.85,8786598.72000002
"19387",2017-12-22 05:09:09,149678.3,8936277.02000002
"19388",2017-12-22 05:09:09,179900.04,9116177.06000002
"19389",2017-12-22 05:09:09,135110.76,9251287.82000002
"19390",2017-12-22 05:21:20,230104.37,9481392.19000001
"19391",2017-12-22 05:44:31,120784.68,9602176.87000001
"19392",2017-12-22 05:44:31,110294.46,9712471.33000001
"19393",2017-12-22 05:44:31,136105.78,9848577.11000001
"19394",2017-12-22 05:44:31,91812.61,9940389.72000001
"19395",2017-12-22 05:44:31,32068.89,9972458.61000001
"19396",2017-12-22 05:44:31,94345.97,10066804.58
"19397",2017-12-22 06:16:31,128143.89,10194948.47
"19398",2017-12-22 06:32:40,8819.72,10203768.19
"19399",2017-12-22 06:32:40,7561.69,10211329.88
"19400",2017-12-22 06:32:40,57532.59,10268862.47
"19401",2017-12-22 06:32:40,32626.06,10301488.53
"19402",2017-12-22 06:32:40,39289.01,10340777.54
"19403",2017-12-22 06:36:28,17698.4,10358475.94
"19404",2017-12-22 06:36:28,32807.69,10391283.63
"19405",2017-12-22 06:36:28,49750.81,10441034.44
"19406",2017-12-22 06:59:54,180223.11,10621257.55
"19407",2017-12-22 06:59:54,138181.63,10759439.18
"6035",2017-12-22 07:19:43,100114.41,10859553.59
"6036",2017-12-22 07:48:20,-100114.41,10759439.18
"6037",2017-12-22 10:20:06,300114.69,11059553.87
"19408",2017-12-22 10:20:06,300114.7,11359668.57
"6038",2017-12-22 11:31:16,-300114.69,11059553.88
"6039",2017-12-22 14:16:46,777891.85,11837445.73
"6040",2017-12-22 15:17:02,-777891.85,11059553.88
"6041",2017-12-22 16:05:22,777891.93,11837445.81
"19409",2017-12-22 16:17:35,294968.64,12132414.45
"19410",2017-12-22 19:20:37,231590.16,12364004.61
"19411",2017-12-22 19:20:37,191731.43,12555736.04
"19412",2017-12-22 19:20:37,190712.95,12746448.99
"19413",2017-12-22 19:20:37,383193.35,13129642.34
"19414",2017-12-22 19:20:37,653385.41,13783027.75
"19415",2017-12-22 21:31:58,189003.31,13972031.06
"6042",2017-12-23 01:07:28,246606.65,14218637.71
"6043",2017-12-23 01:53:46,-1024498.58,13194139.13
"19416",2017-12-23 01:53:46,245544.37,13439683.5
"19417",2017-12-23 02:01:26,261729.82,13701413.32
"6044",2017-12-23 02:31:41,369857.52,14071270.84
"6045",2017-12-23 02:31:41,184461.36,14255732.2
"19418",2017-12-23 02:31:41,100012.19,14355744.39
"6046",2017-12-23 02:39:51,-554318.88,13801425.51
"19419",2017-12-23 04:16:40,338915.42,14140340.93
"19420",2017-12-23 04:16:40,376354.65,14516695.58
"19421",2017-12-23 05:07:37,530973.08,15047668.66
"19422",2017-12-23 05:31:13,545596.26,15593264.92
"19423",2017-12-23 08:55:02,415673.31,16008938.23
"19424",2017-12-23 10:01:31,-1303850.43,14705087.8
"19425",2017-12-23 10:01:31,-1303850.43,13401237.37
"19426",2017-12-23 10:01:31,-1303850.43,12097386.94
"19427",2017-12-23 10:01:31,107641.87,12205028.81
"19428",2017-12-23 10:01:31,-1303850.43,10901178.38
"6047",2017-12-23 10:03:47,984449.08,11885627.46
"19429",2017-12-23 10:03:47,16411.16,11902038.62
"19430",2017-12-23 10:03:47,16312.89,11918351.51
"19431",2017-12-23 10:03:47,-1303850.43,10614501.08
"6048",2017-12-23 10:38:46,286117.95,10900619.03
"6049",2017-12-23 10:38:46,390827.28,11291446.31
"6050",2017-12-23 11:05:59,-984449.08,10306997.23
"6051",2017-12-23 11:12:43,344804.82,10651802.05
"19432",2017-12-23 11:12:43,233643.49,10885445.54
"19433",2017-12-23 11:26:49,59463.92,10944909.46
"19434",2017-12-23 11:31:51,233721.69,11178631.15
"6052",2017-12-23 12:17:24,-1021750.05,10156881.1
"6053",2017-12-23 12:58:51,341144.26,10498025.36
"6054",2017-12-23 12:58:51,233462.28,10731487.64
"6055",2017-12-23 13:05:48,-574606.54,10156881.1
"6056",2017-12-23 13:05:48,79654.78,10236535.88
"19435",2017-12-23 13:05:48,258662.64,10495198.52
"6057",2017-12-23 13:07:44,252343.63,10747542.15
"6058",2017-12-23 13:39:07,-79654.78,10667887.37
"6059",2017-12-23 13:53:45,-252343.63,10415543.74
"6060",2017-12-23 13:53:45,255450.84,10670994.58
"6061",2017-12-23 14:57:54,-255450.84,10415543.74
"19436",2017-12-23 14:57:54,241190.07,10656733.81
"19437",2017-12-23 15:00:18,431550.87,11088284.68
"19438",2017-12-23 15:00:18,271768.78,11360053.46
"19439",2017-12-23 15:15:58,588553.83,11948607.29
"19440",2017-12-23 16:05:10,240056.24,12188663.53
"19441",2017-12-23 16:20:26,178612.01,12367275.54
"19442",2017-12-23 16:20:26,192281.96,12559557.5
"6062",2017-12-23 16:25:00,262309.76,12821867.26
"6063",2017-12-23 16:42:29,-262309.76,12559557.5
"19443",2017-12-23 16:42:29,284733.05,12844290.55
"19444",2017-12-23 16:42:29,323231.19,13167521.74
"19445",2017-12-23 17:11:18,218738.32,13386260.06
"19446",2017-12-23 17:11:18,188982.5,13575242.56
"19447",2017-12-23 17:11:18,195580.6,13770823.16
"19448",2017-12-23 17:11:18,217588.27,13988411.43
"6064",2017-12-23 18:30:17,420610.63,14409022.06
"6065",2017-12-23 18:30:17,360146.85,14769168.91
"6066",2017-12-23 18:30:17,37400.51,14806569.42
"6067",2017-12-23 18:54:55,-818157.99,13988411.43
"19449",2017-12-23 18:55:39,173088.08,14161499.51
"19450",2017-12-23 18:55:39,77489.94,14238989.45
"19451",2017-12-23 19:14:05,359694.38,14598683.83
"6068",2017-12-23 19:35:00,351842.74,14950526.57
"6069",2017-12-23 19:51:43,-351842.74,14598683.83
"19452",2017-12-23 19:51:43,179909.85,14778593.68
"19453",2017-12-23 20:11:12,201436.63,14980030.31
"6070",2017-12-23 20:25:03,340614.72,15320645.03
"19454",2017-12-23 20:25:03,164975.77,15485620.8
"6071",2017-12-23 20:46:11,-340614.72,15145006.08
"19455",2017-12-23 21:05:09,252102.75,15397108.83
"19456",2017-12-23 21:17:56,223999.92,15621108.75
"19457",2017-12-23 21:42:37,155579.98,15776688.73
"6072",2017-12-23 22:37:48,151369.91,15928058.64
"6073",2017-12-23 22:37:48,237127.8,16165186.44
"6074",2017-12-23 22:37:48,204484.13,16369670.57
"19458",2017-12-23 22:37:48,134862.46,16504533.03
"19459",2017-12-23 22:37:48,234433.19,16738966.22
"19460",2017-12-23 22:37:48,275879.02,17014845.24
"19461",2017-12-23 22:37:48,163525.33,17178370.57
"6075",2017-12-23 22:55:10,-592981.84,16585388.73
"6076",2017-12-23 22:55:10,454894.32,17040283.05
"19462",2017-12-23 22:55:10,457238.86,17497521.91
"19463",2017-12-23 22:55:10,302015.91,17799537.82
"6077",2017-12-23 23:15:00,-454894.32,17344643.5
"6078",2017-12-23 23:15:00,396390.14,17741033.64
"6079",2017-12-23 23:15:00,712044.32,18453077.96
"19464",2017-12-23 23:15:00,514243.2,18967321.16
"19465",2017-12-23 23:15:00,364899.46,19332220.62
"19466",2017-12-23 23:15:00,777893.45,20110114.07
"6080",2017-12-23 23:21:37,-1108434.46,19001679.61
"6081",2017-12-23 23:50:33,509419.31,19511098.92
"6082",2017-12-23 23:50:33,777893.55,20288992.47
"6083",2017-12-23 23:50:33,196375.56,20485368.03
"6084",2017-12-23 23:50:33,593396.72,21078764.75
"19467",2017-12-23 23:50:33,206268.54,21285033.29
"19468",2017-12-23 23:50:33,777893.53,22062926.82
"19469",2017-12-23 23:50:33,557181.13,22620107.95
"6085",2017-12-24 00:00:11,-2077085.14,20543022.81
"19470",2017-12-24 00:03:00,579855.55,21122878.36
"6086",2017-12-24 00:55:43,777893.6,21900771.96
"6087",2017-12-24 00:55:43,777893.59,22678665.55
"6088",2017-12-24 00:55:43,526968.61,23205634.16
"19471",2017-12-24 00:55:43,603704.1,23809338.26
"19472",2017-12-24 00:55:43,596428.81,24405767.07
"19473",2017-12-24 00:55:43,620068.78,25025835.85
"19474",2017-12-24 00:58:00,33223.75,25059059.6
"19475",2017-12-24 00:58:00,17636.07,25076695.67
"6089",2017-12-24 00:59:01,-2082755.8,22993939.87
"6090",2017-12-24 01:17:07,777893.69,23771833.56
"6091",2017-12-24 01:17:07,352371.71,24124205.27
"6092",2017-12-24 01:17:07,777893.7,24902098.97
"6093",2017-12-24 01:20:11,-1908159.1,22993939.87
"19476",2017-12-24 01:20:11,451304.41,23445244.28
"6094",2017-12-24 01:56:08,777893.75,24223138.03
"6095",2017-12-24 01:56:08,159932.76,24383070.79
"6096",2017-12-24 01:56:08,777893.74,25160964.53
"19477",2017-12-24 01:56:08,751591.12,25912555.65
"6097",2017-12-24 02:00:32,-1715720.25,24196835.4
"6098",2017-12-24 02:32:40,165595.83,24362431.23
"6099",2017-12-24 02:32:40,777893.78,25140325.01
"6100",2017-12-24 02:32:40,501387.79,25641712.8
"6101",2017-12-24 02:32:40,777893.82,26419606.62
"19478",2017-12-24 02:32:40,30170.81,26449777.43
"19479",2017-12-24 02:32:40,504754.7,26954532.13
"19480",2017-12-24 02:32:40,777893.8,27732425.93
"19481",2017-12-24 02:35:55,45405.21,27777831.14
"6102",2017-12-24 02:47:31,-2222771.22,25555059.92
"19482",2017-12-24 02:56:49,440732.86,25995792.78
"19483",2017-12-24 02:56:49,732528.88,26728321.66
"6103",2017-12-24 03:05:30,777893.88,27506215.54
"6104",2017-12-24 03:05:30,777893.89,28284109.43
"6105",2017-12-24 03:05:30,665498.9,28949608.33
"19484",2017-12-24 03:05:30,607991.68,29557600.01
"6106",2017-12-24 03:29:38,-2221286.67,27336313.34
"19485",2017-12-24 03:29:38,409666.73,27745980.07
"19486",2017-12-24 03:29:38,567249.8,28313229.87
"6107",2017-12-24 03:45:03,777893.95,29091123.82
"6108",2017-12-24 03:45:03,622283.96,29713407.78
"6109",2017-12-24 03:49:01,-1400177.91,28313229.87
"19487",2017-12-24 04:02:21,139112.91,28452342.78
"19488",2017-12-24 04:43:04,470458.78,28922801.56
"19489",2017-12-24 04:43:04,97478.96,29020280.52
"19490",2017-12-24 04:51:23,527118.51,29547399.03
"19491",2017-12-24 06:18:12,474587.63,30021986.66
"19492",2017-12-24 06:18:12,430141.65,30452128.31
"6110",2017-12-24 07:18:56,570201,31022329.31
"6111",2017-12-24 07:18:56,550869.41,31573198.72
"19493",2017-12-24 07:18:56,387857.57,31961056.29
"19494",2017-12-24 07:18:56,468366.33,32429422.62
"6112",2017-12-24 07:23:51,-1121070.41,31308352.21
"6113",2017-12-24 07:36:31,22160.95,31330513.16
"6114",2017-12-24 07:36:31,94574.94,31425088.1
"19495",2017-12-24 07:36:31,18723.98,31443812.08
"19496",2017-12-24 07:37:41,382929.57,31826741.65
"6115",2017-12-24 07:43:44,-116735.89,31710005.76
"19497",2017-12-24 08:00:23,549514.13,32259519.89
"6116",2017-12-24 08:20:54,496377.36,32755897.25
"6117",2017-12-24 08:20:54,831990.45,33587887.7
"6118",2017-12-24 08:28:39,-1328367.81,32259519.89
"6119",2017-12-24 08:49:06,494247.17,32753767.06
"6120",2017-12-24 08:49:06,625269.14,33379036.2
"6121",2017-12-24 09:00:49,-1119516.31,32259519.89
"6122",2017-12-24 09:19:18,412786.71,32672306.6
"6123",2017-12-24 09:20:00,667683.13,33339989.73
"6124",2017-12-24 09:27:26,-1080469.84,32259519.89
"6125",2017-12-24 09:27:26,385048.96,32644568.85
"6126",2017-12-24 09:42:29,-385048.96,32259519.89
"19498",2017-12-24 10:21:19,377334.75,32636854.64
"6127",2017-12-24 10:35:11,282857.28,32919711.92
"6128",2017-12-24 10:35:11,466296.75,33386008.67
"6129",2017-12-24 10:35:11,20690.66,33406699.33
"6130",2017-12-24 10:53:47,300112.33,33706811.66
"6131",2017-12-24 10:53:47,-769844.69,32936966.97
"6132",2017-12-24 10:53:47,77894.34,33014861.31
"6133",2017-12-24 11:08:49,-378006.67,32636854.64
"6134",2017-12-24 11:33:57,77894.36,32714749
"6135",2017-12-24 11:41:53,-77894.36,32636854.64
"6136",2017-12-24 11:41:53,89005.44,32725860.08
"6137",2017-12-24 12:04:43,-89005.44,32636854.64
"6138",2017-12-24 12:04:43,300117.49,32936972.13
"6139",2017-12-24 12:04:43,89005.47,33025977.6
"6140",2017-12-24 12:04:43,300117.46,33326095.06
"6141",2017-12-24 12:18:27,-689240.42,32636854.64
"6142",2017-12-24 12:18:27,300117.54,32936972.18
"6143",2017-12-24 12:18:27,300117.51,33237089.69
"6144",2017-12-24 12:42:36,-600235.05,32636854.64
"19499",2017-12-24 12:42:36,46949.04,32683803.68
"19500",2017-12-24 13:11:48,362496.44,33046300.12
"19501",2017-12-24 13:27:59,414869.59,33461169.71
"6145",2017-12-24 13:32:49,225840.14,33687009.85
"6146",2017-12-24 13:43:45,-225840.14,33461169.71
"6147",2017-12-24 14:02:45,343229.98,33804399.69
"6148",2017-12-24 14:13:42,-343229.98,33461169.71
"6149",2017-12-24 14:47:20,253049.03,33714218.74
"6150",2017-12-24 14:47:20,379356.04,34093574.78
"6151",2017-12-24 14:47:20,284278.64,34377853.42
"6152",2017-12-24 14:55:07,-916683.71,33461169.71
"19502",2017-12-24 14:59:17,592099.89,34053269.6
"6153",2017-12-24 15:17:26,76623.66,34129893.26
"6154",2017-12-24 15:29:42,-76623.66,34053269.6
"6155",2017-12-24 15:29:42,270165.68,34323435.28
"6156",2017-12-24 15:29:42,248278.89,34571714.17
"6157",2017-12-24 15:36:31,-518444.57,34053269.6
"6158",2017-12-24 15:42:55,352220.75,34405490.35
"6159",2017-12-24 15:55:17,-352220.75,34053269.6
"19503",2017-12-24 15:55:17,289418.05,34342687.65
"6160",2017-12-24 16:05:17,276040.89,34618728.54
"6161",2017-12-24 16:07:09,298013.39,34916741.93
"6162",2017-12-24 16:09:56,-276040.89,34640701.04
"6163",2017-12-24 16:33:25,-298013.39,34342687.65
"6164",2017-12-24 16:33:25,281217.03,34623904.68
"6165",2017-12-24 16:33:25,308571.27,34932475.95
"19504",2017-12-24 16:33:25,231227.79,35163703.74
"6166",2017-12-24 16:43:40,-589788.3,34573915.44
"19505",2017-12-24 16:43:40,324990.43,34898905.87
"19506",2017-12-24 16:43:40,384577.1,35283482.97
"6167",2017-12-24 17:08:48,177895.06,35461378.03
"6168",2017-12-24 17:12:18,-177895.06,35283482.97
"19507",2017-12-24 17:49:34,286287.74,35569770.71
"6169",2017-12-24 18:00:57,215718.07,35785488.78
"6170",2017-12-24 18:10:13,-215718.07,35569770.71
"19508",2017-12-24 18:19:26,666895.31,36236666.02
"6171",2017-12-24 18:46:53,276916.13,36513582.15
"6172",2017-12-24 18:46:53,501066.04,37014648.19
"19509",2017-12-24 18:46:53,300118.16,37314766.35
"6173",2017-12-24 18:49:46,-777982.17,36536784.18
"6174",2017-12-24 19:14:25,250415.57,36787199.75
"6175",2017-12-24 19:14:25,334662.3,37121862.05
"19510",2017-12-24 19:14:25,274298.69,37396160.74
"6176",2017-12-24 19:34:43,-585077.87,36811082.87
"6177",2017-12-24 20:04:14,637155.18,37448238.05
"6178",2017-12-24 20:08:23,-637155.18,36811082.87
"19511",2017-12-24 20:21:59,407091.08,37218173.95
"19512",2017-12-24 20:36:53,394624.87,37612798.82
"6179",2017-12-24 21:15:12,300118.31,37912917.13
"19513",2017-12-24 21:15:12,709191.31,38622108.44
"19514",2017-12-24 21:15:12,277867.82,38899976.26
"6180",2017-12-24 21:20:13,-300118.31,38599857.95
"6181",2017-12-24 21:20:13,426550.69,39026408.64
"6182",2017-12-24 21:26:23,-426550.69,38599857.95
"6183",2017-12-24 22:42:52,271058.89,38870916.84
"6184",2017-12-24 22:46:42,-271058.89,38599857.95
"19515",2017-12-25 00:12:38,317103.52,38916961.47
"19516",2017-12-25 00:12:38,347085.62,39264047.09
"19517",2017-12-25 00:25:09,24263.75,39288310.84
"19518",2017-12-25 01:02:01,284579.93,39572890.77
"6185",2017-12-25 01:56:01,385323.67,39958214.44
"19519",2017-12-25 01:56:01,388181.66,40346396.1
"6186",2017-12-25 02:00:11,-385323.67,39961072.43
"6187",2017-12-25 02:29:21,381589.45,40342661.88
"6188",2017-12-25 02:46:29,-381589.45,39961072.43
"6189",2017-12-25 03:41:53,336965.55,40298037.98
"6190",2017-12-25 03:57:37,-336965.55,39961072.43
"6191",2017-12-25 05:00:09,412570.45,40373642.88
"6192",2017-12-25 05:00:09,265352.25,40638995.13
"6193",2017-12-25 05:00:09,499991.54,41138986.67
"6194",2017-12-25 05:00:09,353827.03,41492813.7
"19520",2017-12-25 05:00:09,404837.63,41897651.33
"19521",2017-12-25 05:00:09,269671.94,42167323.27
"19522",2017-12-25 05:00:09,340542.59,42507865.86
"6195",2017-12-25 05:10:27,-1531741.27,40976124.59
"6196",2017-12-25 05:10:27,590804.08,41566928.67
"6197",2017-12-25 05:18:16,-590804.08,40976124.59
"6198",2017-12-25 05:18:16,222731.45,41198856.04
"6199",2017-12-25 05:35:09,-222731.45,40976124.59
"19523",2017-12-25 05:35:09,328952.17,41305076.76
"19524",2017-12-25 05:35:09,26364.89,41331441.65
"6200",2017-12-25 06:29:26,509109.19,41840550.84
"6201",2017-12-25 06:31:53,410196.56,42250747.4
"6202",2017-12-25 07:00:48,-509109.19,41741638.21
"6203",2017-12-25 08:03:18,-410196.56,41331441.65
"19525",2017-12-25 08:03:18,300118.88,41631560.53
"19526",2017-12-25 08:03:18,287082.25,41918642.78
"6204",2017-12-25 08:29:20,308811.82,42227454.6
"19527",2017-12-25 08:29:20,346342.08,42573796.68
"19528",2017-12-25 08:29:20,613784.36,43187581.04
"19529",2017-12-25 08:46:18,366806.04,43554387.08
"19530",2017-12-25 08:46:18,659760.52,44214147.6
"6205",2017-12-25 08:51:14,-308811.82,43905335.78
"6206",2017-12-25 08:51:14,403875.86,44309211.64
"6207",2017-12-25 09:13:39,-403875.86,43905335.78
"19531",2017-12-25 09:13:39,284672.5,44190008.28
"19532",2017-12-25 10:18:32,422160.57,44612168.85
"19533",2017-12-25 12:29:50,289932.67,44902101.52
"19534",2017-12-25 12:29:50,406837.25,45308938.77
"6208",2017-12-25 13:03:42,352661.46,45661600.23
"19535",2017-12-25 13:03:42,267611.85,45929212.08
"19536",2017-12-25 13:03:42,391176.3,46320388.38
"6209",2017-12-25 13:10:12,-352661.46,45967726.92
"6210",2017-12-25 13:27:24,511529.06,46479255.98
"6211",2017-12-25 13:27:24,857087.94,47336343.92
"6212",2017-12-25 13:44:35,-1368617,45967726.92
"19537",2017-12-25 13:59:10,93801.2,46061528.12
"19538",2017-12-25 13:59:10,382786.34,46444314.46
"19539",2017-12-25 13:59:10,777896.19,47222210.65
"19540",2017-12-25 13:59:10,393465.42,47615676.07
"19541",2017-12-25 14:31:15,383235.55,47998911.62
"19542",2017-12-25 14:31:15,383235.55,48382147.17
"6213",2017-12-25 14:50:34,94667.24,48476814.41
"6214",2017-12-25 14:50:34,530288.81,49007103.22
"6215",2017-12-25 14:50:34,359435.41,49366538.63
"6216",2017-12-25 15:22:44,-984391.46,48382147.17
"19543",2017-12-25 15:22:44,439822.49,48821969.66
"19544",2017-12-25 15:49:35,247007.59,49068977.25
"19545",2017-12-25 16:51:32,249683.58,49318660.83
"6217",2017-12-25 17:42:45,241229.91,49559890.74
"6218",2017-12-25 18:01:43,-241229.91,49318660.83
"19546",2017-12-25 18:01:43,404896.13,49723556.96
"6219",2017-12-25 18:08:06,469945.03,50193501.99
"6220",2017-12-25 18:17:33,-469945.03,49723556.96
"19547",2017-12-25 18:24:37,317559.31,50041116.27
"19548",2017-12-25 18:26:10,300119.44,50341235.71
"19549",2017-12-25 18:59:19,290139.9,50631375.61
"19550",2017-12-25 18:59:19,304486.27,50935861.88
"19551",2017-12-25 19:12:33,313660.16,51249522.04
"19552",2017-12-25 19:24:37,315587.02,51565109.06
"19553",2017-12-25 19:35:11,277890.88,51842999.94
"6221",2017-12-25 20:58:35,306085.39,52149085.33
"6222",2017-12-25 20:58:35,36919.84,52186005.17
"19554",2017-12-25 20:58:35,401805.4,52587810.57
"19555",2017-12-25 20:58:35,382062.32,52969872.89
"19556",2017-12-25 20:58:35,343906.09,53313778.98
"19557",2017-12-25 21:05:01,49821.82,53363600.8
"6223",2017-12-25 21:17:09,-343005.23,53020595.57
"19558",2017-12-25 21:20:09,311328.57,53331924.14
"6224",2017-12-25 23:07:50,481790.77,53813714.91
"6225",2017-12-25 23:07:50,350404.37,54164119.28
"6226",2017-12-25 23:07:50,302060.72,54466180
"19559",2017-12-25 23:07:50,345739.49,54811919.49
"6227",2017-12-25 23:36:04,-1134255.86,53677663.63
"19560",2017-12-25 23:56:49,379242.4,54056906.03
"6228",2017-12-26 00:16:44,516969.16,54573875.19
"6229",2017-12-26 00:28:12,-516969.16,54056906.03
"19561",2017-12-26 00:28:12,282559.78,54339465.81
"19562",2017-12-26 00:57:21,559284.17,54898749.98
"6230",2017-12-26 01:11:48,478654.13,55377404.11
"6231",2017-12-26 01:43:01,-478654.13,54898749.98
"6232",2017-12-26 01:43:01,523035.55,55421785.53
"6233",2017-12-26 01:57:08,-523035.55,54898749.98
"19563",2017-12-26 02:03:16,302800.92,55201550.9
"19564",2017-12-26 02:38:39,172282.19,55373833.09
"6234",2017-12-26 02:44:45,192553.87,55566386.96
"6235",2017-12-26 03:12:41,-192553.87,55373833.09
"19565",2017-12-26 03:12:41,152292.62,55526125.71
"19566",2017-12-26 03:31:57,204851.93,55730977.64
"6236",2017-12-26 03:50:59,186951.48,55917929.12
"6237",2017-12-26 03:58:31,-186951.48,55730977.64
"19567",2017-12-26 03:58:31,246058.65,55977036.29
"6238",2017-12-26 04:13:20,269913.6,56246949.89
"6239",2017-12-26 04:13:20,238310.6,56485260.49
"19568",2017-12-26 04:13:20,263874.22,56749134.71
"6240",2017-12-26 04:19:57,-508224.2,56240910.51
"6241",2017-12-26 04:58:17,407294.97,56648205.48
"6242",2017-12-26 04:58:17,216806.14,56865011.62
"6243",2017-12-26 05:03:06,-624101.11,56240910.51
"6244",2017-12-26 05:25:54,429281.89,56670192.4
"19569",2017-12-26 05:25:54,384985.13,57055177.53
"19570",2017-12-26 05:25:54,62787.51,57117965.04
"19571",2017-12-26 05:30:05,240170.29,57358135.33
"6245",2017-12-26 05:38:20,185601.91,57543737.24
"6246",2017-12-26 05:38:20,-429281.89,57114455.35
"19572",2017-12-26 05:38:20,291974.6,57406429.95
"6247",2017-12-26 06:14:47,292891.65,57699321.6
"6248",2017-12-26 06:14:47,192629.83,57891951.43
"6249",2017-12-26 06:14:47,215383.59,58107335.02
"6250",2017-12-26 06:14:47,-185601.91,57921733.11
"19573",2017-12-26 06:14:47,591596.64,58513329.75
"6251",2017-12-26 06:25:57,-700905.07,57812424.68
"19574",2017-12-26 06:54:52,-57812424.68,2.98023223876953e-08
"6252",2017-12-26 07:03:23,431030.37,431030.37000003
"6253",2017-12-26 07:14:38,-431030.37,2.98023223876953e-08
"19575",2017-12-26 07:29:34,326054.39,326054.39000003
"19576",2017-12-26 07:37:32,430706.57,756760.96000003
"19577",2017-12-26 07:37:32,-326054.39,430706.57000003
"6254",2017-12-26 07:50:52,306672.05,737378.62000003
"19578",2017-12-26 07:50:52,-430706.57,306672.05000003
"6255",2017-12-26 07:58:42,-306672.05,2.96859070658684e-08
"19579",2017-12-26 08:14:13,311287.97,311287.97000003
"19580",2017-12-26 08:21:50,234006.92,545294.89000003
"19581",2017-12-26 08:21:50,-311287.97,234006.92000003
"19582",2017-12-26 08:26:43,-234006.92,2.97150108963251e-08
"6256",2017-12-26 08:35:19,268316.71,268316.71000003
"6257",2017-12-26 08:44:35,-268316.71,2.97441147267818e-08
"6258",2017-12-26 10:03:03,246608.88,246608.88000003
"6259",2017-12-26 10:19:11,-246608.88,2.97441147267818e-08
"19583",2017-12-26 10:19:11,201089.7,201089.70000003
"19584",2017-12-26 10:31:08,-201089.7,2.97441147267818e-08
"19585",2017-12-26 10:54:43,197820.72,197820.72000003
"19586",2017-12-26 11:07:22,50639.75,248460.47000003
"19587",2017-12-26 11:07:22,-197820.72,50639.7500000297
"19588",2017-12-26 11:23:11,-50639.75,2.97441147267818e-08
"6260",2017-12-26 11:46:33,211520.1,211520.10000003
"6261",2017-12-26 11:50:35,-211520.1,2.97441147267818e-08
"19589",2017-12-26 12:43:33,211709.61,211709.61000003
"19590",2017-12-26 13:03:13,-211709.61,2.97441147267818e-08
"19591",2017-12-26 13:50:32,211954.65,211954.65000003
"19592",2017-12-26 14:31:47,196525.78,408480.43000003
"19593",2017-12-26 14:37:09,-211954.65,196525.78000003
"6262",2017-12-26 14:40:51,275850.62,472376.40000003
"6263",2017-12-26 14:40:51,348438.08,820814.48000003
"6264",2017-12-26 15:08:46,-624288.7,196525.78000003
"6265",2017-12-26 15:08:46,510180.11,706705.89000003
"6266",2017-12-26 15:21:13,-510180.11,196525.78000003
"6267",2017-12-26 15:39:11,534919.22,731445.00000003
"6268",2017-12-26 16:10:53,-534919.22,196525.78000003
"6269",2017-12-26 17:03:34,321529.17,518054.95000003
"6270",2017-12-26 17:26:35,268243.63,786298.58000003
"6271",2017-12-26 17:26:35,-321529.17,464769.41000003
"19594",2017-12-26 17:26:35,72097.22,536866.63000003
"6272",2017-12-26 17:35:34,-268243.63,268623.00000003
"19595",2017-12-26 17:48:28,656144.42,924767.42000003
"19596",2017-12-26 17:55:11,370372.2,1295139.62000003
"19597",2017-12-26 17:55:11,224842.48,1519982.10000003
"6273",2017-12-26 18:15:14,381222.57,1901204.67000003
"6274",2017-12-26 18:33:29,303897.45,2205102.12000003
"6275",2017-12-26 18:33:29,-381222.57,1823879.55000003
"6276",2017-12-26 18:42:41,-303897.45,1519982.10000003
"19598",2017-12-26 18:53:17,26217.69,1546199.79000003
"19599",2017-12-26 18:53:17,252798.71,1798998.50000003
"6277",2017-12-26 19:28:42,225842.27,2024840.77000003
"6278",2017-12-26 20:23:38,454923.15,2479763.92000003
"19600",2017-12-26 20:23:38,373177.49,2852941.41000003
"19601",2017-12-26 20:23:38,241094.57,3094035.98000003
"6279",2017-12-26 20:44:37,225312.16,3319348.14000003
"6280",2017-12-26 20:44:37,261685.81,3581033.95000003
"6281",2017-12-26 20:45:22,226072.23,3807106.18000003
"6282",2017-12-26 20:45:22,-225842.27,3581263.91000003
"6283",2017-12-26 21:00:37,-1167993.35,2413270.56000003
"6284",2017-12-26 21:03:05,193028.7,2606299.26000003
"6285",2017-12-26 21:15:14,-193028.7,2413270.56000003
"19602",2017-12-26 21:15:14,503449.52,2916720.08000003
"19603",2017-12-26 21:23:07,44554.96,2961275.04000003
"6286",2017-12-26 21:52:04,276709.64,3237984.68000003
"19604",2017-12-26 21:52:04,262506.1,3500490.78000003
"19605",2017-12-26 21:52:04,233468.43,3733959.21000003
"6287",2017-12-26 21:57:23,-276709.64,3457249.57000003
"19606",2017-12-26 22:10:54,261201.67,3718451.24000003
"19607",2017-12-26 22:10:54,266685.83,3985137.07000003
"6288",2017-12-26 22:56:48,317963.67,4303100.74000003
"19608",2017-12-26 23:31:50,326341.15,4629441.89000003
"19609",2017-12-26 23:31:50,337721.97,4967163.86000003
"6289",2017-12-26 23:36:43,-317963.67,4649200.19000003
"19610",2017-12-27 00:04:11,313634.03,4962834.22000003
"6290",2017-12-27 01:16:04,432794.14,5395628.36000003
"6291",2017-12-27 01:16:04,415498.29,5811126.65000003
"6292",2017-12-27 01:16:04,487885.49,6299012.14000003
"19611",2017-12-27 01:16:04,351054.24,6650066.38000003
"6293",2017-12-27 01:27:43,256009.7,6906076.08000003
"6294",2017-12-27 01:27:43,-1336177.92,5569898.16000003
"6295",2017-12-27 01:48:24,647898.23,6217796.39000003
"6296",2017-12-27 01:48:24,-256009.7,5961786.69000003
"6297",2017-12-27 01:59:37,-647898.23,5313888.46000003
"19612",2017-12-27 05:27:35,644417.21,5958305.67000003
"19613",2017-12-27 06:54:01,-5958305.67,3.07336449623108e-08
"19614",2017-12-27 07:09:39,631945.55,631945.550000031
"19615",2017-12-27 07:26:35,610786.23,1242731.78000003
"19616",2017-12-27 07:26:35,-631945.55,610786.230000031
"19617",2017-12-27 07:41:35,-610786.23,3.07336449623108e-08
"19618",2017-12-27 07:49:09,628902.33,628902.330000031
"19619",2017-12-27 08:00:56,-628902.33,3.07336449623108e-08
"19620",2017-12-27 08:00:56,605371.33,605371.330000031
"19621",2017-12-27 08:07:23,-605371.33,3.07336449623108e-08
"19622",2017-12-27 08:20:33,1259556.78,1259556.78000003
"19623",2017-12-27 09:35:42,777898.88,2037455.66000003
"19624",2017-12-27 09:35:42,312017.89,2349473.55000003
"19625",2017-12-27 10:16:20,111650.01,2461123.56000003
"19626",2017-12-27 10:27:04,777898.93,3239022.49000003
"19627",2017-12-27 10:27:04,39281.94,3278304.43000003
"6298",2017-12-27 10:34:56,777898.95,4056203.38000003
"6299",2017-12-27 10:34:56,76972.96,4133176.34000003
"19628",2017-12-27 10:38:11,64335.01,4197511.35000003
"6300",2017-12-27 10:50:56,72952.17,4270463.52000003
"6301",2017-12-27 10:50:56,-854871.91,3415591.61000003
"19629",2017-12-27 10:50:56,273352,3688943.61000003
"19630",2017-12-27 10:50:56,777898.99,4466842.60000003
"6302",2017-12-27 11:00:17,712271.04,5179113.64000003
"6303",2017-12-27 11:00:17,-72952.17,5106161.47000003
"6304",2017-12-27 11:05:51,-712271.04,4393890.43000003
"6305",2017-12-27 11:09:35,627101.17,5020991.60000003
"6306",2017-12-27 11:23:51,-627101.17,4393890.43000003
"19631",2017-12-27 11:23:51,640196.73,5034087.16000003
"6307",2017-12-27 11:43:29,645400.46,5679487.62000003
"6308",2017-12-27 11:43:29,32023.61,5711511.23000003
"6309",2017-12-27 11:48:07,-677424.07,5034087.16000003
"6310",2017-12-27 12:34:21,610271.57,5644358.73000003
"6311",2017-12-27 13:11:51,-610271.57,5034087.16000003
"19632",2017-12-27 14:17:37,448427.96,5482515.12000003
"19633",2017-12-27 14:18:32,551824.49,6034339.61000003
"19634",2017-12-27 14:21:19,777899.11,6812238.72000003
"19635",2017-12-27 14:21:19,29618.12,6841856.84000003
"6312",2017-12-27 14:35:14,462880.5,7304737.34000003
"6313",2017-12-27 14:35:14,23211.44,7327948.78000003
"19636",2017-12-27 14:35:14,427237.58,7755186.36000003
"6314",2017-12-27 14:42:43,-486091.94,7269094.42000003
"19637",2017-12-27 14:56:17,433258.32,7702352.74000003
"19638",2017-12-27 15:02:36,777899.18,8480251.92000003
"19639",2017-12-27 15:02:36,192035.19,8672287.11000003
"6315",2017-12-27 15:19:30,777899.2,9450186.31000003
"6316",2017-12-27 15:19:30,479536.58,9929722.89000003
"6317",2017-12-27 15:19:30,652843.21,10582566.1
"6318",2017-12-27 15:31:48,-1910278.99,8672287.11000003
"19640",2017-12-27 15:31:48,553199.85,9225486.96000003
"6319",2017-12-27 15:49:52,951948.42,10177435.38
"6320",2017-12-27 16:05:56,-951948.42,9225486.96000003
"6321",2017-12-27 16:29:06,513982.63,9739469.59000003
"6322",2017-12-27 16:44:44,661822.21,10401291.8
"6323",2017-12-27 16:44:44,38402.16,10439693.96
"6324",2017-12-27 16:44:44,-513982.63,9925711.33000003
"6325",2017-12-27 17:27:11,328924.24,10254635.57
"6326",2017-12-27 17:27:11,327479.15,10582114.72
"19641",2017-12-27 17:27:11,283952.59,10866067.31
"19642",2017-12-27 17:27:11,325391.28,11191458.59
"6327",2017-12-27 17:39:51,-700224.37,10491234.22
"19643",2017-12-27 17:39:51,456284.7,10947518.92
"6328",2017-12-27 18:09:51,327917.75,11275436.67
"6329",2017-12-27 18:09:51,517250.45,11792687.12
"6330",2017-12-27 18:09:51,-656403.39,11136283.73
"19644",2017-12-27 18:09:51,291487.08,11427770.81
"6331",2017-12-27 18:30:53,-845168.2,10582602.61
"19645",2017-12-27 18:48:24,334138.75,10916741.36
"6332",2017-12-27 18:58:11,353185.01,11269926.37
"6333",2017-12-27 19:08:01,-353185.01,10916741.36
"19646",2017-12-27 19:08:01,292545.85,11209287.21
"6334",2017-12-27 19:10:02,774631.55,11983918.76
"6335",2017-12-27 19:15:57,-774631.55,11209287.21
"19647",2017-12-27 19:18:32,452151.67,11661438.88
"6336",2017-12-27 19:39:38,600048.95,12261487.83
"6337",2017-12-27 19:39:38,381529.54,12643017.37
"6338",2017-12-27 19:47:59,-981578.49,11661438.88
"6339",2017-12-27 22:23:09,777899.57,12439338.45
"6340",2017-12-27 22:23:09,777899.54,13217237.99
"19648",2017-12-27 22:23:09,777899.61,13995137.6
"19649",2017-12-27 22:23:09,777899.6,14773037.2
"19650",2017-12-27 22:23:09,777899.59,15550936.79
"19651",2017-12-27 22:23:09,777899.62,16328836.41
"19652",2017-12-27 22:23:09,75247.63,16404084.04
"6341",2017-12-27 22:26:16,777899.53,17181983.57
"6342",2017-12-27 22:26:16,777899.55,17959883.12
"6343",2017-12-27 22:26:16,777899.56,18737782.68
"6344",2017-12-27 22:35:18,67950.58,18805733.26
"6345",2017-12-27 22:35:18,-1555799.11,17249934.15
"6346",2017-12-27 22:46:56,825899.18,18075833.33
"6347",2017-12-27 22:46:56,-2401649.22,15674184.11
"6348",2017-12-27 23:13:35,-825899.18,14848284.93
"19653",2017-12-28 01:10:46,111617.33,14959902.26
"6349",2017-12-28 03:16:31,111161.61,15071063.87
"19654",2017-12-28 03:16:31,23109.24,15094173.11
"6350",2017-12-28 03:25:09,110062.85,15204235.96
"6351",2017-12-28 03:25:09,-111161.61,15093074.35
"6352",2017-12-28 03:32:07,180913.88,15273988.23
"6353",2017-12-28 03:32:07,777899.87,16051888.1
"6354",2017-12-28 03:32:07,352977.12,16404865.22
"6355",2017-12-28 03:32:07,777899.84,17182765.06
"6356",2017-12-28 03:37:03,-110062.85,17072702.21
"6357",2017-12-28 03:51:12,252191.91,17324894.12
"6358",2017-12-28 03:51:12,777899.9,18102794.02
"6359",2017-12-28 03:51:12,24824.09,18127618.11
"6360",2017-12-28 03:51:12,-2089690.71,16037927.4
"19655",2017-12-28 03:51:12,358580.75,16396508.15
"19656",2017-12-28 03:51:12,761614.29,17158122.44
"6361",2017-12-28 04:01:23,-1054915.9,16103206.54
"19657",2017-12-28 04:22:28,673782.47,16776989.01
"19658",2017-12-28 04:22:28,534672.92,17311661.93
"6362",2017-12-28 04:29:53,659889.17,17971551.1
"6363",2017-12-28 04:29:53,60333.88,18031884.98
"6364",2017-12-28 04:56:43,-720223.05,17311661.93
"19659",2017-12-28 04:56:43,470065.98,17781727.91
"19660",2017-12-28 04:56:43,478914.02,18260641.93
"19661",2017-12-28 05:08:27,609894.26,18870536.19
"6365",2017-12-28 05:14:54,777900.03,19648436.22
"6366",2017-12-28 05:14:54,661119.83,20309556.05
"6367",2017-12-28 05:14:54,34053.04,20343609.09
"6368",2017-12-28 05:22:30,-1473072.9,18870536.19
"6369",2017-12-28 05:56:06,758185.04,19628721.23
"6370",2017-12-28 05:59:17,-758185.04,18870536.19
"19662",2017-12-28 06:52:21,281304.58,19151840.77
"19663",2017-12-28 07:23:04,276613.01,19428453.78
"6371",2017-12-28 07:45:30,358830.32,19787284.1
"6372",2017-12-28 07:57:21,46793.94,19834078.04
"6373",2017-12-28 07:57:21,-358830.32,19475247.72
"6374",2017-12-28 08:11:05,-46793.94,19428453.78
"19664",2017-12-28 09:28:06,348360.81,19776814.59
"19665",2017-12-28 09:57:58,465998.62,20242813.21
"6375",2017-12-28 10:33:39,421941.57,20664754.78
"6376",2017-12-28 10:43:33,-421941.57,20242813.21
"19666",2017-12-28 11:09:15,353044.56,20595857.77
"19667",2017-12-28 11:27:04,380240.98,20976098.75
"19668",2017-12-28 12:22:24,326267.81,21302366.56
"19669",2017-12-28 12:45:56,385430.75,21687797.31
"19670",2017-12-28 12:45:56,340395.8,22028193.11
"19671",2017-12-28 13:21:14,322606.81,22350799.92
"6377",2017-12-28 14:52:30,353384.2,22704184.12
"19672",2017-12-28 14:52:30,318155.63,23022339.75
"19673",2017-12-28 14:52:30,595002.26,23617342.01
"19674",2017-12-28 14:52:30,317511.77,23934853.78
"6378",2017-12-28 15:00:44,355079.06,24289932.84
"6379",2017-12-28 15:00:44,-353384.2,23936548.64
"6380",2017-12-28 15:13:36,407079.23,24343627.87
"6381",2017-12-28 15:13:36,324106.67,24667734.54
"6382",2017-12-28 15:13:36,31249.41,24698983.95
"6383",2017-12-28 15:13:36,-355079.06,24343904.89
"19675",2017-12-28 15:13:36,698984.42,25042889.31
"6384",2017-12-28 15:26:23,-762435.31,24280454
"19676",2017-12-28 15:26:23,687267.82,24967721.82
"6385",2017-12-28 15:40:02,589271.26,25556993.08
"6386",2017-12-28 15:47:16,-589271.26,24967721.82
"6387",2017-12-28 16:37:11,188152.98,25155874.8
"6388",2017-12-28 16:41:09,-188152.98,24967721.82
"6389",2017-12-28 16:59:49,285816.58,25253538.4
"6390",2017-12-28 16:59:49,183587.63,25437126.03
"6391",2017-12-28 17:09:24,-469404.21,24967721.82
"6392",2017-12-28 18:39:49,114724.12,25082445.94
"6393",2017-12-28 18:49:46,-114724.12,24967721.82
"19677",2017-12-28 19:31:14,395936.68,25363658.5
"19678",2017-12-28 20:13:53,283450.16,25647108.66
"6394",2017-12-28 20:15:36,178985.44,25826094.1
"6395",2017-12-28 20:44:15,-178985.44,25647108.66
"19679",2017-12-28 20:44:15,220237.32,25867345.98
"19680",2017-12-28 20:48:47,193689.93,26061035.91
"19681",2017-12-28 22:13:10,90467.5,26151503.41
"6396",2017-12-28 22:31:54,86763.31,26238266.72
"6397",2017-12-28 22:31:54,311431.77,26549698.49
"19682",2017-12-28 22:31:54,261624.07,26811322.56
"6398",2017-12-28 22:46:28,-398195.08,26413127.48
"6399",2017-12-28 23:00:55,155103.76,26568231.24
"6400",2017-12-28 23:02:58,-155103.76,26413127.48
"19683",2017-12-28 23:34:30,191840.39,26604967.87
"6401",2017-12-29 00:04:46,416914.94,27021882.81
"6402",2017-12-29 00:04:46,249166.39,27271049.2
"19684",2017-12-29 00:04:46,192024.75,27463073.95
"19685",2017-12-29 00:04:46,664139.3,28127213.25
"6403",2017-12-29 00:25:22,-666081.33,27461131.92
"19686",2017-12-29 00:25:22,239420.05,27700551.97
"19687",2017-12-29 01:05:29,221794.44,27922346.41
"19688",2017-12-29 01:05:29,243347.71,28165694.12
"6404",2017-12-29 01:16:54,274644,28440338.12
"6405",2017-12-29 01:26:35,-274644,28165694.12
"19689",2017-12-29 01:26:35,323433.77,28489127.89
"19690",2017-12-29 01:59:53,264978.36,28754106.25
"6406",2017-12-29 02:00:26,506742.58,29260848.83
"6407",2017-12-29 02:03:40,-506742.58,28754106.25
"6408",2017-12-29 02:25:55,239912.43,28994018.68
"6409",2017-12-29 02:25:55,355697.47,29349716.15
"6410",2017-12-29 02:25:55,237203.62,29586919.77
"19691",2017-12-29 02:25:55,310179.78,29897099.55
"19692",2017-12-29 02:25:55,273470.02,30170569.57
"19693",2017-12-29 02:25:55,484702.35,30655271.92
"6411",2017-12-29 02:31:12,-832813.52,29822458.4
"6412",2017-12-29 02:54:54,549210.89,30371669.29
"6413",2017-12-29 02:54:54,283362.86,30655032.15
"19694",2017-12-29 02:54:54,310989.19,30966021.34
"6414",2017-12-29 03:05:53,-832573.75,30133447.59
"6415",2017-12-29 03:18:05,356446.84,30489894.43
"6416",2017-12-29 03:36:00,295465.31,30785359.74
"6417",2017-12-29 03:36:00,-356446.84,30428912.9
"19695",2017-12-29 03:36:00,275940.4,30704853.3
"19696",2017-12-29 03:36:00,54153.11,30759006.41
"19697",2017-12-29 03:41:19,324975.38,31083981.79
"6418",2017-12-29 04:07:43,456693.79,31540675.58
"6419",2017-12-29 04:07:43,-295465.31,31245210.27
"19698",2017-12-29 04:07:43,234698.96,31479909.23
"6420",2017-12-29 04:13:52,-456693.79,31023215.44
"19699",2017-12-29 04:15:58,295189.33,31318404.77
"19700",2017-12-29 04:20:11,363039.35,31681444.12
"6421",2017-12-29 04:39:27,458786.97,32140231.09
"6422",2017-12-29 04:42:06,-458786.97,31681444.12
"6423",2017-12-29 05:04:58,395862.4,32077306.52
"19701",2017-12-29 05:04:58,308581.18,32385887.7
"19702",2017-12-29 05:04:58,293879.91,32679767.61
"19703",2017-12-29 05:04:58,22554.97,32702322.58
"19704",2017-12-29 05:04:58,-31681444.12,1020878.46000003
"6424",2017-12-29 05:12:29,284206.58,1305085.04000003
"6425",2017-12-29 05:12:29,-395862.4,909222.640000027
"19705",2017-12-29 05:12:29,-625016.06,284206.580000027
"6426",2017-12-29 05:19:20,-284206.58,2.69501470029354e-08
"19706",2017-12-29 05:34:50,337648.39,337648.390000027
"6427",2017-12-29 05:58:49,777901.3,1115549.69000003
"6428",2017-12-29 05:58:49,397546.02,1513095.71000003
"6429",2017-12-29 05:58:49,208314.31,1721410.02000003
"19707",2017-12-29 05:58:49,308285.67,2029695.69000003
"19708",2017-12-29 05:58:49,299492.47,2329188.16000003
"19709",2017-12-29 05:58:49,316107.62,2645295.78000003
"19710",2017-12-29 05:58:49,-337648.39,2307647.39000003
"6430",2017-12-29 06:15:41,-1383761.63,923885.760000027
"19711",2017-12-29 06:15:41,732944.96,1656830.72000003
"19712",2017-12-29 06:15:41,-923885.76,732944.960000027
"19713",2017-12-29 06:22:30,395088.72,1128033.68000003
"19714",2017-12-29 06:22:30,-732944.96,395088.720000027
"19715",2017-12-29 06:26:27,-395088.72,2.72411853075027e-08
"6431",2017-12-29 07:11:21,453690.24,453690.240000027
"6432",2017-12-29 07:11:21,370396.12,824086.360000027
"6433",2017-12-29 07:11:21,354140.83,1178227.19000003
"19716",2017-12-29 07:11:21,375838.52,1554065.71000003
"6434",2017-12-29 07:19:22,-1178227.19,375838.520000027
"6435",2017-12-29 07:48:46,308675.3,684513.820000027
"19717",2017-12-29 07:48:46,407642.99,1092156.81000003
"6436",2017-12-29 07:56:36,286152.49,1378309.30000003
"6437",2017-12-29 07:56:36,-308675.3,1069634.00000003
"6438",2017-12-29 08:10:32,-286152.49,783481.510000027
"6439",2017-12-29 08:16:00,320290.15,1103771.66000003
"6440",2017-12-29 08:16:00,590738.58,1694510.24000003
"6441",2017-12-29 08:26:56,-911028.73,783481.510000027
"19718",2017-12-29 08:26:56,391645.68,1175127.19000003
"19719",2017-12-29 08:53:05,387219.89,1562347.08000003
"6442",2017-12-29 09:50:51,333473.48,1895820.56000003
"6443",2017-12-29 09:50:51,347410.1,2243230.66000003
"6444",2017-12-29 10:16:42,-680883.58,1562347.08000003
"19720",2017-12-29 10:57:22,182061.21,1744408.29000003
"19721",2017-12-29 11:03:09,149149.97,1893558.26000003
"6445",2017-12-29 11:06:31,355223.08,2248781.34000003
"19722",2017-12-29 11:06:31,543604.66,2792386.00000003
"6446",2017-12-29 11:16:49,-355223.08,2437162.92000003
"19723",2017-12-29 11:16:49,320908.41,2758071.33000003
"19724",2017-12-29 11:36:19,193509.68,2951581.01000003
"19725",2017-12-29 11:54:07,288548.51,3240129.52000003
"19726",2017-12-29 12:12:49,210917.86,3451047.38000003
"19727",2017-12-29 12:12:49,325272.41,3776319.79000003
"19728",2017-12-29 12:29:22,545807.8,4322127.59000003
"6447",2017-12-29 12:39:32,178661.41,4500789.00000003
"19729",2017-12-29 12:42:21,58843.15,4559632.15000003
"6448",2017-12-29 13:09:47,-178661.41,4380970.74000003
"19730",2017-12-29 13:09:47,269280.63,4650251.37000003
"19731",2017-12-29 13:29:56,194440.72,4844692.09000003
"6449",2017-12-29 13:54:21,302350.49,5147042.58000003
"19732",2017-12-29 13:54:21,176556.87,5323599.45000003
"19733",2017-12-29 13:57:48,306316.04,5629915.49000003
"6450",2017-12-29 14:13:33,131781.85,5761697.34000003
"6451",2017-12-29 14:13:33,-302350.49,5459346.85000003
"19734",2017-12-29 14:13:33,191046.78,5650393.63000003
"19735",2017-12-29 14:13:33,195176.39,5845570.02000003
"6452",2017-12-29 14:25:01,-131781.85,5713788.17000003
"6453",2017-12-29 14:38:49,48603.13,5762391.30000003
"6454",2017-12-29 14:59:08,183651.7,5946043.00000003
"6455",2017-12-29 14:59:08,-48603.13,5897439.87000003
"6456",2017-12-29 15:06:24,-183651.7,5713788.17000003
"19736",2017-12-29 15:42:32,210183.43,5923971.60000003
"19737",2017-12-29 17:34:47,150116.45,6074088.05000003
"6457",2017-12-29 17:48:21,397655.56,6471743.61000003
"6458",2017-12-29 17:48:21,777903.55,7249647.16000003
"19738",2017-12-29 17:48:21,693040.71,7942687.87000003
"6459",2017-12-29 17:53:59,-1175559.11,6767128.76000003
"19739",2017-12-29 18:07:32,401736.47,7168865.23000003
"19740",2017-12-29 18:09:57,446723.5,7615588.73000003
"6460",2017-12-29 18:17:44,52544.98,7668133.71000003
"19741",2017-12-29 18:17:44,271922.34,7940056.05000003
"6461",2017-12-29 18:32:08,665113.34,8605169.39000003
"6462",2017-12-29 18:32:08,257698.72,8862868.11000003
"6463",2017-12-29 18:32:08,-52544.98,8810323.13000003
"19742",2017-12-29 18:32:08,300126.66,9110449.79000003
"19743",2017-12-29 18:32:08,401783.09,9512232.88000003
"19744",2017-12-29 18:32:08,14515.88,9526748.76000003
"6464",2017-12-29 18:39:56,-922812.06,8603936.70000003
"19745",2017-12-29 18:54:54,336492.54,8940429.24000003
"19746",2017-12-29 18:54:54,624382.65,9564811.89000003
"19747",2017-12-29 19:17:52,445727.97,10010539.86
"19748",2017-12-29 19:17:52,639963.84,10650503.7
"6465",2017-12-29 19:24:07,267683.75,10918187.45
"6466",2017-12-29 19:33:26,280651.54,11198838.99
"6467",2017-12-29 19:33:26,-267683.75,10931155.24
"6468",2017-12-29 20:05:13,250291.16,11181446.4
"6469",2017-12-29 20:05:13,-280651.54,10900794.86
"19749",2017-12-29 20:05:13,268161.79,11168956.65
"19750",2017-12-29 20:05:13,228012.64,11396969.29
"19751",2017-12-29 20:05:13,494608.44,11891577.73
"6470",2017-12-29 20:11:06,-250291.16,11641286.57
"19752",2017-12-29 20:28:00,316524.34,11957810.91
"19753",2017-12-29 20:28:00,87648.09,12045459
"6471",2017-12-29 20:28:57,306306.78,12351765.78
"6472",2017-12-29 20:36:50,-306306.78,12045459
"19754",2017-12-29 20:58:18,206461.31,12251920.31
"19755",2017-12-29 21:03:36,541724.39,12793644.7
"6473",2017-12-29 21:09:37,411407.79,13205052.49
"6474",2017-12-29 21:14:31,458269.41,13663321.9
"6475",2017-12-29 21:14:31,-411407.79,13251914.11
"6476",2017-12-29 21:28:32,-458269.41,12793644.7
"19756",2017-12-29 21:28:32,690499.9,13484144.6
"19757",2017-12-29 21:54:31,496602.56,13980747.16
"6477",2017-12-29 22:15:20,767994.06,14748741.22
"6478",2017-12-29 22:19:55,-767994.06,13980747.16
"19758",2017-12-29 22:19:55,405730.46,14386477.62
"6479",2017-12-29 22:57:02,315046.96,14701524.58
"19759",2017-12-29 22:57:02,234574.98,14936099.56
"6480",2017-12-29 23:06:20,-315046.96,14621052.6
"19760",2017-12-29 23:32:02,343101.73,14964154.33
"19761",2017-12-29 23:32:02,396191.01,15360345.34
"6481",2017-12-30 00:04:20,329752.04,15690097.38
"19762",2017-12-30 00:04:20,551176.54,16241273.92
"6482",2017-12-30 00:10:49,-329752.04,15911521.88
"19763",2017-12-30 00:31:49,440149.53,16351671.41
"19764",2017-12-30 00:31:49,366359.62,16718031.03
"6483",2017-12-30 00:34:08,572451.56,17290482.59
"6484",2017-12-30 00:52:43,-572451.56,16718031.03
"19765",2017-12-30 00:52:43,312034.8,17030065.83
"6485",2017-12-30 01:09:23,589999.3,17620065.13
"19766",2017-12-30 01:09:23,381092.32,18001157.45
"6486",2017-12-30 01:12:19,-589999.3,17411158.15
"19767",2017-12-30 01:12:19,332926.2,17744084.35
"6487",2017-12-30 01:20:36,314504.54,18058588.89
"6488",2017-12-30 01:33:10,-314504.54,17744084.35
"19768",2017-12-30 01:58:16,291593.85,18035678.2
"19769",2017-12-30 02:02:02,667260.2,18702938.4
"6489",2017-12-30 02:43:54,425141.45,19128079.85
"19770",2017-12-30 02:43:54,225670.06,19353749.91
"6490",2017-12-30 02:47:58,-425141.45,18928608.46
"19771",2017-12-30 02:56:58,561768.24,19490376.7
"19772",2017-12-30 03:17:18,602271.78,20092648.48
"19773",2017-12-30 03:41:39,327533.59,20420182.07
"19774",2017-12-30 03:41:39,454068.93,20874251
"19775",2017-12-30 03:56:53,36540.46,20910791.46
"19776",2017-12-30 03:56:53,287189.04,21197980.5
"19777",2017-12-30 04:30:54,191713.15,21389693.65
"6491",2017-12-30 04:56:30,62808.12,21452501.77
"19778",2017-12-30 04:56:30,246299.65,21698801.42
"19779",2017-12-30 04:56:30,405991.3,22104792.72
"19780",2017-12-30 04:56:30,247159.99,22351952.71
"6492",2017-12-30 05:41:15,-62808.12,22289144.59
"19781",2017-12-30 05:41:15,280891.76,22570036.35
"19782",2017-12-30 05:41:15,260598.87,22830635.22
"19783",2017-12-30 06:13:55,28426.95,22859062.17
"19784",2017-12-30 06:13:55,407205.9,23266268.07
"19785",2017-12-30 06:13:55,599121.23,23865389.3
"19786",2017-12-30 06:29:06,406570.46,24271959.76
"19787",2017-12-30 06:29:06,501560.92,24773520.68
"19788",2017-12-30 06:49:47,236128.38,25009649.06
"6493",2017-12-30 06:56:44,27652.67,25037301.73
"6494",2017-12-30 07:03:50,-27652.67,25009649.06
"19789",2017-12-30 07:25:27,213565.62,25223214.68
"19790",2017-12-30 07:25:27,563293.97,25786508.65
"19791",2017-12-30 07:48:19,253018.62,26039527.27
"19792",2017-12-30 07:48:19,235528.54,26275055.81
"19793",2017-12-30 08:23:44,322176.96,26597232.77
"6495",2017-12-30 08:37:12,259623.43,26856856.2
"6496",2017-12-30 08:44:40,-259623.43,26597232.77
"19794",2017-12-30 09:13:00,-26597232.77,2.23517417907715e-08
"6497",2017-12-30 10:02:07,218611.56,218611.560000022
"6498",2017-12-30 10:10:55,300128.06,518739.620000022
"6499",2017-12-30 10:10:55,-218611.56,300128.060000022
"19795",2017-12-30 10:10:55,296285.63,596413.690000022
"6500",2017-12-30 10:23:14,298782.71,895196.400000022
"6501",2017-12-30 10:23:14,-300128.06,595068.340000022
"19796",2017-12-30 10:23:14,-296285.63,298782.710000022
"19797",2017-12-30 10:25:39,284838.36,583621.070000022
"6502",2017-12-30 10:32:34,501620.87,1085241.94000002
"19798",2017-12-30 10:32:34,404786.23,1490028.17000002
"19799",2017-12-30 10:32:34,-284838.36,1205189.81000002
"6503",2017-12-30 10:36:50,-298782.71,906407.100000022
"19800",2017-12-30 10:36:50,379618.15,1286025.25000002
"19801",2017-12-30 10:39:18,-784404.38,501620.870000022
"6504",2017-12-30 10:42:33,-501620.87,2.23517417907715e-08
"6505",2017-12-30 11:19:49,403792.39,403792.390000022
"19802",2017-12-30 11:19:49,512416.3,916208.690000022
"6506",2017-12-30 11:31:29,245441.66,1161650.35000002
"6507",2017-12-30 11:31:29,-403792.39,757857.960000022
"19803",2017-12-30 11:31:29,-512416.3,245441.660000022
"6508",2017-12-30 11:47:47,-245441.66,2.22062226384878e-08
"19804",2017-12-30 12:32:51,346943.83,346943.830000022
"19805",2017-12-30 12:32:51,331315.71,678259.540000022
"19806",2017-12-30 12:32:51,256735.85,934995.390000022
"19807",2017-12-30 13:06:03,626069.3,1561064.69000002
"19808",2017-12-30 13:31:04,344547.41,1905612.10000002
"19809",2017-12-30 13:31:04,317591.38,2223203.48000002
"19810",2017-12-30 13:47:11,245224.01,2468427.49000002
"19811",2017-12-30 14:12:24,300128.37,2768555.86000002
"19812",2017-12-30 14:12:24,233357.96,3001913.82000002
"6509",2017-12-30 14:40:55,272654.23,3274568.05000002
"19813",2017-12-30 14:40:55,404374.56,3678942.61000002
"19814",2017-12-30 14:40:55,319247.54,3998190.15000002
"6510",2017-12-30 15:02:10,-272654.23,3725535.92000002
"19815",2017-12-30 15:02:10,318772.06,4044307.98000002
"19816",2017-12-30 15:02:10,251993.59,4296301.57000002
"6511",2017-12-30 15:18:12,474326.16,4770627.73000002
"19817",2017-12-30 15:18:12,413480.12,5184107.85000002
"6512",2017-12-30 15:22:10,-474326.16,4709781.69000002
"19818",2017-12-30 16:23:30,26086.59,4735868.28000002
"6513",2017-12-30 16:28:51,28134.59,4764002.87000002
"19819",2017-12-30 16:28:51,405268.74,5169271.61000002
"6514",2017-12-30 16:30:54,446901.63,5616173.24000002
"6515",2017-12-30 16:34:06,-28134.59,5588038.65000002
"19820",2017-12-30 16:34:06,305543.44,5893582.09000002
"6516",2017-12-30 16:36:43,279338.29,6172920.38000002
"6517",2017-12-30 17:04:49,256517.45,6429437.83000002
"6518",2017-12-30 17:04:49,-726239.92,5703197.91000002
"6519",2017-12-30 17:16:51,-256517.45,5446680.46000002
"19821",2017-12-30 17:16:51,275815.15,5722495.61000002
"19822",2017-12-30 17:16:51,268235.36,5990730.97000002
"19823",2017-12-30 17:23:09,265863.9,6256594.87000002
"6520",2017-12-30 18:13:58,328766.33,6585361.20000002
"19824",2017-12-30 18:13:58,233387.79,6818748.99000002
"19825",2017-12-30 18:13:58,489352.05,7308101.04000002
"6521",2017-12-30 18:26:00,467404.5,7775505.54000002
"6522",2017-12-30 18:26:00,252589.37,8028094.91000002
"6523",2017-12-30 18:26:00,-328766.33,7699328.58000002
"19826",2017-12-30 18:34:35,305628.57,8004957.15000002
"6524",2017-12-30 19:08:04,-719993.87,7284963.28000002
"19827",2017-12-30 19:08:04,416793.35,7701756.63000002
"19828",2017-12-30 19:08:04,343200.83,8044957.46000002
"19829",2017-12-30 19:29:15,348458.26,8393415.72000002
"19830",2017-12-30 19:41:56,309174.58,8702590.30000002
"19831",2017-12-30 19:41:56,330148.68,9032738.98000002
"19832",2017-12-30 20:11:10,271804.77,9304543.75000002
"19833",2017-12-30 20:11:10,340054.29,9644598.04000002
"19834",2017-12-30 20:11:10,235582.85,9880180.89000002
"19835",2017-12-30 20:30:31,411237.16,10291418.05
"6525",2017-12-30 20:34:41,300128.86,10591546.91
"6526",2017-12-30 21:01:49,-300128.86,10291418.05
"19836",2017-12-30 21:01:49,420676.73,10712094.78
"6527",2017-12-30 21:14:33,493918.96,11206013.74
"19837",2017-12-30 21:14:33,200128.89,11406142.63
"6528",2017-12-30 21:22:16,-493918.96,10912223.67
"19838",2017-12-30 21:50:02,285558.96,11197782.63
"6529",2017-12-30 22:07:18,66827.27,11264609.9
"6530",2017-12-30 22:20:44,-66827.27,11197782.63
"6531",2017-12-30 22:47:24,332855.88,11530638.51
"6532",2017-12-30 22:47:24,353700.63,11884339.14
"19839",2017-12-30 22:47:24,359342.12,12243681.26
"19840",2017-12-30 22:47:24,311826.44,12555507.7
"6533",2017-12-30 23:14:37,200129.03,12755636.73
"6534",2017-12-30 23:14:37,-686556.51,12069080.22
"6535",2017-12-30 23:23:03,-200129.03,11868951.19
"19841",2017-12-30 23:26:46,464858.62,12333809.81
"6536",2017-12-31 00:08:05,363917.34,12697727.15
"6537",2017-12-31 00:14:29,-363917.34,12333809.81
"6538",2017-12-31 00:20:54,264169.15,12597978.96
"6539",2017-12-31 00:27:19,-264169.15,12333809.81
"6540",2017-12-31 00:52:15,467669.99,12801479.8
"19842",2017-12-31 00:52:15,275851.01,13077330.81
"19843",2017-12-31 00:52:15,276824.94,13354155.75
"6541",2017-12-31 00:57:21,-467669.99,12886485.76
"19844",2017-12-31 01:28:38,295276.58,13181762.34
"19845",2017-12-31 01:28:38,414016.91,13595779.25
"6542",2017-12-31 01:51:27,281334.52,13877113.77
"6543",2017-12-31 01:55:31,-281334.52,13595779.25
"19846",2017-12-31 02:07:54,362444.83,13958224.08
"19847",2017-12-31 02:26:39,541093.59,14499317.67
"19848",2017-12-31 02:47:35,437474.4,14936792.07
"19849",2017-12-31 02:47:35,500739.59,15437531.66
"19850",2017-12-31 02:56:35,337636.26,15775167.92
"19851",2017-12-31 03:04:31,549084.38,16324252.3
"19852",2017-12-31 03:04:31,343055.46,16667307.76
"19853",2017-12-31 03:32:22,305449.26,16972757.02
"19854",2017-12-31 03:32:22,442819.49,17415576.51
"6544",2017-12-31 03:43:34,497953.88,17913530.39
"6545",2017-12-31 03:52:54,-497953.88,17415576.51
"19855",2017-12-31 04:34:25,263875.41,17679451.92
"6546",2017-12-31 04:49:01,339113.58,18018565.5
"6547",2017-12-31 04:53:25,235946.98,18254512.48
"6548",2017-12-31 04:53:25,-339113.58,17915398.9
"6549",2017-12-31 05:06:08,434682.33,18350081.23
"6550",2017-12-31 05:06:08,-235946.98,18114134.25
"6551",2017-12-31 05:12:49,-434682.33,17679451.92
"19856",2017-12-31 05:30:49,306229.92,17985681.84
"6552",2017-12-31 05:46:24,337384.61,18323066.45
"6553",2017-12-31 05:51:16,-337384.61,17985681.84
"19857",2017-12-31 06:52:33,342115.89,18327797.73
"19858",2017-12-31 07:09:58,384513.42,18712311.15
"6554",2017-12-31 07:26:32,398492.96,19110804.11
"6555",2017-12-31 07:52:52,-398492.96,18712311.15
"19859",2017-12-31 09:11:12,378698,19091009.15
"6556",2017-12-31 09:51:19,378445.66,19469454.81
"6557",2017-12-31 10:09:42,-378445.66,19091009.15
"6558",2017-12-31 10:50:40,275618.88,19366628.03
"6559",2017-12-31 10:50:40,410375.13,19777003.16
"6560",2017-12-31 11:02:05,-685994.01,19091009.15
"19860",2017-12-31 11:33:25,391284.35,19482293.5
"6561",2017-12-31 11:50:12,320580.83,19802874.33
"6562",2017-12-31 12:12:38,418320.87,20221195.2
"6563",2017-12-31 12:12:38,-320580.83,19900614.37
"6564",2017-12-31 12:23:25,-418320.87,19482293.5
"19861",2017-12-31 12:23:25,250325.53,19732619.03
"6565",2017-12-31 12:32:38,709554.67,20442173.7
"19862",2017-12-31 12:32:38,586958.88,21029132.58
"19863",2017-12-31 12:32:38,473439.41,21502571.99
"6566",2017-12-31 12:36:40,-709554.67,20793017.32
"19864",2017-12-31 13:33:42,343794.27,21136811.59
"6567",2017-12-31 14:49:56,200129.75,21336941.34
"6568",2017-12-31 14:49:56,380912.37,21717853.71
"6569",2017-12-31 14:49:56,358222.54,22076076.25
"6570",2017-12-31 14:52:19,397390.4,22473466.65
"6571",2017-12-31 14:58:48,-939264.66,21534201.99
"6572",2017-12-31 15:39:56,619867.78,22154069.77
"6573",2017-12-31 15:39:56,356789.57,22510859.34
"6574",2017-12-31 15:39:56,-397390.4,22113468.94
"6575",2017-12-31 15:55:04,517658.58,22631127.52
"6576",2017-12-31 15:55:04,-976657.35,21654470.17
"6577",2017-12-31 16:03:38,-517658.58,21136811.59
"19865",2017-12-31 16:03:38,37592.56,21174404.15
"6578",2017-12-31 16:09:47,777906.86,21952311.01
"6579",2017-12-31 16:22:44,232603.89,22184914.9
"6580",2017-12-31 16:22:44,40696.87,22225611.77
"6581",2017-12-31 16:22:44,777906.88,23003518.65
"6582",2017-12-31 16:22:44,-777906.86,22225611.79
"19866",2017-12-31 16:22:44,530405.75,22756017.54
"19867",2017-12-31 16:22:44,471738.19,23227755.73
"6583",2017-12-31 16:30:42,-1051207.64,22176548.09
"6584",2017-12-31 16:43:02,546692.65,22723240.74
"6585",2017-12-31 16:45:22,-546692.65,22176548.09
"6586",2017-12-31 16:53:49,497627.06,22674175.15
"6587",2017-12-31 17:03:51,-497627.06,22176548.09
"19868",2017-12-31 17:34:06,599760.64,22776308.73
"6588",2017-12-31 18:02:28,496299.65,23272608.38
"6589",2017-12-31 18:02:28,371604.02,23644212.4
"6590",2017-12-31 18:10:03,-867903.67,22776308.73
"6591",2017-12-31 18:35:13,34706.83,22811015.56
"6592",2017-12-31 18:53:15,-34706.83,22776308.73
"19869",2017-12-31 18:53:15,338373.9,23114682.63
"19870",2017-12-31 18:53:15,405080.05,23519762.68
"6593",2017-12-31 19:26:46,423194.5,23942957.18
"6594",2017-12-31 19:42:45,-423194.5,23519762.68
"6595",2017-12-31 19:53:56,55662.31,23575424.99
"6596",2017-12-31 20:08:28,390452.22,23965877.21
"6597",2017-12-31 20:08:28,-55662.31,23910214.9
"6598",2017-12-31 20:16:44,-390452.22,23519762.68
"19871",2017-12-31 20:50:39,428620.84,23948383.52
"19872",2017-12-31 20:50:39,34163.52,23982547.04
"19873",2017-12-31 21:41:43,538372.21,24520919.25
"19874",2017-12-31 21:47:32,302156.77,24823076.02
"19875",2017-12-31 22:57:33,400883.61,25223959.63
"6599",2017-12-31 23:40:56,383900.76,25607860.39
"6600",2017-12-31 23:43:42,-383900.76,25223959.63
"6601",2018-01-01 00:33:42,399509.98,25623469.61
"6602",2018-01-01 00:41:38,-399509.98,25223959.63
"19876",2018-01-01 01:02:03,533333.87,25757293.5
"6603",2018-01-01 01:21:28,471648.41,26228941.91
"6604",2018-01-01 01:44:42,-471648.41,25757293.5
"19877",2018-01-01 01:44:42,57595.59,25814889.09
"6605",2018-01-01 01:56:34,441802.67,26256691.76
"6606",2018-01-01 02:10:45,-441802.67,25814889.09
"19878",2018-01-01 03:02:24,49009.32,25863898.41
"19879",2018-01-01 03:20:30,511005.74,26374904.15
"6607",2018-01-01 03:49:40,83347.85,26458252
"6608",2018-01-01 03:56:10,-83347.85,26374904.15
"6609",2018-01-01 03:57:29,274201.33,26649105.48
"6610",2018-01-01 04:03:23,777907.32,27427012.8
"6611",2018-01-01 04:03:23,-274201.33,27152811.47
"6612",2018-01-01 04:10:24,-777907.32,26374904.15
"19880",2018-01-01 04:10:24,372022.02,26746926.17
"6613",2018-01-01 04:29:12,491468.53,27238394.7
"6614",2018-01-01 04:51:50,362973.65,27601368.35
"6615",2018-01-01 04:51:50,-491468.53,27109899.82
"19881",2018-01-01 04:51:50,435260.34,27545160.16
"6616",2018-01-01 04:57:50,-362973.65,27182186.51
"19882",2018-01-01 05:09:13,579742.68,27761929.19
"19883",2018-01-01 05:45:32,392592.67,28154521.86
"6617",2018-01-01 06:12:20,415736.72,28570258.58
"6618",2018-01-01 06:16:15,-415736.72,28154521.86
"6619",2018-01-01 07:22:29,466228.16,28620750.02
"6620",2018-01-01 07:22:29,67608.87,28688358.89
"6621",2018-01-01 07:22:29,427033.89,29115392.78
"6622",2018-01-01 07:40:05,-960870.92,28154521.86
"19884",2018-01-01 09:19:16,62570.18,28217092.04
"19885",2018-01-01 10:43:34,430566.2,28647658.24
"19886",2018-01-01 11:47:10,195304.55,28842962.79
"19887",2018-01-01 11:47:10,777907.54,29620870.33
"19888",2018-01-01 11:51:20,538637.3,30159507.63
"19889",2018-01-01 12:35:55,396420.94,30555928.57
"6623",2018-01-01 12:44:31,66931.6,30622860.17
"6624",2018-01-01 12:55:58,-66931.6,30555928.57
"19890",2018-01-01 12:55:58,570561.11,31126489.68
"19891",2018-01-01 12:55:58,413247.78,31539737.46
"19892",2018-01-01 13:11:52,387294.04,31927031.5
"19893",2018-01-01 13:42:19,373681.44,32300712.94
"6625",2018-01-01 14:26:21,327225.29,32627938.23
"19894",2018-01-01 14:26:21,27094.85,32655033.08
"6626",2018-01-01 14:31:10,-327225.29,32327807.79
"19895",2018-01-01 15:23:38,200130.8,32527938.59
"19896",2018-01-01 15:23:38,292593.65,32820532.24
"19897",2018-01-01 15:23:38,382644.96,33203177.2
"19898",2018-01-01 15:58:25,363939,33567116.2
"19899",2018-01-01 16:13:26,37004.97,33604121.17
"19900",2018-01-01 16:13:26,365912.56,33970033.73
"19901",2018-01-01 16:43:08,378006.42,34348040.15
"19902",2018-01-01 16:43:08,401670.04,34749710.19
"19903",2018-01-01 16:43:08,333616.36,35083326.55
"19904",2018-01-01 16:49:12,564253.18,35647579.73
"19905",2018-01-01 17:41:06,362476.12,36010055.85
"19906",2018-01-01 19:17:32,481360.32,36491416.17
"19907",2018-01-01 19:37:00,510849.97,37002266.14
"19908",2018-01-01 19:37:00,527806.37,37530072.51
"19909",2018-01-01 19:45:36,681422.63,38211495.14
"6627",2018-01-01 19:57:33,471486.46,38682981.6
"6628",2018-01-01 20:03:41,-471486.46,38211495.14
"19910",2018-01-01 20:25:47,379169.06,38590664.2
"6629",2018-01-01 20:39:28,347970.77,38938634.97
"6630",2018-01-01 20:53:20,357701.6,39296336.57
"6631",2018-01-01 20:53:20,-347970.77,38948365.8
"6632",2018-01-01 21:07:10,-357701.6,38590664.2
"6633",2018-01-01 21:16:52,469343.77,39060007.97
"19911",2018-01-01 21:16:52,386281.18,39446289.15
"6634",2018-01-01 21:22:19,-469343.77,38976945.38
"6635",2018-01-01 21:43:12,444853.16,39421798.54
"6636",2018-01-01 21:52:48,-444853.16,38976945.38
"6637",2018-01-01 22:56:31,226546.11,39203491.49
"6638",2018-01-01 22:56:31,777908.1,39981399.59
"6639",2018-01-01 23:14:17,-1004454.21,38976945.38
"19912",2018-01-01 23:53:05,716375.11,39693320.49
"6640",2018-01-02 00:19:12,423391.02,40116711.51
"6641",2018-01-02 00:37:08,-423391.02,39693320.49
"19913",2018-01-02 00:37:08,777908.15,40471228.64
"19914",2018-01-02 00:37:08,12748.16,40483976.8
"6642",2018-01-02 01:45:26,616528.99,41100505.79
"6643",2018-01-02 01:55:27,-616528.99,40483976.8
"6644",2018-01-02 03:12:26,667245.24,41151222.04
"6645",2018-01-02 03:16:12,-667245.24,40483976.8
"6646",2018-01-02 04:54:22,656792.79,41140769.59
"6647",2018-01-02 04:54:22,65802.9,41206572.49
"6648",2018-01-02 04:59:42,-722595.69,40483976.8
"19915",2018-01-02 05:39:04,462007.82,40945984.62
"19916",2018-01-02 10:41:58,618381.98,41564366.6
"19917",2018-01-02 11:01:33,446032.06,42010398.66
"19918",2018-01-02 12:29:03,441906.1,42452304.76
"19919",2018-01-02 13:11:03,490272.15,42942576.91
"19920",2018-01-02 13:11:03,1275823,44218399.91
"6649",2018-01-02 13:28:19,777908.66,44996308.57
"6650",2018-01-02 13:28:19,59957.67,45056266.24
"6651",2018-01-02 13:35:16,-837866.33,44218399.91
"19921",2018-01-02 13:35:16,305910.69,44524310.6
"19922",2018-01-02 13:35:16,777908.68,45302219.28
"6652",2018-01-02 13:49:59,494314.55,45796533.83
"6653",2018-01-02 13:49:59,614827.49,46411361.32
"6654",2018-01-02 13:51:49,-1109142.04,45302219.28
"6655",2018-01-02 14:32:16,641727.22,45943946.5
"6656",2018-01-02 14:32:16,66536.68,46010483.18
"6657",2018-01-02 14:49:44,485758.94,46496242.12
"6658",2018-01-02 14:49:44,-708263.9,45787978.22
"6659",2018-01-02 14:58:11,-485758.94,45302219.28
"19923",2018-01-02 16:20:51,573667.56,45875886.84
"19924",2018-01-02 17:03:58,703403.77,46579290.61
"19925",2018-01-02 17:33:04,619569.05,47198859.66
"6660",2018-01-02 18:20:33,18570.92,47217430.58
"6661",2018-01-02 18:20:33,777908.91,47995339.49
"6662",2018-01-02 18:24:10,-796479.83,47198859.66
"6663",2018-01-02 18:39:51,687865.02,47886724.68
"6664",2018-01-02 18:54:24,-687865.02,47198859.66
"6665",2018-01-02 19:25:26,716541.57,47915401.23
"6666",2018-01-02 19:29:01,-716541.57,47198859.66
"19926",2018-01-02 20:24:29,777909.01,47976768.67
"19927",2018-01-02 20:24:29,309641.02,48286409.69
"6667",2018-01-02 20:38:34,13860.04,48300269.73
"6668",2018-01-02 20:38:34,777909.03,49078178.76
"6669",2018-01-02 20:55:49,777909.07,49856087.83
"6670",2018-01-02 20:55:49,66727.08,49922814.91
"6671",2018-01-02 20:55:49,-791769.07,49131045.84
"19928",2018-01-02 20:55:49,73031.06,49204076.9
"19929",2018-01-02 20:55:49,777909.05,49981985.95
"6672",2018-01-02 21:02:26,-844636.15,49137349.8
"6673",2018-01-02 22:14:34,546278.92,49683628.72
"6674",2018-01-02 22:22:43,-546278.92,49137349.8
"19930",2018-01-02 23:27:05,455997.29,49593347.09
"19931",2018-01-02 23:46:54,200118.19,49793465.28
"19932",2018-01-02 23:46:54,777909.18,50571374.46
"19933",2018-01-02 23:46:54,581627.87,51153002.33
"6675",2018-01-03 00:28:59,487599.06,51640601.39
"6676",2018-01-03 00:54:07,627365.33,52267966.72
"6677",2018-01-03 00:59:01,-487599.06,51780367.66
"6678",2018-01-03 01:15:15,-627365.33,51153002.33
"6679",2018-01-03 03:02:17,516923.43,51669925.76
"6680",2018-01-03 03:14:39,-516923.43,51153002.33
"6681",2018-01-03 04:26:25,208994.5,51361996.83
"6682",2018-01-03 04:34:02,274879.63,51636876.46
"6683",2018-01-03 04:34:02,-208994.5,51427881.96
"6684",2018-01-03 04:47:52,293401.21,51721283.17
"6685",2018-01-03 04:47:52,-274879.63,51446403.54
"6686",2018-01-03 04:53:21,369088.62,51815492.16
"6687",2018-01-03 05:20:06,-662489.83,51153002.33
"6688",2018-01-03 05:39:27,548116.97,51701119.3
"6689",2018-01-03 05:47:42,-548116.97,51153002.33
"6690",2018-01-03 07:11:30,554046.7,51707049.03
"6691",2018-01-03 07:22:03,461240.06,52168289.09
"6692",2018-01-03 07:22:03,-554046.7,51614242.39
"6693",2018-01-03 08:49:13,663912.42,52278154.81
"19934",2018-01-03 08:49:13,34025.44,52312180.25
"19935",2018-01-03 08:49:13,777909.43,53090089.68
"19936",2018-01-03 08:49:13,-51153002.33,1937087.35000002
"6694",2018-01-03 08:54:17,-461240.06,1475847.29000002
"19937",2018-01-03 08:54:17,666193.72,2142041.01000002
"19938",2018-01-03 08:54:17,386608.98,2528649.99000002
"6695",2018-01-03 09:08:27,29128.2,2557778.19000002
"6696",2018-01-03 09:08:27,42402.72,2600180.91000002
"6697",2018-01-03 09:08:27,42422.69,2642603.60000002
"6698",2018-01-03 09:08:27,-663912.42,1978691.18000002
"19939",2018-01-03 09:08:27,-811934.87,1166756.31000002
"19940",2018-01-03 09:17:57,-1052802.7,113953.610000017
"6699",2018-01-03 09:21:13,-113953.61,1.68656697496772e-08
"19941",2018-01-03 10:17:41,585573.8,585573.800000017
"19942",2018-01-03 10:17:41,508651.57,1094225.37000002
"6700",2018-01-03 10:21:01,550866.73,1645092.10000002
"19943",2018-01-03 10:21:01,-1094225.37,550866.730000017
"6701",2018-01-03 10:28:30,547460.49,1098327.22000002
"6702",2018-01-03 10:28:30,52827.54,1151154.76000002
"19944",2018-01-03 10:47:20,421684.81,1572839.57000002
"6703",2018-01-03 10:50:14,-1151154.76,421684.810000017
"19945",2018-01-03 10:51:06,-421684.81,1.68220140039921e-08
"6704",2018-01-03 10:54:37,469702.35,469702.350000017
"6705",2018-01-03 11:50:09,454711.31,924413.660000017
"6706",2018-01-03 11:50:09,475418.68,1399832.34000002
"6707",2018-01-03 11:50:09,36503.18,1436335.52000002
"19946",2018-01-03 11:50:09,649887.53,2086223.05000002
"19947",2018-01-03 11:55:32,-649887.53,1436335.52000002
"6708",2018-01-03 12:31:13,380822.96,1817158.48000002
"6709",2018-01-03 12:31:13,904880.9,2722039.38000002
"6710",2018-01-03 13:02:27,-469702.35,2252337.03000002
"6711",2018-01-03 13:30:04,-2252337.03,1.67638063430786e-08
"19948",2018-01-03 13:30:04,505852.03,505852.030000017
"6712",2018-01-03 13:33:22,481796.4,987648.430000017
"6713",2018-01-03 13:33:22,97390.85,1085039.28000002
"19949",2018-01-03 13:36:02,-505852.03,579187.250000017
"6714",2018-01-03 13:40:20,-579187.25,1.67638063430786e-08
"19950",2018-01-03 13:40:20,587018.74,587018.740000017
"19951",2018-01-03 13:45:25,-587018.74,1.67638063430786e-08
"19952",2018-01-03 14:10:53,480303.94,480303.940000017
"19953",2018-01-03 14:17:47,766017.67,1246321.61000002
"19954",2018-01-03 14:25:14,633173.01,1879494.62000002
"6715",2018-01-03 14:47:51,777642.89,2657137.51000002
"6716",2018-01-03 14:47:51,422869.18,3080006.69000002
"6717",2018-01-03 14:47:51,539399.74,3619406.43000002
"19955",2018-01-03 14:47:51,556017.17,4175423.60000002
"6718",2018-01-03 14:59:17,-1739911.81,2435511.79000002
"19956",2018-01-03 14:59:17,663851.8,3099363.59000002
"19957",2018-01-03 15:06:15,634085.59,3733449.18000002
"6719",2018-01-03 15:15:51,777909.8,4511358.98000002
"6720",2018-01-03 15:27:24,129047.81,4640406.79000002
"6721",2018-01-03 15:27:24,58076.86,4698483.65000002
"6722",2018-01-03 15:27:24,-777909.8,3920573.85000002
"19958",2018-01-03 15:27:24,591782.12,4512355.97000002
"6723",2018-01-03 15:47:53,681051.45,5193407.42000002
"6724",2018-01-03 15:47:53,-187124.67,5006282.75000002
"19959",2018-01-03 15:47:53,588925.06,5595207.81000002
"6725",2018-01-03 16:18:12,575122.63,6170330.44000002
"6726",2018-01-03 16:21:16,-681051.45,5489278.99000002
"6727",2018-01-03 16:41:15,-575122.63,4914156.36000002
"6728",2018-01-03 17:11:18,533842.22,5447998.58000002
"6729",2018-01-03 17:24:47,-533842.22,4914156.36000002
"19960",2018-01-03 17:24:47,609717.91,5523874.27000002
"6730",2018-01-03 17:36:34,769446.91,6293321.18000002
"6731",2018-01-03 17:51:02,777909.92,7071231.10000002
"6732",2018-01-03 17:51:02,214951.93,7286183.03000002
"6733",2018-01-03 17:51:02,-769446.91,6516736.12000002
"6734",2018-01-03 18:09:30,-992861.85,5523874.27000002
"6735",2018-01-03 18:33:12,549150.69,6073024.96000002
"6736",2018-01-03 18:42:20,-549150.69,5523874.27000002
"19961",2018-01-03 18:46:02,636110.87,6159985.14000002
"19962",2018-01-03 19:43:45,509752.2,6669737.34000002
"6737",2018-01-03 20:17:39,131920.62,6801657.96000002
"6738",2018-01-03 20:20:43,-131920.62,6669737.34000002
"6739",2018-01-03 20:59:01,462244.08,7131981.42000002
"6740",2018-01-03 21:05:43,-462244.08,6669737.34000002
"6741",2018-01-03 21:50:00,581423.4,7251160.74000002
"6742",2018-01-03 21:50:00,777910.13,8029070.87000002
"6743",2018-01-03 21:50:00,713769.14,8742840.01000002
"19963",2018-01-03 21:50:00,595075.37,9337915.38000002
"6744",2018-01-03 22:04:04,-2073102.67,7264812.71000002
"6745",2018-01-03 23:13:38,638479.66,7903292.37000002
"6746",2018-01-03 23:44:59,-638479.66,7264812.71000002
"6747",2018-01-04 00:51:38,48873.38,7313686.09000002
"6748",2018-01-04 00:51:38,460231.86,7773917.95000002
"6749",2018-01-04 01:03:29,777910.24,8551828.19000002
"6750",2018-01-04 01:03:29,320689.25,8872517.44000002
"6751",2018-01-04 01:03:29,614055.82,9486573.26000002
"6752",2018-01-04 01:03:29,-509105.24,8977468.02000002
"6753",2018-01-04 01:21:11,135411.27,9112879.29000002
"6754",2018-01-04 01:21:11,777910.26,9890789.55000002
"6755",2018-01-04 01:21:11,450621.17,10341410.72
"6756",2018-01-04 01:21:11,54412.39,10395823.11
"6757",2018-01-04 01:21:11,-1712655.31,8683167.80000002
"6758",2018-01-04 01:45:58,-1418355.09,7264812.71000002
"19964",2018-01-04 01:55:47,569278.37,7834091.08000002
"19965",2018-01-04 02:22:23,714995.71,8549086.79000002
"6759",2018-01-04 02:34:16,573109.77,9122196.56000002
"6760",2018-01-04 02:42:47,-573109.77,8549086.79000002
"19966",2018-01-04 03:45:51,622551.76,9171638.55000002
"6761",2018-01-04 08:55:54,506030.85,9677669.40000002
"6762",2018-01-04 09:10:04,-506030.85,9171638.55000002
"19967",2018-01-04 09:10:04,314927.76,9486566.31000002
"19968",2018-01-04 09:10:04,213824.97,9700391.28000002
"19969",2018-01-04 09:35:09,518177.92,10218569.2
"6763",2018-01-04 10:29:35,664352.09,10882921.29
"19970",2018-01-04 10:29:35,442664.34,11325585.63
"19971",2018-01-04 10:29:35,438703.11,11764288.74
"19972",2018-01-04 10:29:35,462266.16,12226554.9
"6764",2018-01-04 10:36:33,433482.35,12660037.25
"6765",2018-01-04 10:37:47,-664352.09,11995685.16
"19973",2018-01-04 10:53:29,427521.52,12423206.68
"6766",2018-01-04 10:55:54,-433482.35,11989724.33
"19974",2018-01-04 11:11:24,647581.43,12637305.76
"19975",2018-01-04 11:11:24,473171.94,13110477.7
"6767",2018-01-04 11:21:40,455238.43,13565716.13
"6768",2018-01-04 11:24:21,-455238.43,13110477.7
"19976",2018-01-04 11:24:21,547809.84,13658287.54
"6769",2018-01-04 12:01:03,47297.16,13705584.7
"19977",2018-01-04 12:01:03,545377.9,14250962.6
"6770",2018-01-04 12:06:42,-47297.16,14203665.44
"6771",2018-01-04 12:18:11,745882.77,14949548.21
"19978",2018-01-04 12:18:11,447953.2,15397501.41
"6772",2018-01-04 12:29:23,-745882.77,14651618.64
"19979",2018-01-04 13:13:41,611968.36,15263587
"6773",2018-01-04 13:34:52,563919.93,15827506.93
"6774",2018-01-04 14:04:00,-563919.93,15263587
"6775",2018-01-04 15:36:10,591355.98,15854942.98
"19980",2018-01-04 15:36:10,36186.67,15891129.65
"19981",2018-01-04 15:36:10,777911.66,16669041.31
"19982",2018-01-04 15:36:10,616171.19,17285212.5
"6776",2018-01-04 15:48:12,-591355.98,16693856.52
"19983",2018-01-04 15:48:12,573895.73,17267752.25
"19984",2018-01-04 15:48:12,439696.01,17707448.26
"19985",2018-01-04 16:17:25,539065.16,18246513.42
"6777",2018-01-04 16:36:12,777911.72,19024425.14
"6778",2018-01-04 16:49:49,7366.73,19031791.87
"6779",2018-01-04 16:49:49,593347.01,19625138.88
"6780",2018-01-04 16:49:49,-777911.72,18847227.16
"19986",2018-01-04 16:49:49,523173.08,19370400.24
"6781",2018-01-04 16:57:00,-600713.74,18769686.5
"19987",2018-01-04 16:57:00,394959.85,19164646.35
"6782",2018-01-04 17:25:19,478016.32,19642662.67
"6783",2018-01-04 17:33:30,-478016.32,19164646.35
"6784",2018-01-04 19:06:11,645994.59,19810640.94
"6785",2018-01-04 19:32:52,777911.84,20588552.78
"19988",2018-01-04 19:32:52,777911.82,21366464.6
"19989",2018-01-04 19:32:52,294234.83,21660699.43
"6786",2018-01-04 19:36:40,225873.85,21886573.28
"6787",2018-01-04 19:36:40,-645994.59,21240578.69
"6788",2018-01-04 19:42:57,-1003785.69,20236793
"6789",2018-01-04 19:51:47,656797.73,20893590.73
"6790",2018-01-04 20:05:56,846564.48,21740155.21
"6791",2018-01-04 20:18:10,534534.89,22274690.1
"6792",2018-01-04 20:18:10,588613.01,22863303.11
"6793",2018-01-04 20:20:00,-656797.73,22206505.38
"6794",2018-01-04 20:27:52,-1969712.38,20236793
"6795",2018-01-04 20:36:16,777911.9,21014704.9
"6796",2018-01-04 20:36:16,297088.91,21311793.81
"19990",2018-01-04 20:38:17,547181.53,21858975.34
"6797",2018-01-04 21:15:03,-1075000.81,20783974.53
"19991",2018-01-04 21:30:28,278523.94,21062498.47
"19992",2018-01-04 21:30:28,777911.93,21840410.4
"6798",2018-01-04 21:52:27,1082786.1,22923196.5
"6799",2018-01-04 22:03:41,-1082786.1,21840410.4
"6800",2018-01-04 23:52:03,619737.79,22460148.19
"6801",2018-01-04 23:54:58,-619737.79,21840410.4
"6802",2018-01-05 01:17:36,48297.11,21888707.51
"6803",2018-01-05 01:22:13,-48297.11,21840410.4
"19993",2018-01-05 01:46:13,486412.07,22326822.47
"19994",2018-01-05 01:56:49,563432.04,22890254.51
"19995",2018-01-05 02:04:39,522745.89,23413000.4
"19996",2018-01-05 02:25:21,644732.04,24057732.44
"19997",2018-01-05 02:25:21,540953.43,24598685.87
"19998",2018-01-05 02:25:21,462778,25061463.87
"6804",2018-01-05 02:43:46,630345.83,25691809.7
"6805",2018-01-05 02:49:18,666693.16,26358502.86
"6806",2018-01-05 02:49:18,-630345.83,25728157.03
"6807",2018-01-05 02:57:56,-666693.16,25061463.87
"19999",2018-01-05 02:57:56,622738.21,25684202.08
"6808",2018-01-05 03:26:29,590629.95,26274832.03
"6809",2018-01-05 03:30:04,-590629.95,25684202.08
"20000",2018-01-05 04:20:30,494111.51,26178313.59
"20001",2018-01-05 04:20:30,509889.04,26688202.63
"20002",2018-01-05 06:24:14,525461.17,27213663.8
"6810",2018-01-05 06:36:32,500953.33,27714617.13
"6811",2018-01-05 06:42:02,-500953.33,27213663.8
"20003",2018-01-05 08:03:23,595941.25,27809605.05
"20004",2018-01-05 08:44:33,532676.85,28342281.9
"6812",2018-01-05 09:04:51,777912.26,29120194.16
"6813",2018-01-05 09:04:51,1759.27,29121953.43
"6814",2018-01-05 09:04:51,777912.28,29899865.71
"6815",2018-01-05 09:07:22,164801.29,30064667
"6816",2018-01-05 09:09:08,-1557583.81,28507083.19
"20005",2018-01-05 09:09:08,285938.31,28793021.5
"20006",2018-01-05 09:09:08,777912.3,29570933.8
"6817",2018-01-05 09:17:08,-164801.29,29406132.51
"20007",2018-01-05 09:17:08,-29406132.51,2.98023223876953e-08
"20008",2018-01-05 09:37:22,33870.33,33870.3300000298
"20009",2018-01-05 09:37:22,777912.32,811782.65000003
"20010",2018-01-05 09:37:22,784946.72,1596729.37000003
"20011",2018-01-05 09:46:37,-1596729.37,2.95694917440414e-08
"6818",2018-01-05 10:40:45,734127.3,734127.30000003
"6819",2018-01-05 11:21:56,-734127.3,2.95694917440414e-08
"20012",2018-01-05 11:21:56,68278.25,68278.2500000296
"20013",2018-01-05 11:35:54,-68278.25,2.95694917440414e-08
"6820",2018-01-05 11:38:18,354207.44,354207.44000003
"6821",2018-01-05 11:45:26,777912.43,1132119.87000003
"6822",2018-01-05 11:48:51,-354207.44,777912.43000003
"6823",2018-01-05 11:54:34,-777912.43,2.96859070658684e-08
"6824",2018-01-05 14:11:56,336721.85,336721.85000003
"6825",2018-01-05 14:22:40,-336721.85,2.96859070658684e-08
"6826",2018-01-05 14:32:56,201249.12,201249.12000003
"6827",2018-01-05 14:52:13,-201249.12,2.96859070658684e-08
"6828",2018-01-05 15:27:08,53584.29,53584.2900000297
"20014",2018-01-05 15:27:08,141210.6,194794.89000003
"20015",2018-01-05 15:27:08,22983.23,217778.12000003
"20016",2018-01-05 15:27:08,230198.78,447976.90000003
"20017",2018-01-05 15:27:08,169909.05,617885.95000003
"6829",2018-01-05 15:41:25,-53584.29,564301.66000003
"6830",2018-01-05 16:03:08,562138.33,1126439.99000003
"6831",2018-01-05 16:08:00,-562138.33,564301.66000003
"20018",2018-01-05 16:56:49,409519,973820.66000003
"20019",2018-01-05 17:58:47,296218.88,1270039.54000003
"6832",2018-01-05 18:26:56,689583.19,1959622.73000003
"6833",2018-01-05 18:31:53,-689583.19,1270039.54000003
"20020",2018-01-05 19:11:18,545412.31,1815451.85000003
"6834",2018-01-05 22:07:24,297920.17,2113372.02000003
"6835",2018-01-05 22:07:24,156106.82,2269478.84000003
"6836",2018-01-05 22:07:24,137360.01,2406838.85000003
"20021",2018-01-05 22:07:24,200102.93,2606941.78000003
"20022",2018-01-05 22:07:24,17732.67,2624674.45000003
"6837",2018-01-05 22:45:19,42807.54,2667481.99000003
"20023",2018-01-05 22:45:19,280041.04,2947523.03000003
"20024",2018-01-05 22:45:19,42992.11,2990515.14000003
"6838",2018-01-05 23:01:47,119328.02,3109843.16000003
"6839",2018-01-05 23:01:47,85917.2,3195760.36000003
"6840",2018-01-05 23:01:47,190033.8,3385794.16000003
"6841",2018-01-05 23:01:47,228806.88,3614601.04000003
"6842",2018-01-05 23:01:47,509498.64,4124099.68000003
"6843",2018-01-05 23:01:47,-591387,3532712.68000003
"6844",2018-01-05 23:18:04,-1176392.08,2356320.60000003
"20025",2018-01-05 23:18:04,55657.82,2411978.42000003
"6845",2018-01-05 23:59:39,31842.1,2443820.52000003
"6846",2018-01-05 23:59:39,78032.58,2521853.10000003
"6847",2018-01-06 00:02:40,-109874.68,2411978.42000003
"20026",2018-01-06 00:17:50,348645.74,2760624.16000003
"6848",2018-01-06 00:28:18,38789.81,2799413.97000003
"6849",2018-01-06 00:28:18,45247.27,2844661.24000003
"20027",2018-01-06 00:28:18,83632.27,2928293.51000003
"6850",2018-01-06 00:51:35,22196.07,2950489.58000003
"6851",2018-01-06 00:51:35,112840.9,3063330.48000003
"20028",2018-01-06 00:51:35,158470.3,3221800.78000003
"20029",2018-01-06 00:51:35,39147.79,3260948.57000003
"20030",2018-01-06 00:51:35,108761.06,3369709.63000003
"6852",2018-01-06 00:55:06,-84037.08,3285672.55000003
"6853",2018-01-06 01:17:36,94915.1,3380587.65000003
"20031",2018-01-06 01:17:36,424533.13,3805120.78000003
"6854",2018-01-06 01:36:01,54430.79,3859551.57000003
"6855",2018-01-06 01:36:01,193044.19,4052595.76000003
"6856",2018-01-06 01:36:01,44311.17,4096906.93000003
"6857",2018-01-06 01:36:01,40572.54,4137479.47000003
"6858",2018-01-06 01:36:01,16380.73,4153860.20000003
"6859",2018-01-06 01:36:01,268096.42,4421956.62000003
"6860",2018-01-06 01:36:01,14280.86,4436237.48000003
"6861",2018-01-06 01:36:01,403750.46,4839987.94000003
"6862",2018-01-06 01:44:26,147026.19,4987014.13000003
"6863",2018-01-06 01:44:26,223325.93,5210340.06000003
"6864",2018-01-06 01:44:26,444216.83,5654556.89000003
"6865",2018-01-06 01:44:26,-135036.97,5519519.92000003
"6866",2018-01-06 01:50:46,171068.78,5690588.70000003
"6867",2018-01-06 01:50:46,-1944351.21,3746237.49000003
"6868",2018-01-06 02:05:16,-171068.78,3575168.71000003
"20032",2018-01-06 02:05:16,19670.86,3594839.57000003
"6869",2018-01-06 03:09:02,266892.13,3861731.70000003
"6870",2018-01-06 03:09:02,59216.16,3920947.86000003
"6871",2018-01-06 03:09:02,213609.88,4134557.74000003
"6872",2018-01-06 03:09:02,141474.67,4276032.41000003
"20033",2018-01-06 03:09:02,126662.07,4402694.48000003
"6873",2018-01-06 03:17:34,305319.73,4708014.21000003
"6874",2018-01-06 03:17:34,-681192.84,4026821.37000003
"6875",2018-01-06 03:26:11,-305319.73,3721501.64000003
"6876",2018-01-06 04:08:04,33133.26,3754634.90000003
"6877",2018-01-06 04:08:04,17909.48,3772544.38000003
"6878",2018-01-06 04:08:04,20782.04,3793326.42000003
"6879",2018-01-06 04:08:04,17701.42,3811027.84000003
"6880",2018-01-06 04:08:04,133077.49,3944105.33000003
"6881",2018-01-06 04:08:04,20809.07,3964914.40000003
"6882",2018-01-06 04:08:04,422910.6,4387825.00000003
"6883",2018-01-06 04:08:04,16359.22,4404184.22000003
"20034",2018-01-06 04:08:04,184938.62,4589122.84000003
"20035",2018-01-06 04:08:04,777914.61,5367037.45000003
"6884",2018-01-06 04:08:34,17870.11,5384907.56000003
"6885",2018-01-06 04:11:40,116841.69,5501749.25000003
"6886",2018-01-06 04:11:40,18321.33,5520070.58000003
"6887",2018-01-06 04:11:40,-682682.58,4837388.00000003
"6888",2018-01-06 04:19:14,369223.14,5206611.14000003
"6889",2018-01-06 04:19:14,131400.08,5338011.22000003
"6890",2018-01-06 04:19:14,498736.35,5836747.57000003
"20036",2018-01-06 04:23:35,284381.01,6121128.58000003
"6891",2018-01-06 04:28:36,94272.51,6215401.09000003
"6892",2018-01-06 04:38:04,-1152392.7,5063008.39000003
"20037",2018-01-06 04:44:33,13334.83,5076343.22000003
"6893",2018-01-06 05:02:16,-94272.51,4982070.71000003
"6894",2018-01-06 05:15:24,200704.4,5182775.11000003
"6895",2018-01-06 05:15:24,268887.83,5451662.94000003
"20038",2018-01-06 05:15:24,105860.38,5557523.32000003
"20039",2018-01-06 05:15:24,16664.9,5574188.22000003
"6896",2018-01-06 05:26:32,-469592.23,5104595.99000003
"20040",2018-01-06 05:26:32,13177.41,5117773.40000003
"20041",2018-01-06 06:03:37,222212.26,5339985.66000003
"20042",2018-01-06 06:04:06,306002.02,5645987.68000003
"20043",2018-01-06 06:27:45,464070.54,6110058.22000003
"20044",2018-01-06 06:32:27,247443.1,6357501.32000003
"6897",2018-01-06 06:55:18,363203.81,6720705.13000003
"6898",2018-01-06 06:58:00,-363203.81,6357501.32000003
"20045",2018-01-06 07:36:18,365916.46,6723417.78000003
"6899",2018-01-06 07:53:44,167156.23,6890574.01000003
"6900",2018-01-06 08:07:07,-167156.23,6723417.78000003
"6901",2018-01-06 08:38:47,395756.38,7119174.16000003
"6902",2018-01-06 08:38:47,613532.31,7732706.47000003
"6903",2018-01-06 08:38:47,164145.37,7896851.84000003
"6904",2018-01-06 09:04:31,636108.79,8532960.63000003
"6905",2018-01-06 09:04:31,514747.05,9047707.68000003
"6906",2018-01-06 09:04:31,-1173434.06,7874273.62000003
"6907",2018-01-06 09:14:35,573179.13,8447452.75000003
"6908",2018-01-06 09:14:35,-1150855.84,7296596.91000003
"6909",2018-01-06 09:27:14,-573179.13,6723417.78000003
"6910",2018-01-06 09:46:52,289201.95,7012619.73000003
"6911",2018-01-06 09:46:52,226088.29,7238708.02000003
"6912",2018-01-06 09:56:57,372824.34,7611532.36000003
"6913",2018-01-06 09:56:57,-515290.24,7096242.12000003
"6914",2018-01-06 10:08:30,470254.57,7566496.69000003
"6915",2018-01-06 10:08:30,-372824.34,7193672.35000003
"6916",2018-01-06 10:20:40,378565.93,7572238.28000003
"6917",2018-01-06 10:20:40,-470254.57,7101983.71000003
"6918",2018-01-06 10:25:07,463834.17,7565817.88000003
"6919",2018-01-06 10:27:20,-842400.1,6723417.78000003
"20046",2018-01-06 10:39:55,370470.45,7093888.23000003
"20047",2018-01-06 10:51:01,602417.68,7696305.91000003
"6920",2018-01-06 11:08:35,546887.67,8243193.58000003
"6921",2018-01-06 11:20:21,-546887.67,7696305.91000003
"20048",2018-01-06 11:20:21,49292.21,7745598.12000003
"20049",2018-01-06 11:26:10,570705.37,8316303.49000003
"6922",2018-01-06 12:06:45,347486.45,8663789.94000003
"6923",2018-01-06 12:17:07,-347486.45,8316303.49000003
"20050",2018-01-06 13:11:36,136907.19,8453210.68000003
"20051",2018-01-06 13:24:51,86160.49,8539371.17000003
"20052",2018-01-06 13:43:12,505061.27,9044432.44000003
"20053",2018-01-06 13:43:12,245020.61,9289453.05000003
"20054",2018-01-06 14:00:02,152531.71,9441984.76000003
"20055",2018-01-06 14:00:02,294997.52,9736982.28000003
"20056",2018-01-06 14:00:02,103774.13,9840756.41000003
"6924",2018-01-06 14:22:05,512947.9,10353704.31
"6925",2018-01-06 14:28:20,-512947.9,9840756.41000003
"20057",2018-01-06 15:18:21,776835.48,10617591.89
"6926",2018-01-06 15:29:21,451350.25,11068942.14
"6927",2018-01-06 15:29:21,777915.24,11846857.38
"20058",2018-01-06 15:29:21,250012.34,12096869.72
"6928",2018-01-06 15:39:21,-1229265.49,10867604.23
"20059",2018-01-06 15:55:07,64217.12,10931821.35
"20060",2018-01-06 16:23:03,554154.96,11485976.31
"6929",2018-01-06 17:37:56,47857.22,11533833.53
"6930",2018-01-06 17:44:27,-47857.22,11485976.31
"20061",2018-01-06 20:54:07,294496.3,11780472.61
"20062",2018-01-06 21:15:10,274975.39,12055448
"6931",2018-01-06 22:24:34,777915.34,12833363.34
"6932",2018-01-06 22:24:34,65619.35,12898982.69
"6933",2018-01-06 22:39:39,-843534.69,12055448
"6934",2018-01-06 23:24:31,353828.71,12409276.71
"6935",2018-01-06 23:45:49,-353828.71,12055448
"6936",2018-01-07 00:41:17,663590.79,12719038.79
"6937",2018-01-07 00:44:52,-663590.79,12055448
"6938",2018-01-07 01:32:15,78099.42,12133547.42
"6939",2018-01-07 01:36:47,-78099.42,12055448
"20063",2018-01-07 01:36:47,265731.52,12321179.52
"20064",2018-01-07 01:36:47,304342.33,12625521.85
"6940",2018-01-07 04:31:37,192429.73,12817951.58
"6941",2018-01-07 04:40:52,-192429.73,12625521.85
"20065",2018-01-07 05:24:32,79330.45,12704852.3
"20066",2018-01-07 05:24:32,221751.41,12926603.71
"20067",2018-01-07 05:24:32,69464.89,12996068.6
"20068",2018-01-07 05:33:04,390115.49,13386184.09
"20069",2018-01-07 05:54:33,561470.34,13947654.43
"20070",2018-01-07 05:58:53,-13947654.43,3.35276126861572e-08
"6942",2018-01-07 06:07:15,109362.64,109362.640000034
"6943",2018-01-07 06:31:58,19698.07,129060.710000034
"6944",2018-01-07 06:31:58,795787.78,924848.490000034
"6945",2018-01-07 06:40:32,-109362.64,815485.850000034
"6946",2018-01-07 06:58:52,-815485.85,3.35276126861572e-08
"20071",2018-01-07 07:46:27,312997.48,312997.480000034
"20072",2018-01-07 07:54:24,-312997.48,3.35276126861572e-08
"6947",2018-01-07 08:06:38,179453.98,179453.980000034
"6948",2018-01-07 08:08:58,-179453.98,3.35276126861572e-08
"20073",2018-01-07 08:08:58,295557.56,295557.560000034
"6949",2018-01-07 08:53:38,398564.61,694122.170000033
"20074",2018-01-07 08:53:38,374545.88,1068668.05000003
"6950",2018-01-07 08:58:18,-398564.61,670103.440000033
"20075",2018-01-07 11:32:51,507145.59,1177249.03000003
"20076",2018-01-07 12:05:31,399682.31,1576931.34000003
"20077",2018-01-07 13:29:43,491702.53,2068633.87000003
"20078",2018-01-07 13:35:26,510832.88,2579466.75000003
"20079",2018-01-07 13:35:26,475334.49,3054801.24000003
"20080",2018-01-07 13:53:40,419042.63,3473843.87000003
"6951",2018-01-07 16:11:00,75092.82,3548936.69000003
"6952",2018-01-07 16:14:40,-75092.82,3473843.87000003
"6953",2018-01-07 16:16:09,209020.57,3682864.44000003
"6954",2018-01-07 16:53:50,-209020.57,3473843.87000003
"20081",2018-01-07 18:20:24,455194.71,3929038.58000003
"6955",2018-01-07 18:34:11,548995.99,4478034.57000003
"6956",2018-01-07 18:48:37,539994.8,5018029.37000003
"6957",2018-01-07 18:48:37,-548995.99,4469033.38000003
"20082",2018-01-07 18:48:37,272039.86,4741073.24000003
"6958",2018-01-07 19:02:55,-539994.8,4201078.44000003
"20083",2018-01-07 19:02:55,189825.54,4390903.98000003
"20084",2018-01-07 19:02:55,120783.54,4511687.52000003
"20085",2018-01-07 19:02:55,244958.53,4756646.05000003
"20086",2018-01-07 19:02:55,34106.31,4790752.36000003
"20087",2018-01-07 19:07:55,405165.1,5195917.46000003
"6959",2018-01-07 19:30:05,514980.08,5710897.54000003
"20088",2018-01-07 19:30:05,42010.08,5752907.62000003
"20089",2018-01-07 19:30:05,13918.76,5766826.38000003
"6960",2018-01-07 19:42:14,-514980.08,5251846.30000003
"20090",2018-01-07 19:42:14,76996.02,5328842.32000003
"20091",2018-01-07 19:56:22,261772.76,5590615.08000003
"6961",2018-01-07 20:05:57,777916.54,6368531.62000003
"6962",2018-01-07 20:07:19,54500.55,6423032.17000003
"6963",2018-01-07 20:24:32,-777916.54,5645115.63000003
"6964",2018-01-07 20:38:09,-54500.55,5590615.08000003
"20092",2018-01-07 20:38:09,119028.35,5709643.43000003
"20093",2018-01-07 20:38:09,63615.67,5773259.10000003
"20094",2018-01-07 20:38:09,18546.61,5791805.71000003
"20095",2018-01-07 20:38:09,77946.17,5869751.88000003
"20096",2018-01-07 20:38:09,27061.78,5896813.66000003
"20097",2018-01-07 20:42:43,184928.67,6081742.33000003
"20098",2018-01-07 20:42:43,430004.29,6511746.62000003
"20099",2018-01-07 20:42:43,486727.89,6998474.51000003
"20100",2018-01-07 20:42:43,266251,7264725.51000003
"6965",2018-01-07 21:05:34,205612.98,7470338.49000003
"6966",2018-01-07 21:25:54,-205612.98,7264725.51000003
"20101",2018-01-07 22:11:16,437633.01,7702358.52000003
"6967",2018-01-07 22:31:35,520224.42,8222582.94000003
"6968",2018-01-07 22:37:34,-520224.42,7702358.52000003
"20102",2018-01-07 22:37:34,79807.7,7782166.22000003
"6969",2018-01-08 00:37:45,183146.31,7965312.53000003
"6970",2018-01-08 00:45:53,-183146.31,7782166.22000003
"6971",2018-01-08 04:30:06,421978.27,8204144.49000003
"6972",2018-01-08 04:39:23,-421978.27,7782166.22000003
"20103",2018-01-08 06:51:13,400508.7,8182674.92000003
"6973",2018-01-08 08:04:45,389648.71,8572323.63000003
"6974",2018-01-08 08:10:41,-389648.71,8182674.92000003
"6975",2018-01-08 09:21:47,117288.73,8299963.65000003
"6976",2018-01-08 09:41:24,94222.17,8394185.82000003
"6977",2018-01-08 09:41:24,55839.9,8450025.72000003
"6978",2018-01-08 09:41:24,186749.95,8636775.67000003
"6979",2018-01-08 09:41:24,309506.39,8946282.06000003
"6980",2018-01-08 09:41:24,15271.74,8961553.80000003
"6981",2018-01-08 09:41:24,21781.64,8983335.44000003
"6982",2018-01-08 09:41:24,-117288.73,8866046.71000003
"6983",2018-01-08 09:49:16,-683371.79,8182674.92000003
"20104",2018-01-08 09:49:16,322011,8504685.92000004
"20105",2018-01-08 09:49:16,24841.6,8529527.52000003
"20106",2018-01-08 10:10:44,551391.74,9080919.26000004
"6984",2018-01-08 10:46:31,777918.48,9858837.74000004
"6985",2018-01-08 10:46:31,133947.49,9992785.23000004
"20107",2018-01-08 10:46:31,140636.75,10133421.98
"6986",2018-01-08 10:57:52,-911865.97,9221556.01000004
"6987",2018-01-08 11:18:17,286257.83,9507813.84000004
"6988",2018-01-08 11:47:06,-286257.83,9221556.01000004
"20108",2018-01-08 11:47:06,642932.92,9864488.93000004
"20109",2018-01-08 11:59:49,155303.08,10019792.01
"20110",2018-01-08 11:59:49,640331.33,10660123.34
"20111",2018-01-08 11:59:49,242430.15,10902553.49
"20112",2018-01-08 11:59:49,302674.15,11205227.64
"20113",2018-01-08 12:33:29,325495.19,11530722.83
"20114",2018-01-08 12:55:47,233653.78,11764376.61
"20115",2018-01-08 13:07:09,141317.73,11905694.34
"20116",2018-01-08 13:07:09,21238.65,11926932.99
"20117",2018-01-08 13:07:09,75292.94,12002225.93
"20118",2018-01-08 13:07:09,86109.87,12088335.8
"20119",2018-01-08 13:41:50,17492.03,12105827.83
"20120",2018-01-08 13:41:50,257317.72,12363145.55
"6989",2018-01-08 13:54:50,777918.74,13141064.29
"20121",2018-01-08 13:54:50,222550.73,13363615.02
"20122",2018-01-08 13:54:50,777918.72,14141533.74
"20123",2018-01-08 13:54:50,19553.89,14161087.63
"6990",2018-01-08 13:55:50,230567.75,14391655.38
"6991",2018-01-08 14:02:30,-777918.74,13613736.64
"20124",2018-01-08 14:02:30,777918.76,14391655.4
"20125",2018-01-08 14:02:30,189764.77,14581420.17
"6992",2018-01-08 14:04:06,96296.33,14677716.5
"6993",2018-01-08 14:04:06,22056.67,14699773.17
"6994",2018-01-08 14:48:30,636720.83,15336494
"6995",2018-01-08 14:48:30,108450.85,15444944.85
"6996",2018-01-08 14:48:30,111936.23,15556881.08
"6997",2018-01-08 14:48:30,777918.84,16334799.92
"6998",2018-01-08 14:48:30,180685.99,16515485.91
"6999",2018-01-08 14:48:30,-348920.75,16166565.16
"20126",2018-01-08 14:48:30,606120.81,16772685.97
"20127",2018-01-08 14:48:30,225558.62,16998244.59
"20128",2018-01-08 14:48:30,28976.82,17027221.41
"20129",2018-01-08 14:48:30,275857.77,17303079.18
"20130",2018-01-08 14:48:30,193531.76,17496610.94
"20131",2018-01-08 14:48:30,46127.7,17542738.64
"20132",2018-01-08 14:48:30,47009.08,17589747.72
"20133",2018-01-08 14:48:30,777918.97,18367666.69
"7000",2018-01-08 14:57:59,12092.69,18379759.38
"7001",2018-01-08 14:57:59,84655.85,18464415.23
"7002",2018-01-08 14:57:59,77876.43,18542291.66
"7003",2018-01-08 14:57:59,-1815712.74,16726578.92
"20134",2018-01-08 14:57:59,85592.98,16812171.9
"20135",2018-01-08 15:01:00,30901.87,16843073.77
"7004",2018-01-08 15:01:15,777919.02,17620992.79
"7005",2018-01-08 15:29:48,751853.11,18372845.9
"7006",2018-01-08 15:29:48,777919.1,19150765
"7007",2018-01-08 15:29:48,777919.08,19928684.08
"7008",2018-01-08 15:29:48,464075.09,20392759.17
"7009",2018-01-08 15:29:48,-952543.99,19440215.18
"20136",2018-01-08 15:29:48,168762.64,19608977.82
"20137",2018-01-08 15:29:48,163983.93,19772961.75
"20138",2018-01-08 15:29:48,572090.09,20345051.84
"20139",2018-01-08 15:35:25,278362.63,20623414.47
"7010",2018-01-08 15:38:00,-2771766.38,17851648.09
"7011",2018-01-08 15:40:59,14700.67,17866348.76
"7012",2018-01-08 15:55:57,34600.03,17900948.79
"7013",2018-01-08 15:55:57,-14700.67,17886248.12
"20140",2018-01-08 15:55:57,71237.53,17957485.65
"20141",2018-01-08 15:55:57,103448.17,18060933.82
"20142",2018-01-08 16:26:45,138197.49,18199131.31
"20143",2018-01-08 16:26:45,46133.37,18245264.68
"7014",2018-01-08 16:28:57,-34600.03,18210664.65
"7015",2018-01-08 17:25:26,161578.6,18372243.25
"7016",2018-01-08 17:25:26,23502.28,18395745.53
"7017",2018-01-08 17:25:26,67959.09,18463704.62
"7018",2018-01-08 17:29:28,-253039.97,18210664.65
"20144",2018-01-08 17:46:17,352612.33,18563276.98
"20145",2018-01-08 17:46:17,251581.75,18814858.73
"20146",2018-01-08 18:27:50,373550.33,19188409.06
"20147",2018-01-08 18:30:15,176013.02,19364422.08
"7019",2018-01-08 18:58:03,360430.53,19724852.61
"7020",2018-01-08 19:24:56,260823.49,19985676.1
"7021",2018-01-08 19:24:56,26424.86,20012100.96
"20148",2018-01-08 19:24:56,119657.98,20131758.94
"7022",2018-01-08 19:36:40,65915.01,20197673.95
"7023",2018-01-08 19:36:40,83516.06,20281190.01
"7024",2018-01-08 19:36:40,34392.16,20315582.17
"7025",2018-01-08 19:40:23,-360430.53,19955151.64
"7026",2018-01-08 19:53:54,-471071.58,19484080.06
"20149",2018-01-08 20:16:20,556559.4,20040639.46
"7027",2018-01-08 20:19:34,400587.02,20441226.48
"20150",2018-01-08 20:19:34,344975.83,20786202.31
"7028",2018-01-08 20:35:17,777919.84,21564122.15
"7029",2018-01-08 20:35:17,171232.85,21735355
"7030",2018-01-08 20:35:17,-400587.02,21334767.98
"20151",2018-01-08 20:35:17,295701.28,21630469.26
"20152",2018-01-08 20:35:17,460758.45,22091227.71
"20153",2018-01-08 20:35:17,621548.94,22712776.65
"20154",2018-01-08 20:35:17,310449.38,23023226.03
"7031",2018-01-08 20:48:00,-949152.69,22074073.34
"20155",2018-01-08 21:15:03,703814.2,22777887.54
"20156",2018-01-08 22:44:07,777919.93,23555807.47
"20157",2018-01-08 22:44:07,49251.94,23605059.41
"20158",2018-01-08 22:44:07,142357.5,23747416.91
"20159",2018-01-08 23:21:12,340531.97,24087948.88
"20160",2018-01-08 23:21:12,777919.96,24865868.84
"20161",2018-01-08 23:53:36,777919.98,25643788.82
"20162",2018-01-09 00:08:43,339652.99,25983441.81
"7032",2018-01-09 00:30:43,740491.01,26723932.82
"7033",2018-01-09 00:30:43,777920,27501852.82
"7034",2018-01-09 00:43:46,-1518411.01,25983441.81
"20163",2018-01-09 01:00:22,777920.03,26761361.84
"20164",2018-01-09 01:00:22,215194.04,26976555.88
"7035",2018-01-09 01:31:24,960830.19,27937386.07
"7036",2018-01-09 01:34:45,-960830.19,26976555.88
"20165",2018-01-09 01:36:49,280367.08,27256922.96
"20166",2018-01-09 01:36:49,777920.07,28034843.03
"7037",2018-01-09 01:49:31,53302.33,28088145.36
"7038",2018-01-09 01:49:31,48376.96,28136522.32
"7039",2018-01-09 01:49:31,777920.1,28914442.42
"7040",2018-01-09 01:49:31,640681.38,29555123.8
"7041",2018-01-09 01:49:31,238640.11,29793763.91
"7042",2018-01-09 01:49:31,50743.86,29844507.77
"7043",2018-01-09 01:49:31,29265.45,29873773.22
"7044",2018-01-09 01:49:31,727271.19,30601044.41
"7045",2018-01-09 01:49:31,34029.7,30635074.11
"7046",2018-01-09 01:49:31,34074.4,30669148.51
"7047",2018-01-09 01:49:31,16304.96,30685453.47
"7048",2018-01-09 01:58:34,-2650610.44,28034843.03
"7049",2018-01-09 02:12:23,487883.28,28522726.31
"7050",2018-01-09 02:12:23,926557.75,29449284.06
"7051",2018-01-09 02:17:19,-1414441.03,28034843.03
"20167",2018-01-09 03:30:49,28162.1,28063005.13
"20168",2018-01-09 03:30:49,101758.65,28164763.78
"7052",2018-01-09 04:22:04,68161.97,28232925.75
"7053",2018-01-09 04:27:30,-68161.97,28164763.78
"20169",2018-01-09 04:27:30,48265.81,28213029.59
"7054",2018-01-09 04:34:38,185204.68,28398234.27
"20170",2018-01-09 04:34:38,43732.54,28441966.81
"20171",2018-01-09 04:34:38,14840.92,28456807.73
"20172",2018-01-09 04:34:38,25599.08,28482406.81
"20173",2018-01-09 04:34:38,109693.02,28592099.83
"20174",2018-01-09 04:34:38,265188.02,28857287.85
"20175",2018-01-09 04:34:38,47740.37,28905028.22
"7055",2018-01-09 04:50:36,208837.13,29113865.35
"7056",2018-01-09 04:50:36,-185204.68,28928660.67
"20176",2018-01-09 04:50:36,777920.47,29706581.14
"20177",2018-01-09 04:50:36,22945.53,29729526.67
"20178",2018-01-09 04:50:36,54044.81,29783571.48
"20179",2018-01-09 04:50:36,426447.48,30210018.96
"20180",2018-01-09 04:50:36,45004.72,30255023.68
"20181",2018-01-09 04:50:36,25546.41,30280570.09
"20182",2018-01-09 04:50:36,23454.54,30304024.63
"7057",2018-01-09 04:59:57,22641.43,30326666.06
"7058",2018-01-09 04:59:57,94465.01,30421131.07
"7059",2018-01-09 04:59:57,16240.94,30437372.01
"7060",2018-01-09 04:59:57,-208837.13,30228534.88
"7061",2018-01-09 05:16:02,416107.06,30644641.94
"7062",2018-01-09 05:17:14,-133347.38,30511294.56
"7063",2018-01-09 05:22:37,343004.28,30854298.84
"7064",2018-01-09 05:33:49,-416107.06,30438191.78
"7065",2018-01-09 05:48:15,417465.97,30855657.75
"7066",2018-01-09 05:48:15,-343004.28,30512653.47
"20183",2018-01-09 05:48:15,777920.57,31290574.04
"7067",2018-01-09 05:53:05,431522.91,31722096.95
"20184",2018-01-09 05:53:05,147363.58,31869460.53
"7068",2018-01-09 06:22:40,139304.62,32008765.15
"7069",2018-01-09 06:22:40,24563.34,32033328.49
"7070",2018-01-09 06:22:40,217834.87,32251163.36
"7071",2018-01-09 06:22:40,-417465.97,31833697.39
"20185",2018-01-09 06:22:40,144300.87,31977998.26
"20186",2018-01-09 06:22:40,91519.34,32069517.6
"20187",2018-01-09 06:22:40,232023.89,32301541.49
"7072",2018-01-09 06:33:29,94369.67,32395911.16
"7073",2018-01-09 06:33:29,-813225.74,31582685.42
"7074",2018-01-09 06:45:59,-94369.67,31488315.75
"7075",2018-01-09 07:16:29,269087.15,31757402.9
"7076",2018-01-09 07:23:57,-269087.15,31488315.75
"20188",2018-01-09 07:23:57,468266.75,31956582.5
"20189",2018-01-09 07:50:48,496147.47,32452729.97
"20190",2018-01-09 07:50:48,666873.32,33119603.29
"7077",2018-01-09 09:39:48,475397.27,33595000.56
"20191",2018-01-09 09:39:48,-33119603.29,475397.270000033
"7078",2018-01-09 09:44:58,-475397.27,3.30619513988495e-08
"7079",2018-01-09 10:00:22,155467.62,155467.620000033
"7080",2018-01-09 10:06:36,-155467.62,3.30619513988495e-08
"7081",2018-01-09 10:57:22,1751213.43,1751213.43000003
"20192",2018-01-09 10:57:22,320734.77,2071948.20000003
"20193",2018-01-09 10:57:22,104987.74,2176935.94000003
"20194",2018-01-09 10:57:22,40629.07,2217565.01000003
"20195",2018-01-09 10:57:22,75733.14,2293298.15000003
"20196",2018-01-09 10:57:22,31340.5,2324638.65000003
"20197",2018-01-09 10:57:22,614765.81,2939404.46000003
"20198",2018-01-09 10:57:22,311878.07,3251282.53000003
"20199",2018-01-09 10:57:22,109094.6,3360377.13000003
"20200",2018-01-09 10:57:22,34110.78,3394487.91000003
"20201",2018-01-09 11:00:55,60802.04,3455289.95000003
"20202",2018-01-09 11:00:55,-1643274.48,1812015.47000003
"7082",2018-01-09 11:11:10,-1751213.43,60802.0400000329
"20203",2018-01-09 11:11:10,178383.05,239185.090000033
"20204",2018-01-09 11:11:10,777921.04,1017106.13000003
"20205",2018-01-09 11:11:10,71204.99,1088311.12000003
"20206",2018-01-09 11:11:10,116374.33,1204685.45000003
"20207",2018-01-09 11:11:10,21652,1226337.45000003
"20208",2018-01-09 11:11:10,17917.19,1244254.64000003
"20209",2018-01-09 11:11:10,-60802.04,1183452.60000003
"20210",2018-01-09 11:18:57,-1183452.6,3.28291207551956e-08
"7083",2018-01-09 11:34:07,366086.58,366086.580000033
"7084",2018-01-09 11:38:33,-366086.58,3.28291207551956e-08
"7085",2018-01-09 12:55:36,158651.91,158651.910000033
"7086",2018-01-09 13:05:37,-158651.91,3.28291207551956e-08
"20211",2018-01-09 13:05:37,48013.64,48013.6400000328
"7087",2018-01-09 13:25:22,190955.55,238969.190000033
"7088",2018-01-09 13:25:22,20776.24,259745.430000033
"7089",2018-01-09 13:25:22,285369.75,545115.180000033
"20212",2018-01-09 13:25:22,85664.12,630779.300000033
"20213",2018-01-09 13:25:22,777921.11,1408700.41000003
"7090",2018-01-09 13:30:57,303708.9,1712409.31000003
"7091",2018-01-09 13:30:57,339197.07,2051606.38000003
"7092",2018-01-09 13:30:57,-497101.54,1554504.84000003
"7093",2018-01-09 13:34:37,429384.23,1983889.07000003
"7094",2018-01-09 13:52:21,396578.42,2380467.49000003
"7095",2018-01-09 13:52:21,-642905.97,1737561.52000003
"7096",2018-01-09 14:07:43,91557.73,1829119.25000003
"7097",2018-01-09 14:07:43,-825962.65,1003156.60000003
"7098",2018-01-09 14:36:39,-91557.73,911598.870000033
"20214",2018-01-09 14:40:04,359040.01,1270638.88000003
"20215",2018-01-09 14:40:04,151033.77,1421672.65000003
"20216",2018-01-09 15:08:29,21287.32,1442959.97000003
"20217",2018-01-09 15:17:28,134514.71,1577474.68000003
"20218",2018-01-09 15:17:28,482241.37,2059716.05000003
"7099",2018-01-09 15:21:13,16749.57,2076465.62000003
"7100",2018-01-09 15:30:00,-16749.57,2059716.05000003
"20219",2018-01-09 16:25:01,130538.08,2190254.13000003
"7101",2018-01-09 16:37:57,276376.62,2466630.75000003
"20220",2018-01-09 16:37:57,219431.05,2686061.80000003
"20221",2018-01-09 17:09:08,37996.35,2724058.15000003
"20222",2018-01-09 17:44:40,545037.39,3269095.54000003
"7102",2018-01-09 17:44:56,-276376.62,2992718.92000003
"20223",2018-01-09 18:15:28,147292.52,3140011.44000003
"20224",2018-01-09 18:29:14,290115.89,3430127.33000003
"20225",2018-01-09 18:29:14,131893.44,3562020.77000003
"7103",2018-01-09 20:01:56,40199.84,3602220.61000003
"7104",2018-01-09 20:08:12,371867.99,3974088.60000003
"7105",2018-01-09 20:11:11,-40199.84,3933888.76000003
"7106",2018-01-09 20:27:42,-371867.99,3562020.77000003
"20226",2018-01-09 20:27:42,671305.92,4233326.69000003
"20227",2018-01-09 21:46:54,445787.75,4679114.44000003
"20228",2018-01-09 22:06:04,443299.42,5122413.86000003
"20229",2018-01-09 22:06:04,743399.76,5865813.62000003
"7107",2018-01-09 22:55:49,772603.06,6638416.68000003
"7108",2018-01-09 23:04:38,-772603.06,5865813.62000003
"20230",2018-01-09 23:04:38,397549.58,6263363.20000003
"20231",2018-01-09 23:33:38,426727.15,6690090.35000003
"20232",2018-01-09 23:33:38,407882.32,7097972.67000003
"7109",2018-01-09 23:34:26,662984.59,7760957.26000003
"7110",2018-01-09 23:37:18,-662984.59,7097972.67000003
"20233",2018-01-09 23:51:50,603341.37,7701314.04000003
"20234",2018-01-09 23:51:50,415174.06,8116488.10000003
"20235",2018-01-10 00:06:53,714069.22,8830557.32000003
"20236",2018-01-10 00:11:15,480139.68,9310697.00000003
"20237",2018-01-10 00:43:21,658463.55,9969160.55000003
"20238",2018-01-10 01:08:50,462256.46,10431417.01
"7111",2018-01-10 01:13:49,36196.53,10467613.54
"7112",2018-01-10 01:13:49,101717.35,10569330.89
"7113",2018-01-10 01:18:24,-137913.88,10431417.01
"7114",2018-01-10 03:45:53,601452.18,11032869.19
"20239",2018-01-10 03:45:53,710326.89,11743196.08
"7115",2018-01-10 03:58:37,-601452.18,11141743.9
"20240",2018-01-10 04:16:42,539846.5,11681590.4
"7116",2018-01-10 05:05:41,566638.61,12248229.01
"7117",2018-01-10 05:05:41,671299.06,12919528.07
"7118",2018-01-10 05:19:00,656481.82,13576009.89
"7119",2018-01-10 05:19:00,-1237937.67,12338072.22
"7120",2018-01-10 05:35:29,466263.91,12804336.13
"7121",2018-01-10 05:35:29,-656481.82,12147854.31
"7122",2018-01-10 05:45:18,469225.77,12617080.08
"7123",2018-01-10 05:45:18,598751.44,13215831.52
"7124",2018-01-10 05:45:18,-466263.91,12749567.61
"7125",2018-01-10 05:52:48,87142.53,12836710.14
"7126",2018-01-10 05:52:48,-1067977.21,11768732.93
"20241",2018-01-10 05:52:48,698096.52,12466829.45
"7127",2018-01-10 06:02:30,362809.81,12829639.26
"7128",2018-01-10 06:02:30,623384.48,13453023.74
"7129",2018-01-10 06:02:30,264815.82,13717839.56
"7130",2018-01-10 06:02:30,202773.26,13920612.82
"7131",2018-01-10 06:02:30,-87142.53,13833470.29
"7132",2018-01-10 06:11:17,413522.04,14246992.33
"7133",2018-01-10 06:11:17,-1453783.37,12793208.96
"7134",2018-01-10 06:11:32,583513.17,13376722.13
"7135",2018-01-10 06:22:53,380606.23,13757328.36
"7136",2018-01-10 06:22:53,254527.3,14011855.66
"7137",2018-01-10 06:22:53,-997035.21,13014820.45
"20242",2018-01-10 06:22:53,331058.33,13345878.78
"7138",2018-01-10 06:56:07,-635133.53,12710745.25
"7139",2018-01-10 07:29:58,748606.54,13459351.79
"7140",2018-01-10 07:29:58,777923.79,14237275.58
"7141",2018-01-10 07:29:58,399004.8,14636280.38
"7142",2018-01-10 07:47:10,-1925535.13,12710745.25
"20243",2018-01-10 07:47:10,585119.81,13295865.06
"20244",2018-01-10 07:47:10,406870.62,13702735.68
"7143",2018-01-10 08:22:42,464648.19,14167383.87
"20245",2018-01-10 08:22:42,835846.16,15003230.03
"7144",2018-01-10 08:30:23,-464648.19,14538581.84
"20246",2018-01-10 08:40:02,162453.76,14701035.6
"20247",2018-01-10 08:40:02,147369.07,14848404.67
"20248",2018-01-10 08:40:02,777924.06,15626328.73
"20249",2018-01-10 08:40:02,38978.22,15665306.95
"20250",2018-01-10 09:07:39,142141.17,15807448.12
"20251",2018-01-10 10:43:37,146647.16,15954095.28
"20252",2018-01-10 10:43:37,294832.14,16248927.42
"7145",2018-01-10 10:51:22,134604.11,16383531.53
"7146",2018-01-10 11:02:51,-134604.11,16248927.42
"20253",2018-01-10 11:33:45,331610.24,16580537.66
"20254",2018-01-10 11:33:45,118368.35,16698906.01
"20255",2018-01-10 11:53:14,106516.16,16805422.17
"20256",2018-01-10 11:58:05,12756.72,16818178.89
"20257",2018-01-10 11:58:05,40796.51,16858975.4
"7147",2018-01-10 12:05:17,23904.7,16882880.1
"20258",2018-01-10 12:05:17,16120.07,16899000.17
"20259",2018-01-10 12:05:17,15568.64,16914568.81
"20260",2018-01-10 12:05:17,26840.06,16941408.87
"7148",2018-01-10 12:17:54,-23904.7,16917504.17
"20261",2018-01-10 12:24:58,118040.44,17035544.61
"20262",2018-01-10 12:40:53,407780.63,17443325.24
"20263",2018-01-10 12:43:25,105808.83,17549134.07
"20264",2018-01-10 13:10:02,263078.01,17812212.08
"7149",2018-01-10 13:13:10,319638.08,18131850.16
"20265",2018-01-10 13:13:10,648516.93,18780367.09
"7150",2018-01-10 13:16:57,53909.6,18834276.69
"7151",2018-01-10 13:16:57,115773.07,18950049.76
"7152",2018-01-10 13:16:57,-319638.08,18630411.68
"7153",2018-01-10 13:20:59,514722.6,19145134.28
"7154",2018-01-10 13:35:52,-684405.27,18460729.01
"20266",2018-01-10 13:38:48,416884.76,18877613.77
"7155",2018-01-10 14:41:38,577748.72,19455362.49
"20267",2018-01-10 14:41:38,207016.83,19662379.32
"20268",2018-01-10 14:41:38,96166.01,19758545.33
"20269",2018-01-10 14:41:38,73844.82,19832390.15
"7156",2018-01-10 14:54:11,-577748.72,19254641.43
"20270",2018-01-10 14:57:04,347595.7,19602237.13
"20271",2018-01-10 14:57:25,41083.64,19643320.77
"7157",2018-01-10 15:08:49,395099.95,20038420.72
"20272",2018-01-10 15:08:49,294588.34,20333009.06
"20273",2018-01-10 15:08:49,231358.05,20564367.11
"20274",2018-01-10 15:08:49,610098.59,21174465.7
"20275",2018-01-10 15:08:49,201180.46,21375646.16
"20276",2018-01-10 15:08:49,74986.64,21450632.8
"20277",2018-01-10 15:08:49,242869.21,21693502.01
"20278",2018-01-10 15:08:49,14177.47,21707679.48
"20279",2018-01-10 15:10:18,11920.36,21719599.84
"7158",2018-01-10 15:22:21,-395099.95,21324499.89
"20280",2018-01-10 15:22:21,129850.01,21454349.9
"20281",2018-01-10 15:22:21,154657.21,21609007.11
"20282",2018-01-10 15:22:21,407800.34,22016807.45
"20283",2018-01-10 16:02:56,352656.85,22369464.3
"20284",2018-01-10 16:02:56,162138.23,22531602.53
"7159",2018-01-10 16:20:21,207610.85,22739213.3800001
"7160",2018-01-10 16:29:57,-207610.85,22531602.53
"20285",2018-01-10 17:10:51,59064.49,22590667.02
"20286",2018-01-10 17:10:51,119989.95,22710656.97
"7161",2018-01-10 17:16:14,516155.85,23226812.82
"7162",2018-01-10 17:22:53,-516155.85,22710656.97
"7163",2018-01-10 18:07:10,89228.19,22799885.16
"7164",2018-01-10 18:07:10,29392.3,22829277.46
"7165",2018-01-10 18:14:33,-118620.49,22710656.9700001
"20287",2018-01-10 18:14:33,246951.37,22957608.3400001
"20288",2018-01-10 21:03:56,321865.41,23279473.7500001
"7166",2018-01-10 21:18:31,209332.43,23488806.1800001
"7167",2018-01-10 21:42:21,-209332.43,23279473.7500001
"7168",2018-01-10 21:58:27,670528.84,23950002.5900001
"7169",2018-01-10 22:12:17,-670528.84,23279473.7500001
"7170",2018-01-10 22:33:39,491550.31,23771024.0600001
"7171",2018-01-10 22:48:50,-491550.31,23279473.7500001
"7172",2018-01-10 23:06:42,365036.35,23644510.1000001
"7173",2018-01-10 23:06:42,346068.65,23990578.7500001
"20289",2018-01-10 23:06:42,516423.77,24507002.5200001
"7174",2018-01-10 23:34:00,398328.1,24905330.6200001
"7175",2018-01-10 23:34:00,-711105,24194225.6200001
"7176",2018-01-10 23:51:45,-398328.1,23795897.5200001
"20290",2018-01-11 00:00:42,295595.36,24091492.8800001
"20291",2018-01-11 00:00:42,165112.91,24256605.7900001
"20292",2018-01-11 00:00:42,61075.42,24317681.2100001
"20293",2018-01-11 00:00:42,42657.61,24360338.8200001
"20294",2018-01-11 00:06:50,28941.29,24389280.1100001
"7177",2018-01-11 00:26:59,490758.94,24880039.0500001
"20295",2018-01-11 00:26:59,777925.29,25657964.3400001
"20296",2018-01-11 00:26:59,113545.82,25771510.1600001
"20297",2018-01-11 00:26:59,201846.3,25973356.4600001
"7178",2018-01-11 00:31:02,-490758.94,25482597.5200001
"7179",2018-01-11 01:06:53,560170.89,26042768.4100001
"7180",2018-01-11 01:22:03,-560170.89,25482597.5200001
"7181",2018-01-11 02:04:09,434365.99,25916963.5100001
"7182",2018-01-11 02:12:25,-434365.99,25482597.5200001
"7183",2018-01-11 02:52:52,754668.73,26237266.2500001
"7184",2018-01-11 03:04:48,-754668.73,25482597.5200001
"7185",2018-01-11 03:36:10,82461.97,25565059.4900001
"7186",2018-01-11 03:36:10,501692.15,26066751.64
"7187",2018-01-11 03:36:10,794165.54,26860917.18
"7188",2018-01-11 03:45:26,211321.38,27072238.56
"7189",2018-01-11 03:45:26,131392.2,27203630.76
"7190",2018-01-11 03:45:26,136508.13,27340138.89
"7191",2018-01-11 03:45:26,-1378319.66,25961819.23
"7192",2018-01-11 03:50:15,-479221.71,25482597.52
"7193",2018-01-11 04:05:11,1358976.8,26841574.32
"7194",2018-01-11 04:09:12,777925.51,27619499.83
"7195",2018-01-11 04:09:12,-1358976.8,26260523.03
"7196",2018-01-11 04:10:22,144547.52,26405070.55
"7197",2018-01-11 04:21:00,-922473.03,25482597.52
"7198",2018-01-11 04:33:09,777925.58,26260523.1
"7199",2018-01-11 04:33:09,176228.85,26436751.95
"7200",2018-01-11 04:33:09,659056.91,27095808.86
"7201",2018-01-11 04:33:09,9171.59,27104980.45
"7202",2018-01-11 04:33:09,41157.77,27146138.22
"7203",2018-01-11 04:33:09,279950.52,27426088.74
"7204",2018-01-11 04:41:33,590163.66,28016252.4
"7205",2018-01-11 04:41:33,777925.65,28794178.05
"7206",2018-01-11 04:41:33,19233.7,28813411.75
"7207",2018-01-11 04:41:33,777925.64,29591337.39
"7208",2018-01-11 04:41:33,-1943491.22,27647846.17
"20298",2018-01-11 04:41:33,228343.92,27876190.09
"20299",2018-01-11 04:41:33,310446.7,28186636.79
"20300",2018-01-11 04:41:33,777925.68,28964562.47
"20301",2018-01-11 04:41:33,777925.69,29742488.16
"7209",2018-01-11 05:28:34,98714.55,29841202.71
"7210",2018-01-11 05:28:34,-2165248.65,27675954.06
"20302",2018-01-11 05:28:34,86184.97,27762139.03
"20303",2018-01-11 05:28:34,117014.82,27879153.85
"20304",2018-01-11 05:28:34,280865.52,28160019.37
"20305",2018-01-11 05:28:34,346843.22,28506862.59
"20306",2018-01-11 05:28:34,278608.67,28785471.26
"20307",2018-01-11 05:28:34,777925.81,29563397.07
"20308",2018-01-11 05:28:34,199975.03,29763372.1
"7211",2018-01-11 05:38:30,462286.64,30225658.74
"7212",2018-01-11 06:02:41,777925.9,31003584.64
"7213",2018-01-11 06:02:41,777925.89,31781510.53
"7214",2018-01-11 06:02:41,427401.91,32208912.44
"7215",2018-01-11 06:02:41,-561001.19,31647911.25
"20309",2018-01-11 06:02:41,176467.7,31824378.95
"20310",2018-01-11 06:02:41,78705.5,31903084.45
"7216",2018-01-11 06:08:52,734401.82,32637486.27
"7217",2018-01-11 06:17:24,-1983253.7,30654232.57
"20311",2018-01-11 06:17:24,144028.38,30798260.95
"20312",2018-01-11 06:24:10,226327.42,31024588.37
"20313",2018-01-11 06:24:10,285350.81,31309939.18
"20314",2018-01-11 06:24:10,154011.95,31463951.13
"7218",2018-01-11 06:30:29,-734401.82,30729549.31
"20315",2018-01-11 06:40:28,695367.11,31424916.42
"20316",2018-01-11 06:40:28,536171.02,31961087.44
"20317",2018-01-11 06:57:56,592811.76,32553899.2
"7219",2018-01-11 07:09:39,451150.03,33005049.23
"7220",2018-01-11 07:15:23,777926.02,33782975.25
"7221",2018-01-11 07:15:23,-451150.03,33331825.22
"20318",2018-01-11 07:15:23,359010.69,33690835.91
"7222",2018-01-11 07:21:49,-777926.02,32912909.89
"20319",2018-01-11 07:21:49,269557.12,33182467.01
"7223",2018-01-11 07:33:54,270857.48,33453324.49
"7224",2018-01-11 07:33:54,152881.47,33606205.96
"7225",2018-01-11 07:52:14,-423738.95,33182467.01
"7226",2018-01-11 08:43:18,536929.24,33719396.25
"20320",2018-01-11 08:43:18,527177.51,34246573.76
"20321",2018-01-11 08:43:18,220635.87,34467209.63
"7227",2018-01-11 08:51:19,-536929.24,33930280.39
"20322",2018-01-11 08:51:19,389652.49,34319932.88
"7228",2018-01-11 08:52:37,261527.68,34581460.56
"7229",2018-01-11 08:57:40,436898.77,35018359.33
"7230",2018-01-11 08:57:40,340185.64,35358544.97
"7231",2018-01-11 08:57:40,-261527.68,35097017.29
"7232",2018-01-11 09:08:08,-777084.41,34319932.88
"20323",2018-01-11 09:08:08,166316.77,34486249.6500001
"20324",2018-01-11 09:08:08,107547.82,34593797.4700001
"20325",2018-01-11 09:08:08,153253.88,34747051.3500001
"20326",2018-01-11 09:23:24,517301.43,35264352.7800001
"20327",2018-01-11 09:23:24,773833.85,36038186.6300001
"20328",2018-01-11 09:23:24,-34747051.35,1291135.28000005
"20329",2018-01-11 09:38:03,-1291135.28,5.33182173967361e-08
"20330",2018-01-11 10:29:58,734123.71,734123.710000053
"20331",2018-01-11 11:11:44,269071.26,1003194.97000005
"20332",2018-01-11 11:25:18,624250.88,1627445.85000005
"7233",2018-01-11 12:29:34,563259.58,2190705.43000005
"20333",2018-01-11 12:29:34,480697.06,2671402.49000005
"7234",2018-01-11 12:59:23,-563259.58,2108142.91000005
"20334",2018-01-11 12:59:23,535989.59,2644132.50000005
"20335",2018-01-11 12:59:23,21878.44,2666010.94000005
"20336",2018-01-11 12:59:23,777926.43,3443937.37000005
"20337",2018-01-11 13:45:30,405264.49,3849201.86000005
"20338",2018-01-11 13:54:39,230416.49,4079618.35000005
"20339",2018-01-11 13:54:39,777926.48,4857544.83000005
"7235",2018-01-11 20:00:30,401241.99,5258786.82000005
"7236",2018-01-11 20:04:28,320241.76,5579028.58000005
"7237",2018-01-11 20:04:28,-401241.99,5177786.59000005
"7238",2018-01-11 20:06:36,514018.89,5691805.48000005
"7239",2018-01-11 20:06:36,777926.88,6469732.36000005
"7240",2018-01-11 20:30:38,-320241.76,6149490.60000005
"20340",2018-01-11 20:30:38,409967.87,6559458.47000005
"7241",2018-01-11 20:42:13,385268.91,6944727.38000005
"7242",2018-01-11 20:42:13,424093.18,7368820.56000005
"7243",2018-01-11 20:42:13,-1291945.77,6076874.79000005
"7244",2018-01-11 20:42:13,401242.09,6478116.88000005
"7245",2018-01-11 20:50:12,169311.98,6647428.86000005
"7246",2018-01-11 20:50:12,180746.72,6828175.58000005
"7247",2018-01-11 20:50:12,-1210604.18,5617571.40000005
"7248",2018-01-11 20:54:14,-350058.7,5267512.70000005
"20341",2018-01-11 21:13:18,401242.14,5668754.84000005
"7249",2018-01-11 22:23:21,196179.8,5864934.64000005
"7250",2018-01-11 22:30:28,-196179.8,5668754.84000005
"7251",2018-01-11 23:34:15,331714.06,6000468.90000005
"7252",2018-01-11 23:34:15,25355.23,6025824.13000005
"7253",2018-01-11 23:34:15,412048.95,6437873.08000005
"20342",2018-01-11 23:34:15,777927.07,7215800.15000005
"20343",2018-01-11 23:34:15,777927.08,7993727.23000005
"7254",2018-01-11 23:56:21,-769118.24,7224608.99000005
"7255",2018-01-12 00:03:46,203821.79,7428430.78000005
"7256",2018-01-12 00:12:00,-203821.79,7224608.99000005
"20344",2018-01-12 00:48:46,506280.81,7730889.80000005
"20345",2018-01-12 00:48:46,160028.76,7890918.56000005
"7257",2018-01-12 00:57:25,697361.23,8588279.79000005
"7258",2018-01-12 00:57:25,777927.22,9366207.01000005
"20346",2018-01-12 00:57:25,340040.24,9706247.25000005
"20347",2018-01-12 00:57:25,20638.86,9726886.11000005
"7259",2018-01-12 01:03:56,-1475288.45,8251597.66000005
"20348",2018-01-12 01:03:56,369787.01,8621384.67000005
"20349",2018-01-12 01:14:54,48367.08,8669751.75000005
"7260",2018-01-12 01:43:52,420836.13,9090587.88000005
"7261",2018-01-12 01:47:28,-420836.13,8669751.75000005
"7262",2018-01-12 02:57:44,1047057.7,9716809.45000005
"7263",2018-01-12 03:01:43,-1047057.7,8669751.75000005
"20350",2018-01-12 03:17:59,161997.53,8831749.28000005
"20351",2018-01-12 03:17:59,92665.73,8924415.01000005
"7264",2018-01-12 11:03:32,592859.53,9517274.54000005
"7265",2018-01-12 11:08:13,-592859.53,8924415.01000005
"7266",2018-01-12 13:09:52,416634.3,9341049.31000005
"20352",2018-01-12 13:12:21,-8924415.01,416634.300000055
"7267",2018-01-12 13:16:23,599425.11,1016059.41000005
"7268",2018-01-12 13:16:23,-416634.3,599425.110000055
"7269",2018-01-12 13:22:04,-599425.11,5.48316165804863e-08
"7270",2018-01-12 13:39:33,134268.03,134268.030000055
"7271",2018-01-12 13:39:33,1460066.22,1594334.25000005
"7272",2018-01-12 13:48:20,-1594334.25,5.47152012586594e-08
"20353",2018-01-12 13:48:20,15927.87,15927.8700000547
"20354",2018-01-12 14:03:44,-15927.87,5.47152012586594e-08
"20355",2018-01-12 14:03:44,322109.3,322109.300000055
"20356",2018-01-12 14:13:58,-322109.3,5.47152012586594e-08
"20357",2018-01-12 14:39:29,702489.97,702489.970000055
"20358",2018-01-12 15:02:18,-702489.97,5.47152012586594e-08
"7273",2018-01-12 16:19:44,643348.15,643348.150000055
"7274",2018-01-12 16:22:58,-643348.15,5.47152012586594e-08
"20359",2018-01-13 01:33:12,436183.9,436183.900000055
"20360",2018-01-13 01:33:12,777927.9,1214111.80000005
"20361",2018-01-13 01:53:59,139142.91,1353254.71000005
"7275",2018-01-13 06:47:58,696573.92,2049828.63000005
"7276",2018-01-13 06:52:25,-696573.92,1353254.71000005
"7277",2018-01-13 07:22:20,777927.94,2131182.65000005
"7278",2018-01-13 07:22:20,121025.95,2252208.60000006
"7279",2018-01-13 07:32:42,-898953.89,1353254.71000005
"7280",2018-01-13 08:35:05,427032.92,1780287.63000005
"7281",2018-01-13 08:47:54,-427032.92,1353254.71000005
"7282",2018-01-13 08:51:50,463204.76,1816459.47000005
"7283",2018-01-13 08:58:12,-463204.76,1353254.71000005
"20362",2018-01-13 09:38:51,-1353254.71,5.49480319023132e-08
"7284",2018-01-13 11:05:34,417523.12,417523.120000055
"7285",2018-01-13 11:05:34,777928.11,1195451.23000005
"7286",2018-01-13 11:10:10,-1195451.23,5.49480319023132e-08
"7287",2018-01-13 12:27:32,777928.15,777928.150000055
"7288",2018-01-13 12:29:34,685833.16,1463761.31000006
"7289",2018-01-13 12:53:19,-1463761.31,5.49480319023132e-08
"7290",2018-01-13 13:27:07,777928.22,777928.220000055
"7291",2018-01-13 13:27:07,777928.21,1555856.43000005
"7292",2018-01-13 13:27:07,225808.23,1781664.66000005
"20363",2018-01-13 13:27:07,383888.63,2165553.29000005
"7293",2018-01-13 13:33:54,-1781664.66,383888.630000055
"20364",2018-01-13 13:43:47,433972.77,817861.400000055
"20365",2018-01-13 13:43:47,527943.36,1345804.76000006
"7294",2018-01-13 13:51:31,777928.31,2123733.07000006
"7295",2018-01-13 14:12:01,412016.32,2535749.39000006
"7296",2018-01-13 14:12:01,-777928.31,1757821.08000006
"7297",2018-01-13 14:23:21,-412016.32,1345804.76000005
"7298",2018-01-13 16:11:46,669369.91,2015174.67000005
"7299",2018-01-13 16:25:12,-669369.91,1345804.76000005
"7300",2018-01-13 16:30:55,1162668.13,2508472.89000005
"7301",2018-01-13 16:37:11,-1162668.13,1345804.76000005
"20366",2018-01-13 16:44:02,63104.39,1408909.15000005
"20367",2018-01-13 17:01:53,251757.58,1660666.73000005
"20368",2018-01-13 17:32:18,1133927.85,2794594.58000006
"20369",2018-01-13 17:32:18,970784.09,3765378.67000005
"20370",2018-01-13 17:32:18,828906.63,4594285.30000005
"20371",2018-01-13 17:50:08,1206173.24,5800458.54000005
"7302",2018-01-13 19:05:57,1066001.36,6866459.90000006
"7303",2018-01-13 19:26:36,-1066001.36,5800458.54000005
"7304",2018-01-14 00:52:37,612645.85,6413104.39000005
"7305",2018-01-14 00:52:37,768204.45,7181308.84000005
"7306",2018-01-14 00:57:35,-1380850.3,5800458.54000005
"7307",2018-01-14 05:39:14,1777928.83,7578387.37000006
"7308",2018-01-14 05:39:14,323087.84,7901475.21000005
"7309",2018-01-14 05:44:08,-2101016.67,5800458.54000005
"20372",2018-01-14 06:14:30,147949.53,5948408.07000006
"20373",2018-01-14 07:57:22,1193120.8,7141528.87000006
"7310",2018-01-14 12:17:44,814975.24,7956504.11000006
"7311",2018-01-14 12:27:47,1170659.48,9127163.59000006
"7312",2018-01-14 12:27:47,-814975.24,8312188.35000006
"7313",2018-01-14 12:43:36,996388.28,9308576.63000005
"7314",2018-01-14 12:43:36,-1170659.48,8137917.15000005
"7315",2018-01-14 12:56:44,-996388.28,7141528.87000005
"7316",2018-01-14 15:40:11,777930.27,7919459.14000005
"7317",2018-01-14 15:48:52,-777930.27,7141528.87000006
"7318",2018-01-14 19:37:58,1777931.93,8919460.80000005
"7319",2018-01-14 19:37:58,725309.95,9644770.75000005
"7320",2018-01-14 19:37:58,1777931.94,11422702.6900001
"20374",2018-01-14 19:37:58,1777931.96,13200634.6500001
"20375",2018-01-14 19:37:58,1777931.97,14978566.6200001
"20376",2018-01-14 19:37:58,618909.98,15597476.6000001
"7321",2018-01-14 19:40:46,-4281173.82,11316302.7800001
"7322",2018-01-14 20:34:44,1467511.43,12783814.2100001
"20377",2018-01-14 20:34:44,469691.43,13253505.6400001
"7323",2018-01-14 20:40:50,-1467511.43,11785994.2100001
"7324",2018-01-14 23:15:58,335574.42,12121568.6300001
"7325",2018-01-14 23:28:36,108249.85,12229818.4800001
"7326",2018-01-14 23:28:36,458729.72,12688548.2000001
"7327",2018-01-14 23:28:36,-335574.42,12352973.7800001
"7328",2018-01-14 23:34:09,-566979.57,11785994.2100001
"7329",2018-01-15 02:38:58,505200.04,12291194.2500001
"7330",2018-01-15 02:51:39,338700.4,12629894.6500001
"7331",2018-01-15 02:51:39,-505200.04,12124694.6100001
"7332",2018-01-15 03:22:09,-338700.4,11785994.2100001
"7333",2018-01-15 04:03:12,1179332.93,12965327.1400001
"20378",2018-01-15 04:03:12,196500.48,13161827.6200001
"7334",2018-01-15 04:46:56,-1179332.93,11982494.6900001
"20379",2018-01-15 04:46:56,803491.29,12785985.9800001
"7335",2018-01-15 05:35:55,539897.88,13325883.8600001
"7336",2018-01-15 06:03:57,-539897.88,12785985.9800001
"7337",2018-01-15 06:33:22,785749.18,13571735.1600001
"7338",2018-01-15 06:40:15,-785749.18,12785985.9800001
"7339",2018-01-15 07:55:20,1064751.3,13850737.2800001
"7340",2018-01-15 08:18:29,615254.89,14465992.1700001
"7341",2018-01-15 08:18:29,633832.06,15099824.2300001
"7342",2018-01-15 08:18:29,-1064751.3,14035072.9300001
"20380",2018-01-15 08:18:29,-12785985.98,1249086.95000006
"7343",2018-01-15 08:22:08,843030.37,2092117.32000006
"7344",2018-01-15 08:26:59,-2092117.32,5.70435076951981e-08
"20381",2018-01-15 08:35:22,110883.23,110883.230000057
"20382",2018-01-15 08:55:49,-110883.23,5.70435076951981e-08
"20383",2018-01-15 08:55:49,63117.26,63117.260000057
"20384",2018-01-15 09:04:45,-63117.26,5.70435076951981e-08
"20385",2018-01-15 09:20:55,1484055.04,1484055.04000006
"7345",2018-01-15 09:25:36,170795.8,1654850.84000006
"20386",2018-01-15 09:25:36,-1484055.04,170795.800000057
"7346",2018-01-15 09:28:56,-170795.8,5.71017153561115e-08
"7347",2018-01-15 11:43:10,889044.14,889044.140000057
"7348",2018-01-15 11:43:10,889044.18,1778088.32000006
"7349",2018-01-15 11:43:10,889044.19,2667132.51000006
"7350",2018-01-15 11:55:10,-2667132.51,5.72763383388519e-08
"7351",2018-01-15 14:09:28,1031187.26,1031187.26000006
"7352",2018-01-15 14:09:28,1777934.31,2809121.57000006
"7353",2018-01-15 14:09:28,669385.33,3478506.90000006
"7354",2018-01-15 14:09:28,1777934.32,5256441.22000006
"20387",2018-01-15 14:09:28,1253105.3,6509546.52000006
"20388",2018-01-15 14:09:28,1777934.29,8287480.81000006
"20389",2018-01-15 14:09:28,1777934.28,10065415.0900001
"7355",2018-01-15 14:33:33,-5256441.22,4808973.87000006
"20390",2018-01-15 15:42:26,1189168.96,5998142.83000006
"7356",2018-01-15 16:40:07,763007.2,6761150.03000006
"7357",2018-01-15 16:52:17,-763007.2,5998142.83000006
"7358",2018-01-15 17:32:23,734192.74,6732335.57000006
"7359",2018-01-15 17:52:07,-734192.74,5998142.83000006
"7360",2018-01-15 19:21:08,727771.69,6725914.52000006
"7361",2018-01-15 19:31:19,-727771.69,5998142.83000006
"7362",2018-01-15 20:21:18,732909.41,6731052.24000006
"7363",2018-01-15 20:41:22,-732909.41,5998142.83000006
"7364",2018-01-16 00:31:16,1394646.24,7392789.07000006
"7365",2018-01-16 00:36:03,194581.82,7587370.89000006
"7366",2018-01-16 00:36:03,-1394646.24,6192724.65000006
"20391",2018-01-16 00:39:05,1525259.53,7717984.18000006
"7367",2018-01-16 01:08:38,1652225.35,9370209.53000006
"7368",2018-01-16 01:08:38,-194581.82,9175627.71000006
"7369",2018-01-16 01:18:53,-1652225.35,7523402.36000006
"7370",2018-01-16 02:42:34,1439408.78,8962811.14000006
"20392",2018-01-16 02:42:34,345118.33,9307929.47000006
"7371",2018-01-16 02:57:40,-1439408.78,7868520.69000006
"20393",2018-01-16 03:10:08,165695.52,8034216.21000006
"20394",2018-01-16 03:10:08,678877.22,8713093.43000006
"20395",2018-01-16 04:21:15,1006587.27,9719680.70000006
"20396",2018-01-16 04:27:58,724617.92,10444298.6200001
"7372",2018-01-16 06:25:50,910217.45,11354516.0700001
"20397",2018-01-16 06:25:50,167365.3,11521881.3700001
"7373",2018-01-16 07:08:40,1020991.24,12542872.6100001
"7374",2018-01-16 07:08:40,-910217.45,11632655.1600001
"7375",2018-01-16 07:18:27,-1020991.24,10611663.9200001
"20398",2018-01-16 07:28:21,-10611663.92,5.77419996261597e-08
"20399",2018-01-16 07:58:27,146844.87,146844.870000058
"20400",2018-01-16 07:58:27,1777934.86,1924779.73000006
"7376",2018-01-16 08:14:37,1214887.22,3139666.95000006
"20401",2018-01-16 08:14:37,1396105.48,4535772.43000006
"20402",2018-01-16 08:14:37,-1924779.73,2610992.70000006
"20403",2018-01-16 08:17:47,-1396105.48,1214887.22000006
"7377",2018-01-16 09:08:53,553705.02,1768592.24000006
"7378",2018-01-16 09:08:53,215960.82,1984553.06000006
"7379",2018-01-16 09:08:53,25833.1,2010386.16000006
"7380",2018-01-16 09:08:53,24529.64,2034915.80000006
"7381",2018-01-16 09:08:53,806913.24,2841829.04000006
"7382",2018-01-16 09:08:53,-1214887.22,1626941.82000006
"20404",2018-01-16 09:08:53,459712.46,2086654.28000006
"20405",2018-01-16 09:08:53,936051.83,3022706.11000006
"20406",2018-01-16 09:08:53,92103.08,3114809.19000006
"20407",2018-01-16 09:08:53,150211.88,3265021.07000006
"20408",2018-01-16 09:08:53,70550.57,3335571.64000006
"20409",2018-01-16 09:08:53,182128.9,3517700.54000006
"20410",2018-01-16 09:08:53,134580.17,3652280.71000006
"20411",2018-01-16 09:08:53,119887.01,3772167.72000006
"20412",2018-01-16 09:08:53,13336.4,3785504.12000006
"20413",2018-01-16 09:19:43,1679134.61,5464638.73000006
"20414",2018-01-16 09:19:43,329755.43,5794394.16000006
"20415",2018-01-16 09:19:43,141412.25,5935806.41000006
"20416",2018-01-16 09:19:43,-2158562.3,3777244.11000006
"7383",2018-01-16 10:02:36,28272.92,3805517.03000006
"7384",2018-01-16 10:02:36,1777935.17,5583452.20000006
"7385",2018-01-16 10:02:36,468399.18,6051851.38000006
"7386",2018-01-16 10:02:36,-1626941.82,4424909.56000006
"20417",2018-01-16 10:02:36,1019846.82,5444756.38000006
"20418",2018-01-16 10:02:36,107383.01,5552139.39000006
"20419",2018-01-16 10:02:36,9696.19,5561835.58000006
"20420",2018-01-16 10:02:36,1755227.28,7317062.86000006
"20421",2018-01-16 10:02:36,-2150302.29,5166760.57000006
"20422",2018-01-16 10:12:50,-2892153.3,2274607.27000006
"7387",2018-01-16 10:25:55,-2274607.27,5.72763383388519e-08
"20423",2018-01-16 10:25:55,87580.57,87580.5700000573
"20424",2018-01-16 10:25:55,15313.23,102893.800000057
"20425",2018-01-16 10:25:55,29488,132381.800000057
"20426",2018-01-16 10:36:46,1322027,1454408.80000006
"20427",2018-01-16 10:36:46,40060.48,1494469.28000006
"20428",2018-01-16 10:36:46,248638.54,1743107.82000006
"20429",2018-01-16 10:36:46,9789.68,1752897.50000006
"20430",2018-01-16 10:44:34,718562.26,2471459.76000006
"7388",2018-01-16 10:59:01,191839.38,2663299.14000006
"7389",2018-01-16 11:09:17,-191839.38,2471459.76000006
"7390",2018-01-16 12:33:48,498884.98,2970344.74000006
"7391",2018-01-16 13:04:38,457332.67,3427677.41000006
"7392",2018-01-16 13:04:38,446189.38,3873866.79000006
"7393",2018-01-16 13:04:38,-498884.98,3374981.81000006
"7394",2018-01-16 13:12:27,-903522.05,2471459.76000006
"20431",2018-01-16 13:31:58,1370748.11,3842207.87000006
"7395",2018-01-16 13:39:07,749012.56,4591220.43000006
"7396",2018-01-16 13:58:13,1552356.25,6143576.68000006
"7397",2018-01-16 13:58:13,-749012.56,5394564.12000006
"7398",2018-01-16 14:09:38,-1552356.25,3842207.87000006
"7399",2018-01-16 14:38:20,1777935.64,5620143.51000006
"7400",2018-01-16 14:38:20,191707.65,5811851.16000006
"7401",2018-01-16 14:39:55,840106.62,6651957.78000006
"7402",2018-01-16 14:43:33,-1969643.29,4682314.49000006
"7403",2018-01-16 14:54:22,-840106.62,3842207.87000006
"7404",2018-01-16 17:04:19,522526.93,4364734.80000006
"7405",2018-01-16 17:04:19,129610.98,4494345.78000006
"7406",2018-01-16 17:06:59,16121.23,4510467.01000006
"7407",2018-01-16 17:09:45,-652137.91,3858329.10000006
"7408",2018-01-16 17:17:30,-16121.23,3842207.87000006
"7409",2018-01-16 17:31:16,971882.79,4814090.66000006
"7410",2018-01-16 17:37:32,-971882.79,3842207.87000006
"7411",2018-01-16 18:01:01,277107.92,4119315.79000006
"7412",2018-01-16 18:01:01,1777935.91,5897251.70000006
"7413",2018-01-16 18:05:38,-2055043.83,3842207.87000006
"20432",2018-01-16 18:17:46,1737142.56,5579350.43000006
"7414",2018-01-16 18:20:38,55401.96,5634752.39000006
"7415",2018-01-16 18:20:38,1777935.95,7412688.34000006
"7416",2018-01-16 18:22:16,24999.47,7437687.81000006
"7417",2018-01-16 18:32:03,913133.32,8350821.13000006
"7418",2018-01-16 18:32:03,15660.25,8366481.38000006
"7419",2018-01-16 18:32:03,504101.85,8870583.23000006
"7420",2018-01-16 18:32:03,-1833337.91,7037245.32000006
"7421",2018-01-16 18:40:45,1334220.33,8371465.65000006
"7422",2018-01-16 18:40:45,-1457894.89,6913570.76000006
"7423",2018-01-16 18:49:23,-1334220.33,5579350.43000006
"20433",2018-01-16 18:49:23,1616450.93,7195801.36000006
"7424",2018-01-16 19:08:51,984840.03,8180641.39000006
"7425",2018-01-16 19:12:42,881269.26,9061910.65000006
"7426",2018-01-16 19:12:42,-984840.03,8077070.62000006
"7427",2018-01-16 19:33:00,995155.02,9072225.64000006
"7428",2018-01-16 19:33:00,-881269.26,8190956.38000006
"7429",2018-01-16 19:45:02,-995155.02,7195801.36000006
"7430",2018-01-16 21:55:24,889048.33,8084849.69000006
"7431",2018-01-16 23:07:20,889049.15,8973898.84000006
"7432",2018-01-16 23:21:40,943167.5,9917066.34000006
"7433",2018-01-16 23:56:37,1777938.23,11695004.5700001
"7434",2018-01-16 23:56:37,1777938.22,13472942.7900001
"7435",2018-01-16 23:56:37,129931.24,13602874.0300001
"20434",2018-01-16 23:56:37,1777938.2,15380812.2300001
"20435",2018-01-16 23:56:37,989736.21,16370548.4400001
"7436",2018-01-17 00:25:14,1198733.23,17569281.6700001
"20436",2018-01-17 02:55:39,852974.56,18422256.2300001
"20437",2018-01-17 03:05:54,1187986.64,19610242.8700001
"20438",2018-01-17 03:31:00,905340.15,20515583.0200001
"20439",2018-01-17 03:34:41,1392242.48,21907825.5000001
"20440",2018-01-17 04:55:12,1112880.39,23020705.8900001
"20441",2018-01-17 05:40:29,1598344.15,24619050.0400001
"20442",2018-01-17 06:38:44,1429939.33,26048989.3700001
"7437",2018-01-17 08:53:55,-7605805.9,18443183.4700001
"20443",2018-01-17 09:01:15,-18443183.47,5.96046447753906e-08
"20444",2018-01-17 10:51:56,159581.84,159581.84000006
"20445",2018-01-17 11:03:22,664247.47,823829.31000006
"20446",2018-01-17 11:30:05,979691.05,1803520.36000006
"20447",2018-01-17 12:54:50,615237.74,2418758.10000006
"20448",2018-01-17 12:54:50,647569.95,3066328.05000006
"20449",2018-01-17 12:54:50,405040.67,3471368.72000006
"20450",2018-01-17 12:54:50,755889.52,4227258.24000006
"20451",2018-01-17 12:54:50,58761.39,4286019.63000006
"20452",2018-01-17 14:45:45,1052530.46,5338550.09000006
"20453",2018-01-17 14:50:24,816189.88,6154739.97000006
"20454",2018-01-17 15:11:59,825217.09,6979957.06000006
"20455",2018-01-17 15:11:59,1205852.12,8185809.18000006
"20456",2018-01-17 15:54:16,1777938.94,9963748.12000006
"20457",2018-01-17 15:54:16,376048.95,10339797.0700001
"20458",2018-01-17 16:38:38,1294506.04,11634303.1100001
"20459",2018-01-17 16:38:38,1777939.03,13412242.1400001
"7438",2018-01-17 17:03:41,3485547.15,16897789.2900001
"7439",2018-01-17 17:13:33,900786.58,17798575.8700001
"7440",2018-01-17 17:13:33,-3485547.15,14313028.7200001
"7441",2018-01-17 17:19:00,-900786.58,13412242.1400001
"7442",2018-01-17 20:37:10,1777940.95,15190183.0900001
"7443",2018-01-17 20:37:10,1777940.94,16968124.0300001
"7444",2018-01-17 20:37:10,608309.96,17576433.9900001
"7445",2018-01-17 20:58:16,-4164191.85,13412242.1400001
"7446",2018-01-17 23:06:11,4524934.48,17937176.6200001
"7447",2018-01-17 23:12:13,-4524934.48,13412242.1400001
"7448",2018-01-17 23:18:32,1308440.87,14720683.0100001
"7449",2018-01-17 23:24:38,715760.13,15436443.1400001
"7450",2018-01-17 23:24:38,1777941.12,17214384.2600001
"7451",2018-01-17 23:24:38,-1308440.87,15905943.3900001
"7452",2018-01-17 23:37:38,-2493701.25,13412242.1400001
"7453",2018-01-18 02:05:37,1777941.21,15190183.3500001
"7454",2018-01-18 02:05:37,797863.22,15988046.5700001
"7455",2018-01-18 02:16:54,-2575804.43,13412242.1400001
"7456",2018-01-18 02:59:52,919920.26,14332162.4000001
"7457",2018-01-18 02:59:52,1777941.25,16110103.6500001
"7458",2018-01-18 03:03:02,-2697861.51,13412242.1400001
"7459",2018-01-18 03:47:44,486087.28,13898329.4200001
"7460",2018-01-18 03:47:44,1777941.27,15676270.6900001
"7461",2018-01-18 03:55:25,-2264028.55,13412242.1400001
"7462",2018-01-18 04:15:33,1777941.34,15190183.4800001
"7463",2018-01-18 04:15:33,472093.36,15662276.8400001
"7464",2018-01-18 04:15:33,1777941.35,17440218.1900001
"7465",2018-01-18 04:22:47,-4027976.05,13412242.1400001
"7466",2018-01-18 04:51:15,1777941.37,15190183.5100001
"7467",2018-01-18 04:51:15,1777941.38,16968124.8900001
"7468",2018-01-18 04:57:03,-3555882.75,13412242.1400001
"7469",2018-01-18 05:13:12,90076.39,13502318.5300001
"7470",2018-01-18 05:34:55,1777941.43,15280259.9600001
"7471",2018-01-18 05:34:55,1777941.44,17058201.4000001
"7472",2018-01-18 05:34:55,272475.45,17330676.8500001
"7473",2018-01-18 05:34:55,-90076.39,17240600.4600001
"7474",2018-01-18 05:42:02,-3828358.32,13412242.1400001
"20460",2018-01-18 05:56:32,1777941.49,15190183.6300001
"20461",2018-01-18 05:56:32,1777941.48,16968125.1100001
"20462",2018-01-18 06:00:10,122628.5,17090753.6100001
"7475",2018-01-18 06:14:15,1777941.52,18868695.1300001
"7476",2018-01-18 06:15:55,365811.53,19234506.6600001
"7477",2018-01-18 06:27:58,-1777941.52,17456565.1400001
"7478",2018-01-18 06:57:49,-365811.53,17090753.6100001
"7479",2018-01-18 07:53:53,1777941.56,18868695.1700001
"7480",2018-01-18 07:58:53,1139747.57,20008442.7400001
"7481",2018-01-18 07:58:53,-1777941.56,18230501.1800001
"7482",2018-01-18 08:08:27,-1139747.57,17090753.6100001
"7483",2018-01-18 08:37:44,1759063.6,18849817.2100001
"7484",2018-01-18 08:37:44,1777941.59,20627758.8000001
"7485",2018-01-18 08:56:24,-3537005.19,17090753.6100001
"20463",2018-01-18 09:38:32,1097718.61,18188472.2200001
"7486",2018-01-18 11:11:23,1777941.75,19966413.9700001
"7487",2018-01-18 11:11:23,1641324.76,21607738.7300001
"20464",2018-01-18 11:11:23,1777941.73,23385680.4600001
"20465",2018-01-18 11:11:23,1685529.74,25071210.2000001
"7488",2018-01-18 11:18:11,-3419266.51,21651943.6900001
"7489",2018-01-18 12:12:07,1777941.84,23429885.5300001
"7490",2018-01-18 12:12:07,1767381.85,25197267.3800001
"7491",2018-01-18 12:27:22,-3545323.69,21651943.6900001
"20466",2018-01-18 15:26:49,1244837.68,22896781.3700001
"7492",2018-01-18 15:40:30,68850.35,22965631.7200001
"7493",2018-01-18 15:44:45,-68850.35,22896781.3700001
"7494",2018-01-18 17:07:34,1777942.95,24674724.3200001
"7495",2018-01-18 17:07:34,1777942.96,26452667.2800001
"7496",2018-01-18 17:07:34,1777942.97,28230610.2500001
"7497",2018-01-18 17:08:45,1777942.94,30008553.1900001
"7498",2018-01-18 17:17:13,1777942.93,31786496.1200001
"7499",2018-01-18 17:17:13,-5333828.88,26452667.2400001
"20467",2018-01-18 17:17:13,1777942.9,28230610.1400001
"20468",2018-01-18 17:17:13,1777942.91,30008553.0500001
"20469",2018-01-18 17:18:31,1777942.89,31786495.9400001
"7500",2018-01-18 17:37:50,280318.98,32066814.9200001
"7501",2018-01-18 17:37:50,-3555885.87,28510929.0500001
"20470",2018-01-18 17:37:50,1777942.87,30288871.9200001
"20471",2018-01-18 17:37:50,1777942.88,32066814.8000001
"20472",2018-01-18 17:37:50,1111279.92,33178094.7200001
"7502",2018-01-18 17:51:55,-280318.98,32897775.7400001
"7503",2018-01-18 18:43:09,1431311.06,34329086.8000001
"7504",2018-01-18 18:43:09,1777943.05,36107029.8500001
"20473",2018-01-18 18:43:09,1777943.02,37884972.8700001
"20474",2018-01-18 18:43:09,1071307.03,38956279.9000001
"7505",2018-01-18 18:48:24,-3209254.11,35747025.7900001
"7506",2018-01-18 19:05:16,1777943.1,37524968.8900001
"7507",2018-01-18 19:05:16,790448.11,38315417.0000001
"7508",2018-01-18 19:25:23,-2568391.21,35747025.7900001
"7509",2018-01-18 20:24:39,1777943.18,37524968.9700001
"7510",2018-01-18 20:24:39,966379.19,38491348.1600001
"7511",2018-01-18 20:30:07,-2744322.37,35747025.7900001
"20475",2018-01-18 21:17:59,-35747025.79,5.96046447753906e-08
"7512",2018-01-18 21:44:52,765317.17,765317.17000006
"7513",2018-01-18 21:44:52,445787.82,1211104.99000006
"7514",2018-01-18 21:44:52,777942.83,1989047.82000006
"7515",2018-01-18 21:44:52,150395.89,2139443.71000006
"20476",2018-01-18 21:44:52,17347.06,2156790.77000006
"20477",2018-01-18 21:44:52,11777.3,2168568.07000006
"7516",2018-01-18 21:53:29,-2139443.71,29124.3600000595
"20478",2018-01-18 21:53:29,-29124.36,5.94736775383353e-08
"7517",2018-01-18 22:20:04,2664670.37,2664670.37000006
"7518",2018-01-18 22:34:15,-2664670.37,5.96046447753906e-08
"7519",2018-01-18 23:29:20,1777943.28,1777943.28000006
"7520",2018-01-18 23:29:20,1584417.29,3362360.57000006
"20479",2018-01-18 23:29:20,1777943.3,5140303.87000006
"20480",2018-01-18 23:29:20,1266835.31,6407139.18000006
"7521",2018-01-18 23:34:12,-3362360.57,3044778.61000006
"7522",2018-01-18 23:36:14,1777943.32,4822721.93000006
"20481",2018-01-18 23:36:14,-3044778.61,1777943.32000006
"7523",2018-01-18 23:46:51,129763.33,1907706.65000006
"7524",2018-01-18 23:46:51,-1777943.32,129763.330000059
"7525",2018-01-19 00:11:22,-129763.33,5.94445737078786e-08
"20482",2018-01-19 02:50:23,1708631.35,1708631.35000006
"7526",2018-01-19 06:04:12,1777944.91,3486576.26000006
"7527",2018-01-19 06:30:45,777944.99,4264521.25000006
"7528",2018-01-19 06:30:45,777945,5042466.25000006
"7529",2018-01-19 06:30:45,-1777944.91,3264521.34000006
"7530",2018-01-19 06:52:25,-1555889.99,1708631.35000006
"20483",2018-01-19 13:41:00,1777943.34,3486574.69000006
"7531",2018-01-19 14:49:33,1111285.67,4597860.36000006
"20484",2018-01-19 14:49:33,1777948.7,6375809.06000006
"7532",2018-01-19 15:36:58,1777948.63,8153757.69000006
"7533",2018-01-19 15:36:58,1374591.24,9528348.93000006
"7534",2018-01-19 15:36:58,1161227.03,10689575.9600001
"7535",2018-01-19 15:36:58,1777777.01,12467352.9700001
"7536",2018-01-19 15:36:58,1777948.66,14245301.6300001
"7537",2018-01-19 15:36:58,1777948.62,16023250.2500001
"7538",2018-01-19 15:36:58,1777948.65,17801198.9000001
"7539",2018-01-19 15:36:58,1777777.02,19578975.9200001
"7540",2018-01-19 15:36:58,1777948.64,21356924.5600001
"7541",2018-01-19 15:36:58,-1111285.67,20245638.8900001
"20485",2018-01-19 15:36:58,1777948.71,22023587.6000001
"20486",2018-01-19 15:36:58,1777948.69,23801536.2900001
"20487",2018-01-19 15:36:58,1777948.68,25579484.9700001
"20488",2018-01-19 15:36:58,1777948.72,27357433.6900001
"20489",2018-01-19 15:36:58,1111285.73,28468719.4200001
"7542",2018-01-19 15:52:56,1386298.83,29855018.2500001
"7543",2018-01-19 15:52:56,-14981115.5,14873902.7500001
"7544",2018-01-19 16:11:14,-1386298.83,13487603.9200001
"7545",2018-01-19 20:28:23,499999.16,13987603.0800001
"7546",2018-01-19 20:52:34,-499999.16,13487603.9200001
"7547",2018-01-19 21:12:06,1999990.17,15487594.0900001
"7548",2018-01-19 21:12:06,326278.18,15813872.2700001
"7549",2018-01-19 21:16:48,-2326268.35,13487603.9200001
"7550",2018-01-19 23:27:25,122504.2,13610108.1200001
"7551",2018-01-19 23:27:25,1999990.19,15610098.3100001
"7552",2018-01-19 23:41:19,-2122494.39,13487603.9200001
"7553",2018-01-20 01:08:17,1999990.21,15487594.1300001
"7554",2018-01-20 01:08:17,6306.22,15493900.3500001
"7555",2018-01-20 01:13:00,-2006296.43,13487603.9200001
"7556",2018-01-20 03:49:48,1999990.23,15487594.1500001
"7557",2018-01-20 03:49:48,134227.24,15621821.3900001
"7558",2018-01-20 03:56:16,-2134217.47,13487603.9200001
"20490",2018-01-20 11:10:05,-13487603.92,5.96046447753906e-08
"7559",2018-01-20 11:58:38,888895.18,888895.18000006
"7560",2018-01-20 12:08:31,-888895.18,5.96046447753906e-08
"7561",2018-01-20 20:38:13,499999.42,499999.42000006
"7562",2018-01-20 20:50:18,-499999.42,5.96046447753906e-08
"7563",2018-01-21 04:50:45,1999990.64,1999990.64000006
"7564",2018-01-21 04:50:45,1592322.65,3592313.29000006
"7565",2018-01-21 04:54:19,-3592313.29,5.96046447753906e-08
"7566",2018-01-21 05:16:23,1999990.73,1999990.73000006
"7567",2018-01-21 05:16:23,1586043.74,3586034.47000006
"7568",2018-01-21 05:23:32,-3586034.47,5.91389834880829e-08
"7569",2018-01-21 06:41:42,1915667.84,1915667.84000006
"7570",2018-01-21 06:41:42,1999990.83,3915658.67000006
"7571",2018-01-21 06:46:30,-3915658.67,5.96046447753906e-08
"7572",2018-01-21 07:58:17,1768428.9,1768428.90000006
"7573",2018-01-21 07:58:17,1999990.89,3768419.79000006
"7574",2018-01-21 08:14:02,-3768419.79,5.96046447753906e-08
"20491",2018-01-21 08:14:02,1718264.94,1718264.94000006
"20492",2018-01-21 08:14:02,1999990.93,3718255.87000006
"7575",2018-01-21 08:48:42,206227.12,3924482.99000006
"20493",2018-01-21 08:48:42,1188390.97,5112873.96000006
"20494",2018-01-21 08:48:42,1999990.96,7112864.92000006
"7576",2018-01-21 08:58:07,-206227.12,6906637.80000006
"7577",2018-01-21 09:16:46,2622782.46,9529420.26000006
"7578",2018-01-21 09:35:47,-2622782.46,6906637.80000006
"7579",2018-01-21 10:08:42,1999991.38,8906629.18000006
"7580",2018-01-21 10:08:42,1810468.39,10717097.5700001
"7581",2018-01-21 10:14:22,-3810459.77,6906637.80000006
"20495",2018-01-21 10:19:49,1091415.11,7998052.91000006
"20496",2018-01-21 13:41:32,1815789.16,9813842.07000006
"7582",2018-01-21 16:29:07,1999991.47,11813833.5400001
"20497",2018-01-21 16:29:07,1999991.45,13813824.9900001
"20498",2018-01-21 16:29:07,1746909.46,15560734.4500001
"7583",2018-01-21 16:35:18,-1999991.47,13560742.9800001
"7584",2018-01-21 16:43:13,1999991.49,15560734.4700001
"7585",2018-01-21 16:43:13,247837.5,15808571.9700001
"7586",2018-01-21 16:49:16,-2247828.99,13560742.9800001
"7587",2018-01-21 17:43:48,1999991.54,15560734.5200001
"7588",2018-01-21 17:46:41,1826929.55,17387664.0700001
"7589",2018-01-21 17:52:17,-1999991.54,15387672.5300001
"7590",2018-01-21 17:58:08,-1826929.55,13560742.9800001
"7591",2018-01-21 21:45:41,1999991.62,15560734.6000001
"7592",2018-01-21 21:45:41,408755.63,15969490.2300001
"20499",2018-01-21 21:45:41,1745919.59,17715409.8200001
"20500",2018-01-21 21:45:41,1999991.58,19715401.4000001
"7593",2018-01-21 21:54:27,-2408747.25,17306654.1500001
"7594",2018-01-21 23:25:11,201958.48,17508612.6300001
"7595",2018-01-21 23:39:13,-201958.48,17306654.1500001
"7596",2018-01-22 00:05:49,1999991.64,19306645.7900001
"7597",2018-01-22 00:05:49,347073.65,19653719.4400001
"7598",2018-01-22 00:13:33,-2347065.29,17306654.1500001
"20501",2018-01-22 06:53:07,488889.71,17795543.8600001
"20502",2018-01-22 14:39:26,1493707.8,19289251.6600001
"20503",2018-01-22 15:02:59,531926.79,19821178.4500001
"20504",2018-01-22 15:02:59,1999991.78,21821170.2300001
"7599",2018-01-22 16:21:40,1999991.82,23821162.0500001
"7600",2018-01-22 16:46:00,-1999991.82,21821170.2300001
"7601",2018-01-22 20:03:20,1999991.88,23821162.1100001
"7602",2018-01-22 20:03:20,1965002.89,25786165.0000001
"7603",2018-01-22 20:17:08,-3964994.77,21821170.2300001
"20505",2018-01-22 21:41:54,1481767.91,23302938.1400001
"20506",2018-01-22 21:41:54,1999991.9,25302930.0400001
"20507",2018-01-22 22:02:26,1795280.93,27098210.9700001
"20508",2018-01-22 22:02:26,1999991.92,29098202.8900001
"7604",2018-01-22 22:14:04,1999991.94,31098194.8300001
"7605",2018-01-22 22:18:35,1273622.95,32371817.7800001
"7606",2018-01-22 22:18:35,-1999991.94,30371825.8400001
"7607",2018-01-22 22:26:30,-1273622.95,29098202.8900001
"20509",2018-01-23 00:02:28,1999991.97,31098194.8600001
"20510",2018-01-23 00:02:28,982680.98,32080875.8400001
"20511",2018-01-23 01:20:49,-32080875.84,6.70552253723145e-08
"20512",2018-01-23 03:27:28,1601808.02,1601808.02000007
"20513",2018-01-23 03:27:28,1999992.01,3601800.03000007
"20514",2018-01-23 03:37:01,-3601800.03,6.75208866596222e-08
"20515",2018-01-23 05:42:04,377780.53,377780.530000068
"20516",2018-01-23 07:38:37,1915697.07,2293477.60000007
"20517",2018-01-23 07:38:37,1999992.06,4293469.66000007
"7608",2018-01-23 13:28:21,1999994.17,6293463.83000007
"7609",2018-01-23 13:28:21,1999994.18,8293458.01000007
"7610",2018-01-23 13:28:21,1999994.19,10293452.2000001
"7611",2018-01-23 13:28:21,1146997.2,11440449.4000001
"7612",2018-01-23 13:40:47,-7146979.74,4293469.66000007
"20518",2018-01-23 13:49:32,979750.26,5273219.92000007
"7613",2018-01-23 16:48:15,834456.71,6107676.63000007
"7614",2018-01-23 16:48:15,177420.05,6285096.68000006
"7615",2018-01-23 16:48:15,279672.28,6564768.96000007
"7616",2018-01-23 16:48:15,2244646.74,8809415.70000007
"7617",2018-01-23 16:51:37,51637.36,8861053.06000007
"7618",2018-01-23 16:51:37,-3536195.78,5324857.28000007
"7619",2018-01-23 16:57:53,-51637.36,5273219.92000007
"7620",2018-01-23 17:07:25,130004.3,5403224.22000007
"7621",2018-01-23 17:13:22,-130004.3,5273219.92000007
"20519",2018-01-23 19:50:31,962674.33,6235894.25000007
"20520",2018-01-23 19:50:31,1999994.32,8235888.57000007
"20521",2018-01-23 19:58:44,1999994.31,10235882.8800001
"7622",2018-01-23 20:00:27,1999994.36,12235877.2400001
"7623",2018-01-23 20:23:35,1308737.37,13544614.6100001
"7624",2018-01-23 20:23:35,-1999994.36,11544620.2500001
"7625",2018-01-23 20:27:45,-1308737.37,10235882.8800001
"20522",2018-01-25 05:16:52,-10235882.88,6.51925802230835e-08
"7626",2018-01-25 08:36:04,497781.47,497781.470000065
"7627",2018-01-25 08:54:45,-497781.47,6.51925802230835e-08
"7628",2018-01-25 09:00:06,777781.78,777781.780000065
"7629",2018-01-25 09:05:16,-777781.78,6.51925802230835e-08
"7630",2018-01-25 12:34:12,777781.8,777781.800000065
"7631",2018-01-25 12:46:37,-777781.8,6.51925802230835e-08
"20523",2018-01-25 13:06:24,5056744.95,5056744.95000007
"20524",2018-01-25 20:37:47,777781.52,5834526.47000007
"20525",2018-01-26 13:16:01,777782.08,6612308.55000007
"20526",2018-01-26 13:41:05,499004.64,7111313.19000007
"7632",2018-01-26 21:11:42,777782.23,7889095.42000007
"7633",2018-01-26 21:19:13,-777782.23,7111313.19000006
"7634",2018-01-27 01:54:15,777782.53,7889095.72000006
"7635",2018-01-27 01:58:34,-777782.53,7111313.19000006
"20527",2018-01-27 03:15:25,4394321.93,11505635.1200001
"7636",2018-01-27 09:12:14,777782.58,12283417.7000001
"7637",2018-01-27 09:26:05,-777782.58,11505635.1200001
"7638",2018-01-27 12:07:50,497782.05,12003417.1700001
"20528",2018-01-27 12:07:50,777782.66,12781199.8300001
"7639",2018-01-27 12:12:36,-497782.05,12283417.7800001
"20529",2018-01-27 21:34:48,777782.89,13061200.6700001
"20530",2018-01-28 07:32:21,-13061200.67,6.51925802230835e-08
"7640",2018-01-28 09:08:31,777782.31,777782.310000065
"7641",2018-01-28 09:13:22,-777782.31,6.51925802230835e-08
"7642",2018-01-28 12:44:51,497782.67,497782.670000065
"7643",2018-01-28 12:52:12,-497782.67,6.51925802230835e-08
"7644",2018-01-28 16:35:34,888893.58,888893.580000065
"7645",2018-01-28 16:50:23,-888893.58,6.51925802230835e-08
"7646",2018-01-29 09:31:05,777782.11,777782.110000065
"7647",2018-01-29 09:39:03,-777782.11,6.51925802230835e-08
"7648",2018-01-29 13:50:45,498005.27,498005.270000065
"7649",2018-01-29 13:53:43,-498005.27,6.51925802230835e-08
"7650",2018-01-30 13:59:17,497783.6,497783.600000065
"7651",2018-01-30 14:06:45,-497783.6,6.51925802230835e-08
"7652",2018-02-01 01:35:57,888897.43,888897.430000065
"20531",2018-02-01 01:35:57,888897.47,1777794.90000007
"7653",2018-02-01 01:42:11,-888897.43,888897.470000065
"20532",2018-02-01 01:42:11,-888897.47,6.50761649012566e-08
"7654",2018-02-02 06:56:35,4001925.91,4001925.91000007
"7655",2018-02-02 07:18:16,-4001925.91,6.51925802230835e-08
"7656",2018-02-02 21:50:50,267171.55,267171.550000065
"7657",2018-02-02 21:50:50,308908.08,576079.630000065
"7658",2018-02-02 21:56:40,-576079.63,6.51925802230835e-08
"7659",2018-02-03 07:57:47,630580.37,630580.370000065
"7660",2018-02-03 07:57:47,1999998.36,2630578.73000007
"7661",2018-02-03 08:02:01,-2630578.73,6.51925802230835e-08
"7662",2018-02-03 10:27:26,1999998.39,1999998.39000007
"7663",2018-02-03 10:30:27,1434653.4,3434651.79000007
"7664",2018-02-03 10:30:27,-1999998.39,1434653.40000007
"7665",2018-02-03 10:48:17,-1434653.4,6.54254108667374e-08
"7666",2018-02-03 16:37:33,1249587.17,1249587.17000007
"7667",2018-02-03 16:53:33,-1249587.17,6.54254108667374e-08
"7668",2018-02-04 05:22:39,639902.5,639902.500000065
"7669",2018-02-04 05:22:39,452287.43,1092189.93000007
"7670",2018-02-04 05:55:05,330768.1,1422958.03000007
"7671",2018-02-04 05:55:05,560738.48,1983696.51000007
"7672",2018-02-04 05:55:05,546081.58,2529778.09000007
"7673",2018-02-04 05:55:05,-1092189.93,1437588.16000007
"7674",2018-02-04 06:07:20,-1437588.16,6.56582415103912e-08
"7675",2018-02-04 06:49:50,1595578.76,1595578.76000007
"7676",2018-02-04 06:54:09,-1595578.76,6.56582415103912e-08
"7677",2018-02-04 08:56:56,193553.98,193553.980000066
"7678",2018-02-04 09:15:11,1999998.65,2193552.63000007
"7679",2018-02-04 09:15:11,159834.66,2353387.29000007
"7680",2018-02-04 09:15:11,-193553.98,2159833.31000007
"7681",2018-02-04 09:42:48,-2159833.31,6.56582415103912e-08
"7682",2018-02-04 18:13:37,1251836.87,1251836.87000007
"7683",2018-02-04 18:32:55,-1251836.87,6.56582415103912e-08
"7684",2018-02-04 22:34:18,268187.69,268187.690000066
"7685",2018-02-04 22:51:02,-268187.69,6.56582415103912e-08
"7686",2018-02-04 23:07:26,888896.88,888896.880000066
"7687",2018-02-04 23:11:41,-888896.88,6.56582415103912e-08
"7688",2018-02-05 02:23:46,1999998.96,1999998.96000007
"7689",2018-02-05 02:23:46,600328.97,2600327.93000007
"7690",2018-02-05 02:32:31,-2600327.93,6.56582415103912e-08
"20533",2018-02-05 03:37:49,1136470.25,1136470.25000007
"20534",2018-02-05 03:46:54,-1136470.25,6.56582415103912e-08
"20535",2018-02-05 03:46:54,1741730.49,1741730.49000007
"7691",2018-02-05 04:03:57,777785.95,2519516.44000007
"20536",2018-02-05 04:03:57,-1741730.49,777785.950000066
"7692",2018-02-05 04:07:53,-777785.95,6.56582415103912e-08
"7693",2018-02-05 05:02:57,1467887.04,1467887.04000007
"7694",2018-02-05 05:02:57,1999999.03,3467886.07000007
"7695",2018-02-05 05:11:45,-3467886.07,6.56582415103912e-08
"20537",2018-02-05 05:11:45,796628.06,796628.060000066
"20538",2018-02-05 05:11:45,1999999.05,2796627.11000007
"20539",2018-02-05 06:01:04,-2796627.11,6.56582415103912e-08
"20540",2018-02-05 10:30:47,138878.1,138878.100000066
"20541",2018-02-05 10:33:50,1999999.09,2138877.19000007
"20542",2018-02-05 10:33:50,1999999.07,4138876.26000007
"7696",2018-02-05 12:04:24,1489619.12,5628495.38000007
"7697",2018-02-05 12:43:39,1999999.11,7628494.49000007
"7698",2018-02-05 12:43:39,-1489619.12,6138875.37000007
"7699",2018-02-05 12:58:13,-1999999.11,4138876.26000007
"7700",2018-02-05 14:43:43,1999999.13,6138875.39000007
"7701",2018-02-05 14:43:43,1710859.14,7849734.53000007
"7702",2018-02-05 14:54:38,-3710858.27,4138876.26000007
"20543",2018-02-05 15:40:05,1999999.16,6138875.42000007
"20544",2018-02-05 15:40:05,1588052.17,7726927.59000007
"7703",2018-02-05 16:06:06,1999999.2,9726926.79000006
"7704",2018-02-05 16:06:06,1999999.21,11726926.0000001
"7705",2018-02-05 16:06:06,664640.22,12391566.2200001
"7706",2018-02-05 16:10:07,-4664638.63,7726927.59000006
"20545",2018-02-05 17:25:08,470075.12,8197002.71000006
"20546",2018-02-05 17:54:28,1999999.34,10197002.0500001
"20547",2018-02-05 18:05:38,1646357.35,11843359.4000001
"7707",2018-02-05 19:41:05,1999999.52,13843358.9200001
"7708",2018-02-05 19:45:36,1999999.51,15843358.4300001
"7709",2018-02-05 19:45:36,742658.53,16586016.9600001
"7710",2018-02-05 19:45:36,1999999.5,18586016.4600001
"7711",2018-02-05 19:45:36,-1999999.52,16586016.9400001
"7712",2018-02-05 20:02:58,-4742657.54,11843359.4000001
"7713",2018-02-05 20:42:13,497009.56,12340368.9600001
"7714",2018-02-05 20:48:04,-497009.56,11843359.4000001
"7715",2018-02-06 08:35:45,1999999.58,13843358.9800001
"7716",2018-02-06 08:35:45,1999999.57,15843358.5500001
"7717",2018-02-06 08:35:45,414877.59,16258236.1400001
"7718",2018-02-06 08:51:08,-4414876.74,11843359.4000001
"20548",2018-02-06 09:16:28,1999999.08,13843358.4800001
"7719",2018-02-06 10:06:43,1999999.6,15843358.0800001
"7720",2018-02-06 10:06:43,1999999.62,17843357.7000001
"7721",2018-02-06 10:06:43,624355.63,18467713.3300001
"7722",2018-02-06 10:06:43,1999999.61,20467712.9400001
"7723",2018-02-06 10:17:35,-6624354.46,13843358.4800001
"7724",2018-02-06 16:10:24,1238059.23,15081417.7100001
"7725",2018-02-06 16:18:43,-1238059.23,13843358.4800001
"7726",2018-02-06 20:39:00,25605.91,13868964.3900001
"7727",2018-02-06 20:39:00,10560.36,13879524.7500001
"7728",2018-02-06 20:46:37,-36166.27,13843358.4800001
"20549",2018-02-07 19:37:58,-13843358.48,5.96046447753906e-08
"7729",2018-02-07 19:56:25,91568.45,91568.4500000596
"7730",2018-02-07 19:56:25,26472.39,118040.84000006
"7731",2018-02-07 19:56:25,777777.24,895818.08000006
"7732",2018-02-07 20:06:08,-895818.08,5.96046447753906e-08
"7733",2018-02-07 21:06:13,236881.44,236881.44000006
"7734",2018-02-07 21:22:41,-236881.44,5.96046447753906e-08
"7735",2018-02-07 21:51:30,1916407.13,1916407.13000006
"7736",2018-02-07 21:57:29,-1916407.13,5.96046447753906e-08
"7737",2018-02-07 22:13:36,2021076.9,2021076.90000006
"7738",2018-02-07 22:17:03,-2021076.9,5.96046447753906e-08
"7739",2018-02-07 23:27:04,1030554.99,1030554.99000006
"7740",2018-02-07 23:42:34,-1030554.99,5.96046447753906e-08
"7741",2018-02-08 01:50:32,1777884.56,1777884.56000006
"7742",2018-02-08 02:03:39,-1777884.56,5.96046447753906e-08
"7743",2018-02-08 15:57:07,140678.44,140678.44000006
"7744",2018-02-08 16:02:08,-140678.44,5.96046447753906e-08
"7745",2018-02-08 16:44:45,1420601.93,1420601.93000006
"7746",2018-02-08 16:49:34,-1420601.93,5.96046447753906e-08
"7747",2018-02-08 17:52:38,1382467.84,1382467.84000006
"7748",2018-02-08 19:17:34,-1382467.84,5.96046447753906e-08
"7749",2018-02-09 08:03:04,4414552.66,4414552.66000006
"7750",2018-02-09 08:16:00,-4414552.66,5.96046447753906e-08
"7751",2018-02-09 12:54:55,1601310.36,1601310.36000006
"7752",2018-02-09 13:01:12,-1601310.36,5.96046447753906e-08
"7753",2018-02-09 15:05:40,1729252.78,1729252.78000006
"7754",2018-02-09 15:15:22,-1729252.78,5.96046447753906e-08
"7755",2018-02-09 17:10:39,958921.68,958921.68000006
"7756",2018-02-09 17:10:39,1999990.67,2958912.35000006
"7757",2018-02-09 17:21:39,-2958912.35,5.96046447753906e-08
"7758",2018-02-10 05:33:09,2500786.78,2500786.78000006
"7759",2018-02-10 05:40:42,-2500786.78,5.96046447753906e-08
"7760",2018-02-10 07:10:30,429607.03,429607.03000006
"7761",2018-02-10 07:26:48,-429607.03,5.96046447753906e-08
"20550",2018-02-10 08:26:56,41390.92,41390.9200000596
"20551",2018-02-10 08:35:22,378340.09,419731.01000006
"7762",2018-02-10 08:54:17,733250.24,1152981.25000006
"20552",2018-02-10 08:54:17,732537.6,1885518.85000006
"7763",2018-02-10 09:03:20,275431.57,2160950.42000006
"7764",2018-02-10 09:03:20,-733250.24,1427700.18000006
"7765",2018-02-10 09:11:07,-275431.57,1152268.61000006
"20553",2018-02-10 10:43:18,568311.19,1720579.80000006
"7766",2018-02-10 11:45:31,222096.44,1942676.24000006
"7767",2018-02-10 11:52:29,-222096.44,1720579.80000006
"7768",2018-02-10 14:28:41,412903.73,2133483.53000006
"7769",2018-02-10 14:31:45,-412903.73,1720579.80000006
"20554",2018-02-10 15:03:45,111402.51,1831982.31000006
"20555",2018-02-10 15:29:29,496451.3,2328433.61000006
"7770",2018-02-10 15:44:28,315616.73,2644050.34000006
"7771",2018-02-10 16:09:16,574593.18,3218643.52000006
"7772",2018-02-10 16:09:16,671640.97,3890284.49000006
"7773",2018-02-10 16:09:16,-315616.73,3574667.76000006
"20556",2018-02-10 17:10:20,633399.03,4208066.79000006
"20557",2018-02-10 17:10:20,428238.62,4636305.41000006
"7774",2018-02-10 17:31:42,888159.56,5524464.97000006
"7775",2018-02-10 17:42:59,499778.37,6024243.34000006
"7776",2018-02-10 17:42:59,-1246234.15,4778009.19000006
"7777",2018-02-10 17:54:20,-1387937.93,3390071.26000006
"20558",2018-02-10 18:30:38,856487.56,4246558.82000006
"7778",2018-02-10 18:51:15,25410.19,4271969.01000006
"7779",2018-02-10 18:51:15,75153.39,4347122.40000006
"7780",2018-02-10 18:51:15,332807.54,4679929.94000006
"7781",2018-02-10 18:55:27,-433371.12,4246558.82000006
"7782",2018-02-10 19:15:41,337523.06,4584081.88000006
"20559",2018-02-10 19:15:41,807676.97,5391758.85000006
"7783",2018-02-10 19:22:48,567374.37,5959133.22000006
"7784",2018-02-10 19:22:48,-337523.06,5621610.16000006
"7785",2018-02-10 19:28:14,-567374.37,5054235.79000006
"7786",2018-02-10 19:50:52,402893.44,5457129.23000006
"7787",2018-02-10 20:04:35,-402893.44,5054235.79000006
"7788",2018-02-10 20:58:34,707059.46,5761295.25000006
"7789",2018-02-10 21:08:02,530214.7,6291509.95000006
"7790",2018-02-10 21:08:02,-707059.46,5584450.49000006
"7791",2018-02-10 21:14:01,-530214.7,5054235.79000006
"20560",2018-02-10 21:42:47,362767.83,5417003.62000006
"20561",2018-02-10 21:43:39,270395.37,5687398.99000006
"20562",2018-02-10 21:51:07,436381.1,6123780.09000006
"7792",2018-02-10 22:11:28,453034.49,6576814.58000006
"7793",2018-02-10 22:11:28,682304.33,7259118.91000006
"7794",2018-02-10 22:18:00,446985.06,7706103.97000006
"7795",2018-02-10 22:18:00,-1135338.82,6570765.15000006
"7796",2018-02-10 22:31:23,-446985.06,6123780.09000006
"20563",2018-02-10 23:31:23,451550.12,6575330.21000006
"20564",2018-02-10 23:54:45,342355.27,6917685.48000006
"7797",2018-02-11 00:08:08,270926.22,7188611.70000006
"7798",2018-02-11 00:17:00,-270926.22,6917685.48000006
"7799",2018-02-11 00:59:32,1000633.65,7918319.13000006
"7800",2018-02-11 01:13:55,-1000633.65,6917685.48000006
"20565",2018-02-11 01:58:49,248831.9,7166517.38000006
"7801",2018-02-11 02:37:40,38939.44,7205456.82000006
"7802",2018-02-11 02:37:40,171531.02,7376987.84000006
"7803",2018-02-11 02:37:40,316779.8,7693767.64000006
"7804",2018-02-11 02:37:40,239552.83,7933320.47000006
"7805",2018-02-11 02:37:40,373524.58,8306845.05000006
"7806",2018-02-11 02:54:05,-1140327.67,7166517.38000006
"20566",2018-02-11 03:24:23,27874.58,7194391.96000006
"20567",2018-02-11 03:24:23,239282.49,7433674.45000006
"7807",2018-02-11 04:17:02,487932.68,7921607.13000006
"20568",2018-02-11 04:17:02,153822.42,8075429.55000006
"20569",2018-02-11 04:17:02,232998.27,8308427.82000006
"20570",2018-02-11 04:18:01,163041.7,8471469.52000006
"7808",2018-02-11 04:25:22,-487932.68,7983536.84000006
"20571",2018-02-11 05:02:19,262992.61,8246529.45000006
"7809",2018-02-11 05:11:31,329652.15,8576181.60000006
"7810",2018-02-11 05:25:29,-329652.15,8246529.45000006
"20572",2018-02-11 05:25:29,164279.15,8410808.60000006
"7811",2018-02-11 05:51:10,196140.9,8606949.50000006
"7812",2018-02-11 05:51:10,249975.06,8856924.56000006
"7813",2018-02-11 05:51:10,500001.98,9356926.54000006
"7814",2018-02-11 05:51:10,555576.99,9912503.53000006
"20573",2018-02-11 05:51:10,225281.6,10137785.1300001
"7815",2018-02-11 06:09:36,-1501694.93,8636090.20000006
"20574",2018-02-11 06:09:36,86986.42,8723076.62000006
"20575",2018-02-11 06:30:43,822832.95,9545909.57000006
"20576",2018-02-11 06:45:02,164313.25,9710222.82000006
"20577",2018-02-11 07:00:15,213915.36,9924138.18000006
"20578",2018-02-11 07:00:45,236168.09,10160306.2700001
"20579",2018-02-11 07:08:55,205085.29,10365391.5600001
"20580",2018-02-11 07:18:49,376696.16,10742087.7200001
"20581",2018-02-11 08:07:13,778710.32,11520798.0400001
"20582",2018-02-11 08:07:13,577919.37,12098717.4100001
"20583",2018-02-11 08:16:20,880498.15,12979215.5600001
"20584",2018-02-11 08:41:44,954044.54,13933260.1000001
"20585",2018-02-11 08:41:44,848700.1,14781960.2000001
"20586",2018-02-11 10:05:14,974442.78,15756402.9800001
"20587",2018-02-11 11:44:17,953081.34,16709484.3200001
"7816",2018-02-11 12:08:38,888890.21,17598374.5300001
"7817",2018-02-11 12:08:38,499002.22,18097376.7500001
"7818",2018-02-11 12:14:56,-1387892.43,16709484.3200001
"20588",2018-02-11 12:29:29,749931.37,17459415.6900001
"7819",2018-02-11 12:53:01,777779.26,18237194.9500001
"7820",2018-02-11 12:53:01,777779.24,19014974.1900001
"7821",2018-02-11 12:53:01,777779.25,19792753.4400001
"7822",2018-02-11 12:53:01,777779.27,20570532.7100001
"7823",2018-02-11 12:58:17,-3111117.02,17459415.6900001
"20589",2018-02-11 13:46:07,922895.53,18382311.2200001
"7824",2018-02-11 14:43:25,486494.16,18868805.3800001
"7825",2018-02-11 15:10:12,-486494.16,18382311.2200001
"7826",2018-02-11 17:06:14,517711.5,18900022.7200001
"7827",2018-02-11 17:19:31,-517711.5,18382311.2200001
"20590",2018-02-11 21:50:23,872564.22,19254875.4400001
"7828",2018-02-11 23:30:32,5490080.84,24744956.2800001
"7829",2018-02-11 23:30:32,1777785.9,26522742.1800001
"20591",2018-02-11 23:30:32,326196.44,26848938.6200001
"7830",2018-02-11 23:48:33,-7267866.74,19581071.8800001
"20592",2018-02-12 00:12:30,2823066.25,22404138.1300001
"7831",2018-02-12 01:48:38,1989257.02,24393395.1500001
"7832",2018-02-12 01:51:54,-1989257.02,22404138.1300001
"7833",2018-02-12 08:34:04,77159.5,22481297.6300001
"7834",2018-02-12 08:34:04,1999992.49,24481290.1200001
"7835",2018-02-12 08:48:23,-2077151.99,22404138.1300001
"20593",2018-02-12 12:14:48,835190.59,23239328.7200001
"20594",2018-02-13 11:16:54,181420.93,23420749.6500001
"20595",2018-02-13 15:02:39,276143.96,23696893.6100001
"20596",2018-02-13 16:10:40,496186.11,24193079.7200001
"7836",2018-02-13 20:33:46,505267.15,24698346.8700001
"7837",2018-02-13 20:37:39,-505267.15,24193079.7200001
"7838",2018-02-14 04:39:32,410961.33,24604041.0500001
"7839",2018-02-14 04:43:29,-410961.33,24193079.7200001
"20597",2018-02-14 12:32:18,849727.51,25042807.2300001
"7840",2018-02-14 12:36:08,1888896.97,26931704.2000001
"20598",2018-02-14 12:36:08,888896.98,27820601.1800001
"7841",2018-02-14 12:44:10,-1888896.97,25931704.2100001
"7842",2018-02-15 01:04:28,820872.99,26752577.2000001
"7843",2018-02-15 01:33:12,-820872.99,25931704.2100001
"7844",2018-02-15 07:51:24,381413.79,26313118.0000001
"7845",2018-02-15 08:10:51,-381413.79,25931704.2100001
"7846",2018-02-15 09:42:05,196391.7,26128095.9100001
"7847",2018-02-15 09:45:57,-196391.7,25931704.2100001
"7848",2018-02-15 10:08:28,356677.23,26288381.4400001
"7849",2018-02-15 10:20:05,806878.41,27095259.8500001
"7850",2018-02-15 10:20:05,918518.08,28013777.9300001
"7851",2018-02-15 10:20:05,-356677.23,27657100.7000001
"7852",2018-02-15 10:27:03,1038105.34,28695206.0400001
"7853",2018-02-15 10:27:03,-1725396.49,26969809.5500001
"7854",2018-02-15 10:42:02,-1038105.34,25931704.2100001
"7855",2018-02-15 11:24:00,1098448.36,27030152.5700001
"7856",2018-02-15 11:33:29,-1098448.36,25931704.2100001
"7857",2018-02-15 12:44:55,933401.65,26865105.8600001
"7858",2018-02-15 12:47:14,-933401.65,25931704.2100001
"7859",2018-02-15 14:46:41,802382.78,26734086.9900001
"7860",2018-02-15 15:02:41,-802382.78,25931704.2100001
"7861",2018-02-15 19:12:25,831164.64,26762868.8500001
"7862",2018-02-15 19:36:44,-831164.64,25931704.2100001
"7863",2018-02-16 05:31:22,548242.28,26479946.4900001
"7864",2018-02-16 05:46:54,-548242.28,25931704.2100001
"7865",2018-02-16 07:26:19,518555.57,26450259.7800001
"7866",2018-02-16 07:38:24,-518555.57,25931704.2100001
"7867",2018-02-16 08:20:09,722482.93,26654187.1400001
"20599",2018-02-16 08:20:09,649127.24,27303314.3800001
"7868",2018-02-16 08:35:50,-722482.93,26580831.4500001
"20600",2018-02-16 08:38:50,739530.85,27320362.3000001
"7869",2018-02-16 10:45:08,858093.79,28178456.0900001
"7870",2018-02-16 10:54:30,-858093.79,27320362.3000001
"20601",2018-02-16 12:04:40,856837.11,28177199.4100001
"7871",2018-02-16 16:14:41,957905.87,29135105.2800001
"7872",2018-02-16 16:18:41,-957905.87,28177199.4100001
"20602",2018-02-16 20:23:56,-28177199.41,6.33299350738525e-08
"7873",2018-02-16 20:33:59,824598.77,824598.770000063
"7874",2018-02-16 20:37:47,-824598.77,6.33299350738525e-08
"20603",2018-02-16 22:38:02,482024.28,482024.280000063
"20604",2018-02-16 23:18:10,-482024.28,6.33299350738525e-08
"7875",2018-02-16 23:36:30,388912.92,388912.920000063
"7876",2018-02-16 23:39:12,-388912.92,6.33299350738525e-08
"7877",2018-02-17 01:49:59,1128990.56,1128990.56000006
"7878",2018-02-17 01:59:15,-1128990.56,6.33299350738525e-08
"20605",2018-02-17 03:11:59,1535438.28,1535438.28000006
"20606",2018-02-17 03:29:00,-1535438.28,6.33299350738525e-08
"7879",2018-02-17 07:12:57,1767339.36,1767339.36000006
"7880",2018-02-17 07:18:13,-1767339.36,6.33299350738525e-08
"20607",2018-02-17 12:47:04,709034.99,709034.990000063
"20608",2018-02-17 12:58:24,-709034.99,6.33299350738525e-08
"20609",2018-02-17 16:45:05,1227513.01,1227513.01000006
"20610",2018-02-17 16:49:05,-1227513.01,6.33299350738525e-08
"20611",2018-02-17 23:00:05,1482604.52,1482604.52000006
"20612",2018-02-17 23:06:03,-1482604.52,6.33299350738525e-08
"20613",2018-02-17 23:26:08,1747975.22,1747975.22000006
"20614",2018-02-17 23:29:47,-1747975.22,6.33299350738525e-08
"20615",2018-02-18 01:02:55,1082161.32,1082161.32000006
"20616",2018-02-18 01:08:38,-1082161.32,6.33299350738525e-08
"20617",2018-02-18 01:51:21,487706.16,487706.160000063
"20618",2018-02-18 02:09:16,-487706.16,6.33299350738525e-08
"20619",2018-02-18 02:09:16,599994.39,599994.390000063
"20620",2018-02-18 02:33:41,-599994.39,6.33299350738525e-08
"20621",2018-02-18 02:48:29,1082981.75,1082981.75000006
"20622",2018-02-18 02:50:56,-1082981.75,6.33299350738525e-08
"7881",2018-02-18 04:56:06,721377.15,721377.150000063
"7882",2018-02-18 05:07:56,-721377.15,6.33299350738525e-08
"20623",2018-02-18 06:13:33,1170739.9,1170739.90000006
"20624",2018-02-18 09:12:50,1245614.1,2416354.00000006
"7883",2018-02-18 10:03:06,1534079.44,3950433.44000006
"7884",2018-02-18 10:08:33,1672167.96,5622601.40000006
"7885",2018-02-18 10:08:33,-1534079.44,4088521.96000006
"7886",2018-02-18 10:13:30,-1672167.96,2416354.00000006
"20625",2018-02-18 12:29:00,397468.81,2813822.81000006
"20626",2018-02-18 13:34:47,961659.9,3775482.71000006
"7887",2018-02-18 16:55:03,1186773.2,4962255.91000006
"7888",2018-02-18 16:58:48,-1186773.2,3775482.71000006
"20627",2018-02-18 16:58:48,608662.13,4384144.84000006
"20628",2018-02-18 17:30:38,766624.28,5150769.12000006
"7889",2018-02-18 19:08:13,1183173.52,6333942.64000006
"7890",2018-02-18 19:11:42,-1183173.52,5150769.12000006
"20629",2018-02-18 19:37:43,484437.71,5635206.83000006
"20630",2018-02-18 20:16:53,1102439.51,6737646.34000006
"7891",2018-02-18 22:01:03,760138.95,7497785.29000006
"7892",2018-02-18 22:05:36,-760138.95,6737646.34000006
"20631",2018-02-18 22:05:36,-6737646.34,6.4261257648468e-08
"7893",2018-02-18 22:41:19,428766.06,428766.060000064
"7894",2018-02-18 22:56:39,-428766.06,6.4261257648468e-08
"7895",2018-02-19 00:39:35,750640.23,750640.230000064
"7896",2018-02-19 00:41:58,-750640.23,6.4261257648468e-08
"20632",2018-02-19 07:40:17,547408.45,547408.450000064
"20633",2018-02-19 07:47:07,-547408.45,6.4261257648468e-08
"7897",2018-02-19 08:52:20,998501.49,998501.490000064
"7898",2018-02-19 08:57:17,-998501.49,6.4261257648468e-08
"20634",2018-02-19 14:22:11,1428364.68,1428364.68000006
"20635",2018-02-19 14:29:56,-1428364.68,6.4261257648468e-08
"7899",2018-02-19 15:15:23,100182.84,100182.840000064
"7900",2018-02-19 15:15:23,601718.9,701901.740000064
"7901",2018-02-19 15:15:23,478873.03,1180774.77000006
"7902",2018-02-19 15:22:20,-1180774.77,6.4261257648468e-08
"7903",2018-02-19 15:31:57,1340433.73,1340433.73000006
"7904",2018-02-19 15:41:29,-1340433.73,6.4261257648468e-08
"7905",2018-02-19 16:47:43,499005.11,499005.110000064
"20636",2018-02-19 16:47:43,1393018.79,1892023.90000006
"7906",2018-02-19 16:52:16,-499005.11,1393018.79000006
"20637",2018-02-19 16:52:16,-1393018.79,6.4261257648468e-08
"7907",2018-02-19 18:44:56,446875.21,446875.210000064
"7908",2018-02-19 19:06:34,942296.56,1389171.77000006
"7909",2018-02-19 19:06:34,-446875.21,942296.560000064
"7910",2018-02-19 19:34:07,-942296.56,6.4261257648468e-08
"7911",2018-02-19 20:48:42,1262240.76,1262240.76000006
"7912",2018-02-19 21:06:16,-1262240.76,6.4261257648468e-08
"20638",2018-02-19 22:08:35,1140178.71,1140178.71000006
"20639",2018-02-19 22:14:31,-1140178.71,6.4261257648468e-08
"7913",2018-02-20 00:22:08,624831.84,624831.840000064
"20640",2018-02-20 00:22:08,1988387.72,2613219.56000006
"7914",2018-02-20 00:38:52,684876.83,3298096.39000006
"7915",2018-02-20 00:38:52,-624831.84,2673264.55000006
"20641",2018-02-20 00:38:52,-1988387.72,684876.830000065
"7916",2018-02-20 00:50:37,-684876.83,6.46105036139488e-08
"7917",2018-02-20 01:18:30,1342047.55,1342047.55000006
"7918",2018-02-20 01:25:49,-1342047.55,6.44940882921219e-08
"20642",2018-02-20 01:42:48,1398187.79,1398187.79000006
"20643",2018-02-20 02:07:07,-1398187.79,6.44940882921219e-08
"7919",2018-02-20 02:37:12,1871203.23,1871203.23000006
"7920",2018-02-20 03:02:07,-1871203.23,6.44940882921219e-08
"20644",2018-02-20 04:42:48,1094241.7,1094241.70000006
"20645",2018-02-20 04:56:02,-1094241.7,6.44940882921219e-08
"20646",2018-02-20 07:00:03,1306046.41,1306046.41000006
"20647",2018-02-20 07:07:10,-1306046.41,6.44940882921219e-08
"20648",2018-02-20 07:38:17,1163231.22,1163231.22000006
"20649",2018-02-20 07:48:22,-1163231.22,6.44940882921219e-08
"20650",2018-02-20 16:16:17,599995.51,599995.510000065
"20651",2018-02-20 16:37:35,258650.56,858646.070000065
"20652",2018-02-20 16:37:35,-599995.51,258650.560000065
"20653",2018-02-20 16:44:40,-258650.56,6.45522959530354e-08
"7921",2018-02-20 23:14:05,32052.53,32052.5300000646
"7922",2018-02-20 23:14:05,1435052.96,1467105.49000006
"7923",2018-02-20 23:14:05,52417.82,1519523.31000006
"7924",2018-02-20 23:14:05,499995.81,2019519.12000006
"20654",2018-02-20 23:14:05,1405431.95,3424951.07000006
"7925",2018-02-20 23:17:09,-2019519.12,1405431.95000006
"20655",2018-02-20 23:21:02,-1405431.95,6.44940882921219e-08
"20656",2018-02-21 00:06:22,322541.11,322541.110000064
"20657",2018-02-21 00:06:22,362731.75,685272.860000064
"20658",2018-02-21 00:09:17,370787.7,1056060.56000006
"20659",2018-02-21 00:17:45,-1056060.56,6.44940882921219e-08
"7926",2018-02-21 00:29:18,1552124.84,1552124.84000006
"7927",2018-02-21 00:29:18,885243.52,2437368.36000006
"20660",2018-02-21 00:29:18,408862.92,2846231.28000006
"7928",2018-02-21 00:41:03,-2437368.36,408862.920000065
"20661",2018-02-21 00:41:03,-408862.92,6.46687112748623e-08
"20662",2018-02-21 00:45:24,499995.95,499995.950000065
"20663",2018-02-21 00:45:24,499995.96,999991.910000065
"20664",2018-02-21 00:45:24,91248.97,1091240.88000006
"20665",2018-02-21 01:23:23,-1091240.88,6.47269189357758e-08
"7929",2018-02-21 03:34:57,247620.07,247620.070000065
"7930",2018-02-21 03:34:57,499996.06,747616.130000065
"7931",2018-02-21 04:01:56,-747616.13,6.47269189357758e-08
"20666",2018-02-21 04:26:00,422016.64,422016.640000065
"20667",2018-02-21 04:26:00,433409.46,855426.100000065
"20668",2018-02-21 04:26:00,1165965.38,2021391.48000006
"7932",2018-02-21 04:36:45,417124.9,2438516.38000006
"20669",2018-02-21 04:36:45,-2021391.48,417124.900000065
"7933",2018-02-21 04:44:57,620950.68,1038075.58000006
"7934",2018-02-21 04:44:57,-417124.9,620950.680000065
"7935",2018-02-21 04:51:06,-620950.68,6.46105036139488e-08
"20670",2018-02-21 07:47:21,434895.79,434895.790000065
"20671",2018-02-21 08:22:39,-434895.79,6.46105036139488e-08
"7936",2018-02-21 09:09:52,375707.06,375707.060000065
"20672",2018-02-21 09:09:52,627016.32,1002723.38000006
"7937",2018-02-21 09:11:30,-375707.06,627016.320000065
"20673",2018-02-21 09:24:19,-627016.32,6.46105036139488e-08
"20674",2018-02-21 09:45:18,26773.61,26773.6100000646
"20675",2018-02-21 10:01:26,-26773.61,6.46105036139488e-08
"7938",2018-02-21 12:07:30,608103.99,608103.990000065
"7939",2018-02-21 12:23:31,-608103.99,6.46105036139488e-08
"20676",2018-02-21 12:23:31,302354.78,302354.780000065
"20677",2018-02-21 12:29:07,-302354.78,6.46105036139488e-08
"20678",2018-02-21 12:43:57,48154.19,48154.1900000646
"20679",2018-02-21 12:53:55,-48154.19,6.46105036139488e-08
"20680",2018-02-21 14:08:11,426870.82,426870.820000065
"20681",2018-02-21 14:08:11,291310.44,718181.260000065
"20682",2018-02-21 14:16:13,-718181.26,6.46105036139488e-08
"20683",2018-02-21 14:16:13,227554.58,227554.580000065
"20684",2018-02-21 14:16:13,236366.65,463921.230000065
"7940",2018-02-21 14:40:44,416149.05,880070.280000065
"7941",2018-02-21 14:40:44,459858.19,1339928.47000006
"20685",2018-02-21 14:40:44,33103.77,1373032.24000006
"20686",2018-02-21 14:40:44,-463921.23,909111.010000065
"7942",2018-02-21 14:48:39,-876007.24,33103.7700000645
"20687",2018-02-21 14:48:39,-33103.77,6.45159161649644e-08
"7943",2018-02-21 14:51:01,492187.08,492187.080000065
"7944",2018-02-21 15:11:03,-492187.08,6.44940882921219e-08
"7945",2018-02-21 15:44:57,499996.72,499996.720000064
"7946",2018-02-21 15:44:57,100924.73,600921.450000064
"20688",2018-02-21 15:44:57,446086.48,1047007.93000006
"7947",2018-02-21 16:02:48,-600921.45,446086.480000064
"20689",2018-02-21 16:02:48,-446086.48,6.44940882921219e-08
"20690",2018-02-21 16:02:48,235041.75,235041.750000064
"20691",2018-02-21 16:30:42,-235041.75,6.44940882921219e-08
"7948",2018-02-21 16:48:21,892957.26,892957.260000065
"7949",2018-02-21 16:48:21,599006.76,1491964.02000006
"20692",2018-02-21 16:48:21,844960.37,2336924.39000006
"7950",2018-02-21 16:50:46,-1491964.02,844960.370000064
"20693",2018-02-21 16:56:21,-844960.37,6.4377672970295e-08
"20694",2018-02-21 16:56:21,503233,503233.000000064
"20695",2018-02-21 17:06:44,-503233,6.4377672970295e-08
"20696",2018-02-21 17:06:44,676726.68,676726.680000064
"20697",2018-02-21 17:17:32,-676726.68,6.4377672970295e-08
"7951",2018-02-21 17:29:17,325510.09,325510.090000064
"7952",2018-02-21 17:31:58,-325510.09,6.4377672970295e-08
"20698",2018-02-21 20:39:12,375313.83,375313.830000064
"20699",2018-02-21 20:49:09,-375313.83,6.4377672970295e-08
"20700",2018-02-21 20:49:09,326171.89,326171.890000064
"20701",2018-02-21 20:49:09,777783.91,1103955.80000006
"20702",2018-02-21 20:58:25,-1103955.8,6.44940882921219e-08
"7953",2018-02-21 21:01:42,650808.3,650808.300000065
"7954",2018-02-21 21:21:39,-650808.3,6.44940882921219e-08
"7955",2018-02-21 23:54:13,383266.56,383266.560000064
"7956",2018-02-22 00:05:40,-383266.56,6.44940882921219e-08
"7957",2018-02-22 04:56:54,270256.6,270256.600000064
"7958",2018-02-22 04:59:23,-270256.6,6.44940882921219e-08
"7959",2018-02-22 08:58:03,499997.21,499997.210000065
"7960",2018-02-22 08:58:03,62863.22,562860.430000065
"7961",2018-02-22 09:10:11,-562860.43,6.44940882921219e-08
"20703",2018-02-22 09:54:31,425528.24,425528.240000064
"20704",2018-02-22 09:54:31,599997.23,1025525.47000006
"20705",2018-02-22 10:02:15,-1025525.47,6.44940882921219e-08
"20706",2018-02-22 10:50:51,457183.32,457183.320000065
"20707",2018-02-22 11:13:54,-457183.32,6.44940882921219e-08
"20708",2018-02-22 11:46:52,301930.88,301930.880000064
"20709",2018-02-22 11:46:52,283843.78,585774.660000065
"20710",2018-02-22 11:56:16,-585774.66,6.44940882921219e-08
"20711",2018-02-22 12:04:46,874842.75,874842.750000064
"20712",2018-02-22 12:19:40,-874842.75,6.44940882921219e-08
"20713",2018-02-22 12:38:22,569177.23,569177.230000064
"7962",2018-02-22 12:54:02,462292.48,1031469.71000006
"20714",2018-02-22 12:54:02,-569177.23,462292.480000064
"7963",2018-02-22 12:56:24,-462292.48,6.44940882921219e-08
"7964",2018-02-22 13:05:49,754703.61,754703.610000064
"20715",2018-02-22 13:12:13,638284.42,1392988.03000006
"7965",2018-02-22 13:23:14,562333.32,1955321.35000006
"7966",2018-02-22 13:23:14,708652.73,2663974.08000006
"7967",2018-02-22 13:23:14,-754703.61,1909270.47000006
"20716",2018-02-22 13:23:14,-638284.42,1270986.05000006
"7968",2018-02-22 13:32:34,-1270986.05,6.44940882921219e-08
"20717",2018-02-22 13:40:55,1733243.04,1733243.04000006
"20718",2018-02-22 13:57:04,-1733243.04,6.44940882921219e-08
"20719",2018-02-22 13:57:04,1055796,1055796.00000006
"7969",2018-02-22 14:44:36,599732.97,1655528.97000006
"7970",2018-02-22 14:44:36,547957.07,2203486.04000006
"20720",2018-02-22 14:44:36,-1055796,1147690.04000006
"7971",2018-02-22 14:50:09,-1147690.04,6.4261257648468e-08
"7972",2018-02-22 14:52:19,379028.5,379028.500000064
"7973",2018-02-22 14:52:19,499997.49,879025.990000064
"7974",2018-02-22 15:22:06,-879025.99,6.4261257648468e-08
"20721",2018-02-22 15:22:06,1608332.51,1608332.51000006
"7975",2018-02-22 15:56:31,1335550.83,2943883.34000006
"20722",2018-02-22 15:56:31,-1608332.51,1335550.83000006
"7976",2018-02-22 16:24:17,-1335550.83,6.40284270048141e-08
"7977",2018-02-22 17:25:59,1404321.46,1404321.46000006
"7978",2018-02-22 17:29:38,-1404321.46,6.40284270048141e-08
"7979",2018-02-22 18:11:44,73722.89,73722.890000064
"20723",2018-02-22 18:11:44,1355917.93,1429640.82000006
"7980",2018-02-22 18:28:57,-73722.89,1355917.93000006
"20724",2018-02-22 18:28:57,-1355917.93,6.40284270048141e-08
"7981",2018-02-22 20:55:31,1433585.85,1433585.85000006
"7982",2018-02-22 20:59:41,-1433585.85,6.40284270048141e-08
"20725",2018-02-23 00:17:47,1220327.92,1220327.92000006
"20726",2018-02-23 00:24:23,-1220327.92,6.40284270048141e-08
"20727",2018-02-23 00:52:06,1343156.48,1343156.48000006
"7983",2018-02-23 01:00:15,728693.43,2071849.91000006
"20728",2018-02-23 01:00:15,-1343156.48,728693.430000064
"7984",2018-02-23 01:25:14,-728693.43,6.39120116829872e-08
"20729",2018-02-23 02:09:41,993488.5,993488.500000064
"20730",2018-02-23 02:29:53,-993488.5,6.39120116829872e-08
"7985",2018-02-23 03:56:50,686025.6,686025.600000064
"20731",2018-02-23 03:56:50,1786024.31,2472049.91000006
"20732",2018-02-23 04:05:23,-1786024.31,686025.600000064
"7986",2018-02-23 08:19:51,-686025.6,6.39120116829872e-08
"7987",2018-02-23 12:08:31,866888.18,866888.180000064
"7988",2018-02-23 12:17:52,-866888.18,6.39120116829872e-08
"20733",2018-02-23 13:30:44,528961.45,528961.450000064
"20734",2018-02-23 13:36:01,-528961.45,6.39120116829872e-08
"20735",2018-02-23 16:56:33,1043618.22,1043618.22000006
"20736",2018-02-23 17:05:43,-1043618.22,6.39120116829872e-08
"20737",2018-02-23 19:55:03,281888.93,281888.930000064
"7989",2018-02-23 20:21:27,491944.84,773833.770000064
"20738",2018-02-23 20:21:27,-281888.93,491944.840000064
"7990",2018-02-23 20:25:49,499998.11,991942.950000064
"7991",2018-02-23 20:25:49,160906.12,1152849.07000006
"7992",2018-02-23 20:25:49,98401.08,1251250.15000006
"7993",2018-02-23 20:25:49,599998.07,1851248.22000006
"7994",2018-02-23 20:25:49,-491944.84,1359303.38000006
"20739",2018-02-23 20:25:49,234546.1,1593849.48000006
"20740",2018-02-23 20:25:49,599998.09,2193847.57000006
"7995",2018-02-23 20:37:45,-1359303.38,834544.190000064
"20741",2018-02-23 20:37:45,-834544.19,6.4261257648468e-08
"7996",2018-02-23 22:22:38,714908.46,714908.460000064
"7997",2018-02-23 22:30:18,-714908.46,6.4261257648468e-08
"20742",2018-02-23 22:30:18,464650.59,464650.590000064
"20743",2018-02-23 22:43:37,-464650.59,6.4261257648468e-08
"20744",2018-02-23 23:30:57,874317.11,874317.110000064
"20745",2018-02-23 23:39:59,-874317.11,6.4261257648468e-08
"7998",2018-02-24 00:56:33,1295309.01,1295309.01000006
"7999",2018-02-24 02:33:52,599998.21,1895307.22000006
"8000",2018-02-24 02:33:52,16452.22,1911759.44000006
"8001",2018-02-24 06:14:03,777805.12,2689564.56000006
"8002",2018-02-24 06:14:03,-1295309.01,1394255.55000006
"8003",2018-02-24 06:22:16,-1394255.55,6.4261257648468e-08
"20746",2018-02-24 07:16:16,531468.41,531468.410000064
"20747",2018-02-24 07:35:54,-531468.41,6.4261257648468e-08
"20748",2018-02-24 08:19:24,140444.5,140444.500000064
"20749",2018-02-24 08:31:55,-140444.5,6.4261257648468e-08
"20750",2018-02-24 11:46:15,428150.79,428150.790000064
"20751",2018-02-24 11:57:36,-428150.79,6.4261257648468e-08
"20752",2018-02-24 14:12:35,39027.58,39027.5800000643
"20753",2018-02-24 14:57:38,18417.02,57444.6000000643
"20754",2018-02-24 14:57:38,-39027.58,18417.0200000643
"20755",2018-02-24 14:57:38,191636.98,210054.000000064
"20756",2018-02-24 14:57:38,166346.69,376400.690000064
"20757",2018-02-24 15:03:53,-376400.69,6.4261257648468e-08
"8004",2018-02-24 15:24:05,169751.17,169751.170000064
"8005",2018-02-24 15:46:01,-169751.17,6.4261257648468e-08
"8006",2018-02-24 16:44:39,599999.46,599999.460000064
"8007",2018-02-24 16:44:39,204473.49,804472.950000064
"20758",2018-02-24 16:44:39,135819.53,940292.480000064
"8008",2018-02-24 16:58:04,599009.66,1539302.14000006
"8009",2018-02-24 16:58:04,-804472.95,734829.190000064
"20759",2018-02-24 16:58:04,-135819.53,599009.660000064
"20760",2018-02-24 16:58:04,599009.64,1198019.30000006
"8010",2018-02-24 17:07:42,-599009.66,599009.640000065
"20761",2018-02-24 17:07:42,-599009.64,6.44940882921219e-08
"8011",2018-02-24 17:20:58,555564.72,555564.720000064
"20762",2018-02-24 17:20:58,555564.71,1111129.43000006
"8012",2018-02-24 17:40:05,-555564.72,555564.710000064
"20763",2018-02-24 17:40:05,-555564.71,6.44940882921219e-08
"8013",2018-02-24 21:06:27,204965.96,204965.960000064
"20764",2018-02-24 21:06:27,217247.98,422213.940000064
"8014",2018-02-24 21:14:30,-204965.96,217247.980000065
"20765",2018-02-24 23:14:08,777789.93,995037.910000065
"8015",2018-02-24 23:20:36,777789.94,1772827.85000006
"8016",2018-02-24 23:39:21,-777789.94,995037.910000064
"20766",2018-02-24 23:45:31,777789.99,1772827.90000006
"8017",2018-02-25 03:38:01,431831.36,2204659.26000006
"8018",2018-02-25 03:44:56,-431831.36,1772827.90000006
"8019",2018-02-25 13:46:06,777790.66,2550618.56000006
"8020",2018-02-25 13:52:03,-777790.66,1772827.90000006
"20767",2018-02-25 17:12:39,1076421.63,2849249.53000006
"20768",2018-02-25 18:51:59,602543.73,3451793.26000006
"20769",2018-02-25 19:21:19,65026.54,3516819.80000006
"20770",2018-02-25 20:12:09,667430.12,4184249.92000006
"20771",2018-02-26 08:54:47,1047270.66,5231520.58000006
"20772",2018-02-26 15:05:52,1369272.37,6600792.95000006
"8021",2018-02-26 18:11:51,499991,7100783.95000006
"8022",2018-02-26 18:11:51,110310.01,7211093.96000006
"8023",2018-02-26 18:30:55,-610301.01,6600792.95000006
"8024",2018-02-27 05:50:56,599991.15,7200784.10000006
"8025",2018-02-27 05:50:56,599991.17,7800775.27000006
"8026",2018-02-27 05:50:56,599991.16,8400766.43000006
"8027",2018-02-27 05:50:56,339247.18,8740013.61000006
"8028",2018-02-27 06:03:41,-2139220.66,6600792.95000006
"8029",2018-02-27 13:42:00,563076.25,7163869.20000006
"8030",2018-02-27 13:42:00,1999991.24,9163860.44000006
"8031",2018-02-27 13:47:16,-2563067.49,6600792.95000006
"8032",2018-02-28 02:02:15,1777790.71,8378583.66000006
"8033",2018-02-28 02:15:31,-1777790.71,6600792.95000006
"8034",2018-03-05 09:01:46,1777792.91,8378585.86000006
"8035",2018-03-05 09:12:28,-1777792.91,6600792.95000006
"8036",2018-03-05 09:31:52,599004.82,7199797.77000006
"20773",2018-03-05 09:31:52,1777781.73,8977579.50000007
"20774",2018-03-05 09:31:52,599004.8,9576584.30000007
"8037",2018-03-05 09:37:07,-599004.82,8977579.48000007
"20775",2018-03-05 12:30:21,599994.85,9577574.33000007
"20776",2018-03-05 12:30:21,599994.84,10177569.1700001
"20777",2018-03-05 12:30:21,599994.83,10777564.0000001
"20778",2018-03-05 12:37:26,599994.89,11377558.8900001
"20779",2018-03-05 12:37:26,599994.88,11977553.7700001
"20780",2018-03-05 12:37:26,599994.91,12577548.6800001
"20781",2018-03-05 12:37:26,599994.9,13177543.5800001
"20782",2018-03-05 12:37:26,599994.87,13777538.4500001
"20783",2018-03-05 12:37:26,599994.86,14377533.3100001
"8038",2018-03-08 13:40:53,599996.56,14977529.8700001
"8039",2018-03-08 13:40:53,9289.57,14986819.4400001
"20784",2018-03-08 13:40:53,608694.31,15595513.7500001
"8040",2018-03-08 13:48:22,-609286.13,14986227.6200001
"20785",2018-03-08 18:22:17,499996.85,15486224.4700001
"20786",2018-03-08 18:22:17,499996.86,15986221.3300001
"20787",2018-03-08 18:40:00,465179.91,16451401.2400001
"20788",2018-03-08 19:16:34,-16451401.24,6.51925802230835e-08
"20789",2018-03-08 19:45:28,1037632.44,1037632.44000007
"8041",2018-03-08 21:15:22,1222469.61,2260102.05000007
"8042",2018-03-08 21:41:47,-1222469.61,1037632.44000006
"8043",2018-03-08 22:28:37,1658843.1,2696475.54000007
"8044",2018-03-08 22:48:19,-1658843.1,1037632.44000007
"8045",2018-03-09 00:47:41,1909316.33,2946948.77000007
"20790",2018-03-09 00:47:41,-1037632.44,1909316.33000007
"8046",2018-03-09 00:55:01,-1909316.33,6.51925802230835e-08
"8047",2018-03-09 02:44:18,1492660.25,1492660.25000007
"8048",2018-03-09 02:52:23,-1492660.25,6.51925802230835e-08
"8049",2018-03-09 03:09:43,1579444.63,1579444.63000007
"8050",2018-03-09 03:21:54,-1579444.63,6.51925802230835e-08
"8051",2018-03-09 06:48:35,179002.27,179002.270000065
"8052",2018-03-09 06:48:35,499997.26,678999.530000065
"8053",2018-03-09 07:10:28,-678999.53,6.51925802230835e-08
"20791",2018-03-09 10:28:07,599997.35,599997.350000065
"20792",2018-03-09 10:28:07,599997.34,1199994.69000007
"20793",2018-03-09 10:28:07,420859.36,1620854.05000007
"8054",2018-03-09 11:45:08,163087.38,1783941.43000006
"8055",2018-03-09 11:45:08,599997.37,2383938.80000007
"8056",2018-03-09 11:53:34,-763084.75,1620854.05000007
"8057",2018-03-09 16:37:02,1643862.29,3264716.34000007
"8058",2018-03-09 16:42:54,-1643862.29,1620854.05000007
"20794",2018-03-09 17:02:15,664359.08,2285213.13000007
"20795",2018-03-09 17:11:11,750113.28,3035326.41000007
"20796",2018-03-09 17:11:11,170420.81,3205747.22000007
"8059",2018-03-09 21:02:53,860661.01,4066408.23000007
"8060",2018-03-09 21:15:30,1769576.61,5835984.84000007
"8061",2018-03-09 21:15:30,-860661.01,4975323.83000007
"8062",2018-03-09 21:24:06,-1769576.61,3205747.22000007
"8063",2018-03-09 21:29:17,694575.72,3900322.94000007
"8064",2018-03-09 21:29:17,231719.01,4132041.95000007
"8065",2018-03-09 21:34:07,-926294.73,3205747.22000007
"8066",2018-03-09 23:20:22,1215540.88,4421288.10000006
"8067",2018-03-09 23:26:53,-1215540.88,3205747.22000006
"20797",2018-03-10 07:05:20,473776.44,3679523.66000006
"20798",2018-03-10 19:05:29,811082.81,4490606.47000006
"20799",2018-03-10 19:18:09,322217.74,4812824.21000007
"8068",2018-03-10 19:27:46,599998.05,5412822.26000006
"8069",2018-03-10 19:27:46,567664.06,5980486.32000007
"8070",2018-03-10 19:35:34,-1167662.11,4812824.21000007
"20800",2018-03-10 21:45:27,599998.16,5412822.37000007
"20801",2018-03-10 21:45:27,437515.17,5850337.54000007
"20802",2018-03-10 21:45:27,599998.15,6450335.69000007
"8071",2018-03-10 22:20:38,435901.21,6886236.90000007
"8072",2018-03-10 22:20:38,499998.2,7386235.10000007
"8073",2018-03-10 22:20:38,499998.19,7886233.29000007
"8074",2018-03-10 22:32:14,-1435897.6,6450335.69000007
"8075",2018-03-11 14:24:14,1805874.04,8256209.73000007
"8076",2018-03-11 15:02:03,-1805874.04,6450335.69000007
"8077",2018-03-11 16:07:27,1989752.3,8440087.99000007
"8078",2018-03-11 16:19:11,-1989752.3,6450335.69000007
"20803",2018-03-11 16:52:32,224364.17,6674699.86000007
"8079",2018-03-11 17:34:23,289304.67,6964004.53000007
"8080",2018-03-11 17:34:23,1999998.66,8964003.19000007
"8081",2018-03-11 17:47:30,-2289303.33,6674699.86000007
"8082",2018-03-11 18:00:46,1999998.7,8674698.56000007
"8083",2018-03-11 18:00:46,86482.71,8761181.27000007
"8084",2018-03-11 18:16:28,-2086481.41,6674699.86000007
"20804",2018-03-12 06:33:54,1786548.9,8461248.76000007
"20805",2018-03-12 15:31:18,1078311.23,9539559.99000007
"20806",2018-03-12 20:36:00,599999.03,10139559.0200001
"20807",2018-03-12 20:36:00,599999.04,10739558.0600001
"20808",2018-03-12 20:36:00,351127.05,11090685.1100001
"8085",2018-03-13 06:36:30,1134434.45,12225119.5600001
"8086",2018-03-13 06:41:42,-1134434.45,11090685.1100001
"8087",2018-03-13 14:19:09,112735.36,11203420.4700001
"8088",2018-03-13 14:31:50,-112735.36,11090685.1100001
"8089",2018-03-13 14:45:29,790679.44,11881364.5500001
"8090",2018-03-13 14:53:18,-790679.44,11090685.1100001
"8091",2018-03-13 14:53:18,599999.44,11690684.5500001
"8092",2018-03-13 14:53:18,163957.45,11854642.0000001
"8093",2018-03-13 15:04:44,-763956.89,11090685.1100001
"8094",2018-03-13 16:57:19,743061.61,11833746.7200001
"8095",2018-03-13 17:14:31,-743061.61,11090685.1100001
"20809",2018-03-13 17:57:43,713433.09,11804118.2000001
"8096",2018-03-13 18:12:58,599843.18,12403961.3800001
"8097",2018-03-13 18:38:30,-599843.18,11804118.2000001
"8098",2018-03-14 02:15:04,244098.61,12048216.8100001
"8099",2018-03-14 02:15:04,1999999.6,14048216.4100001
"8100",2018-03-14 02:17:31,-2244098.21,11804118.2000001
"8101",2018-03-14 07:53:24,599999.65,12404117.8500001
"8102",2018-03-14 07:53:24,599999.66,13004117.5100001
"8103",2018-03-14 07:53:24,133433.67,13137551.1800001
"8104",2018-03-14 07:58:26,-1333432.98,11804118.2000001
"20810",2018-03-14 12:50:12,650399.13,12454517.3300001
"20811",2018-03-14 13:37:55,1083596.98,13538114.3100001
"20812",2018-03-14 14:49:49,499999.94,14038114.2500001
"20813",2018-03-14 14:49:49,266852.95,14304967.2000001
"8105",2018-03-14 16:20:09,599990.04,14904957.2400001
"8106",2018-03-14 16:20:09,599990.03,15504947.2700001
"8107",2018-03-14 16:20:09,529776.05,16034723.3200001
"8108",2018-03-14 16:20:09,599990.01,16634713.3300001
"8109",2018-03-14 16:20:09,599990.02,17234703.3500001
"20814",2018-03-14 16:20:09,6e+05,17834703.3500001
"20815",2018-03-14 16:20:09,599999.99,18434703.3400001
"8110",2018-03-14 16:29:31,-2929736.15,15504967.1900001
"20816",2018-03-14 16:30:46,599990.11,16104957.3000001
"20817",2018-03-14 16:30:46,599990.13,16704947.4300001
"20818",2018-03-14 16:30:46,599990.12,17304937.5500001
"20819",2018-03-14 17:01:21,217148.15,17522085.7000001
"20820",2018-03-14 17:01:21,599990.14,18122075.8400001
"20821",2018-03-14 17:12:47,499990.17,18622066.0100001
"20822",2018-03-14 17:12:47,191916.18,18813982.1900001
"20823",2018-03-14 19:49:23,679798.78,19493780.9700001
"8111",2018-03-14 20:48:01,499990.3,19993771.2700001
"8112",2018-03-14 20:48:01,94359.31,20088130.5800001
"8113",2018-03-14 20:52:36,-594349.61,19493780.9700001
"20824",2018-03-15 00:08:52,504947.84,19998728.8100001
"8114",2018-03-15 01:10:42,293225.79,20291954.6000001
"8115",2018-03-15 01:14:53,-293225.79,19998728.8100001
"8116",2018-03-15 01:37:52,341456.96,20340185.7700001
"20825",2018-03-15 01:37:52,1178879.29,21519065.0600001
"20826",2018-03-15 01:37:52,1298015.19,22817080.2500001
"8117",2018-03-15 01:52:57,1165447.77,23982528.0200001
"8118",2018-03-15 01:52:57,-341456.96,23641071.0600001
"8119",2018-03-15 02:05:40,-1165447.77,22475623.2900001
"8120",2018-03-15 03:51:13,37762.43,22513385.7200001
"8121",2018-03-15 03:51:13,348172.11,22861557.8300001
"8122",2018-03-15 04:03:19,-385934.54,22475623.2900001
"20827",2018-03-15 04:40:03,175996.1,22651619.3900001
"8123",2018-03-15 04:57:26,403065.31,23054684.7000001
"8124",2018-03-15 05:02:08,375752.38,23430437.0800001
"8125",2018-03-15 05:02:08,-403065.31,23027371.7700001
"8126",2018-03-15 05:13:23,-375752.38,22651619.3900001
"20828",2018-03-15 05:35:45,456983.17,23108602.5600001
"20829",2018-03-15 06:13:47,234743.35,23343345.9100001
"20830",2018-03-15 06:20:03,177646.15,23520992.0600001
"8127",2018-03-15 06:35:53,467441.45,23988433.5100001
"20831",2018-03-15 06:35:53,373015.1,24361448.6100001
"8128",2018-03-15 06:46:58,172756.48,24534205.0900001
"8129",2018-03-15 06:46:58,-467441.45,24066763.6400001
"8130",2018-03-15 07:03:29,-172756.48,23894007.1600001
"8131",2018-03-15 07:17:02,18526.61,23912533.7700001
"8132",2018-03-15 07:39:04,190228.31,24102762.0800001
"8133",2018-03-15 07:39:04,102221.68,24204983.7600001
"8134",2018-03-15 07:39:04,-18526.61,24186457.1500001
"20832",2018-03-15 07:39:04,208822.93,24395280.0800001
"8135",2018-03-15 07:46:11,-292449.99,24102830.0900001
"8136",2018-03-15 07:52:41,147858.67,24250688.7600001
"8137",2018-03-15 07:58:46,-147858.67,24102830.0900001
"20833",2018-03-15 08:21:01,58451.16,24161281.2500001
"20834",2018-03-15 08:29:14,282886.28,24444167.5300001
"8138",2018-03-15 10:14:17,176840.67,24621008.2000001
"20835",2018-03-15 10:14:17,43872.2,24664880.4000001
"8139",2018-03-15 10:19:01,-176840.67,24488039.7300001
"20836",2018-03-15 10:40:00,41260.01,24529299.7400001
"20837",2018-03-15 10:40:00,20131.44,24549431.1800001
"20838",2018-03-15 10:40:00,499991.3,25049422.4800001
"20839",2018-03-15 10:40:00,300620.31,25350042.7900001
"8140",2018-03-15 10:51:56,66731.69,25416774.4800001
"8141",2018-03-15 10:56:25,-66731.69,25350042.7900001
"8142",2018-03-15 11:05:21,465840.21,25815883.0000001
"8143",2018-03-15 11:14:52,-465840.21,25350042.7900001
"20840",2018-03-15 11:14:52,156105.18,25506147.9700001
"8144",2018-03-15 11:18:28,24412.57,25530560.5400001
"8145",2018-03-15 11:39:53,-24412.57,25506147.9700001
"8146",2018-03-15 11:57:58,195798.94,25701946.9100001
"20841",2018-03-15 11:57:58,170233.7,25872180.6100001
"8147",2018-03-15 12:11:26,-195798.94,25676381.6700001
"8148",2018-03-15 13:20:21,300001.5,25976383.1700001
"8149",2018-03-15 13:43:42,54382.02,26030765.1900001
"8150",2018-03-15 13:43:42,-300001.5,25730763.6900001
"8151",2018-03-15 13:52:17,-54382.02,25676381.6700001
"8152",2018-03-15 14:00:47,88092.58,25764474.2500001
"8153",2018-03-15 14:00:47,850478.12,26614952.3700001
"8154",2018-03-15 14:09:13,-938570.7,25676381.6700001
"8155",2018-03-15 14:47:56,383805.19,26060186.8600001
"20842",2018-03-15 14:47:56,818951.53,26879138.3900001
"20843",2018-03-15 14:47:56,393569.09,27272707.4800001
"20844",2018-03-15 14:49:21,554300.99,27827008.4700001
"8156",2018-03-15 15:07:50,-383805.19,27443203.2800001
"20845",2018-03-15 15:07:50,173735.21,27616938.4900001
"20846",2018-03-15 15:07:50,73689.61,27690628.1000001
"20847",2018-03-15 15:07:50,164611.26,27855239.3600001
"20848",2018-03-15 15:07:50,309537.77,28164777.1300001
"20849",2018-03-15 15:18:33,120604.77,28285381.9000001
"20850",2018-03-15 15:18:33,269233.78,28554615.6800001
"20851",2018-03-15 15:52:04,167493.79,28722109.4700001
"20852",2018-03-15 15:52:04,201461.92,28923571.3900001
"20853",2018-03-15 15:52:04,632256.47,29555827.8600001
"20854",2018-03-15 15:52:04,71694.91,29627522.7700001
"20855",2018-03-15 15:54:37,125830.23,29753353.0000001
"20856",2018-03-15 15:59:44,273963.74,30027316.7400001
"8157",2018-03-15 16:29:24,575577.23,30602893.9700001
"8158",2018-03-15 16:29:24,575577.29,31178471.2600001
"8159",2018-03-15 16:29:24,575577.21,31754048.4700001
"8160",2018-03-15 16:29:24,575577.19,32329625.6600001
"8161",2018-03-15 16:29:24,575577.15,32905202.8100001
"8162",2018-03-15 16:29:24,575577.27,33480780.0800001
"8163",2018-03-15 16:34:11,-3453463.34,30027316.7400001
"20857",2018-03-15 16:34:11,-30027316.74,7.07805156707764e-08
"8164",2018-03-15 16:48:47,189509.25,189509.250000071
"8165",2018-03-15 16:48:47,16120.23,205629.480000071
"8166",2018-03-15 16:48:47,159368.6,364998.080000071
"20858",2018-03-15 16:48:47,647168.48,1012166.56000007
"20859",2018-03-15 16:48:47,78908.32,1091074.88000007
"20860",2018-03-15 16:48:47,499992.3,1591067.18000007
"20861",2018-03-15 16:48:47,499992.31,2091059.49000007
"20862",2018-03-15 16:48:47,329703.33,2420762.82000007
"8167",2018-03-15 17:13:36,206709.51,2627472.33000007
"8168",2018-03-15 17:13:36,203868.22,2831340.55000007
"8169",2018-03-15 17:13:36,599992.37,3431332.92000007
"8170",2018-03-15 17:13:36,-364998.08,3066334.84000007
"20863",2018-03-15 17:13:36,111260.65,3177595.49000007
"20864",2018-03-15 17:13:36,-2055764.74,1121830.75000007
"20865",2018-03-15 17:13:36,698635.71,1820466.46000007
"20866",2018-03-15 17:13:36,439686.47,2260152.93000007
"20867",2018-03-15 17:13:36,500646.91,2760799.84000007
"8171",2018-03-15 17:24:28,-1010570.1,1750229.74000007
"20868",2018-03-15 17:24:28,-1750229.74,7.10133463144302e-08
"8172",2018-03-15 17:36:27,1261763.6,1261763.60000007
"8173",2018-03-15 17:45:43,-1261763.6,7.10133463144302e-08
"8174",2018-03-15 21:49:15,188707.98,188707.980000071
"8175",2018-03-15 21:54:36,-188707.98,7.10133463144302e-08
"8176",2018-03-15 22:47:32,578779.66,578779.660000071
"8177",2018-03-15 22:49:17,-578779.66,7.10133463144302e-08
"20869",2018-03-16 06:58:28,131882.82,131882.820000071
"20870",2018-03-16 06:58:28,499992.81,631875.630000071
"20871",2018-03-16 06:58:28,2573372.57,3205248.20000007
"8178",2018-03-16 08:22:06,599992.9,3805241.10000007
"8179",2018-03-16 08:22:06,599992.85,4405233.95000007
"8180",2018-03-16 08:22:06,599992.92,5005226.87000007
"8181",2018-03-16 08:22:06,599992.86,5605219.73000007
"8182",2018-03-16 08:22:06,599992.93,6205212.66000007
"8183",2018-03-16 08:22:06,316668.96,6521881.62000007
"8184",2018-03-16 08:22:06,599992.87,7121874.49000007
"8185",2018-03-16 08:22:06,599992.89,7721867.38000007
"8186",2018-03-16 08:22:06,599992.95,8321860.33000007
"8187",2018-03-16 08:22:06,599992.91,8921853.24000007
"8188",2018-03-16 08:22:06,599992.94,9521846.18000007
"8189",2018-03-16 08:22:06,599992.88,10121839.0600001
"8190",2018-03-16 08:22:06,262764.71,10384603.7700001
"20872",2018-03-16 08:22:06,162399.49,10547003.2600001
"8191",2018-03-16 08:28:02,-7179355.57,3367647.69000007
"20873",2018-03-16 08:34:37,3249752.32,6617400.01000007
"8192",2018-03-16 14:01:37,33219.18,6650619.19000007
"8193",2018-03-16 14:01:37,1999993.17,8650612.36000007
"8194",2018-03-16 14:05:00,-2033212.35,6617400.01000007
"8195",2018-03-16 16:24:54,599993.35,7217393.36000007
"8196",2018-03-16 16:24:54,599993.36,7817386.72000007
"8197",2018-03-16 16:24:54,599993.34,8417380.06000007
"8198",2018-03-16 16:24:54,393445.38,8810825.44000007
"8199",2018-03-16 16:24:54,599993.37,9410818.81000007
"8200",2018-03-16 16:41:58,-2793418.8,6617400.01000007
"8201",2018-03-16 22:29:42,238930.47,6856330.48000007
"20874",2018-03-16 22:29:42,-6617400.01,238930.470000073
"8202",2018-03-16 22:34:19,-238930.47,7.33125489205122e-08
"8203",2018-03-17 05:15:54,1232475.3,1232475.30000007
"8204",2018-03-17 05:23:10,-1232475.3,7.33416527509689e-08
"20875",2018-03-17 09:11:12,2346830.34,2346830.34000007
"20876",2018-03-17 15:54:46,599993.66,2946824.00000007
"20877",2018-03-17 15:54:46,599993.67,3546817.67000007
"20878",2018-03-17 15:54:46,599993.64,4146811.31000007
"20879",2018-03-17 15:54:46,564022.68,4710833.99000007
"20880",2018-03-17 15:54:46,599993.65,5310827.64000007
"20881",2018-03-17 16:30:49,650749.7,5961577.34000007
"20882",2018-03-17 16:30:49,1999993.69,7961571.03000007
"8205",2018-03-17 20:37:12,193992.75,8155563.78000007
"8206",2018-03-17 20:37:12,599993.74,8755557.52000007
"8207",2018-03-17 20:37:12,599993.71,9355551.23000007
"8208",2018-03-17 20:37:12,599993.73,9955544.96000008
"8209",2018-03-17 20:37:12,599993.72,10555538.6800001
"8210",2018-03-17 20:57:21,-2593967.65,7961571.03000008
"20883",2018-03-17 23:36:50,-7961571.03,7.54371285438538e-08
"20884",2018-03-18 15:50:19,456386.27,456386.270000075
"20885",2018-03-18 15:50:19,599994.24,1056380.51000008
"20886",2018-03-18 15:50:19,599994.26,1656374.77000008
"20887",2018-03-18 15:50:19,599994.25,2256369.02000008
"20888",2018-03-18 16:05:45,-2256369.02,7.54371285438538e-08
"20889",2018-03-18 17:52:19,599994.34,599994.340000075
"20890",2018-03-18 17:52:19,599994.31,1199988.65000008
"20891",2018-03-18 17:52:19,599994.33,1799982.98000008
"20892",2018-03-18 17:52:19,115193.35,1915176.33000008
"20893",2018-03-18 17:52:19,599994.32,2515170.65000008
"20894",2018-03-18 17:52:19,599994.3,3115164.95000008
"20895",2018-03-18 17:58:52,-3115164.95,7.54371285438538e-08
"8211",2018-03-19 10:09:16,499994.68,499994.680000075
"8212",2018-03-19 10:09:16,499994.69,999989.370000075
"8213",2018-03-19 10:15:18,-999989.37,7.54371285438538e-08
"8214",2018-03-19 10:27:02,499994.67,499994.670000075
"8215",2018-03-19 10:31:45,-499994.67,7.54371285438538e-08
"8216",2018-03-19 14:09:40,483519.87,483519.870000075
"8217",2018-03-19 14:26:45,-483519.87,7.54371285438538e-08
"20896",2018-03-20 11:19:43,134027.16,134027.160000075
"20897",2018-03-20 11:45:22,-134027.16,7.54371285438538e-08
"20898",2018-03-20 15:41:38,711975.78,711975.780000075
"8218",2018-03-20 16:27:12,540348.09,1252323.87000008
"8219",2018-03-20 16:27:12,599996.08,1852319.95000008
"8220",2018-03-20 16:27:12,599996.07,2452316.02000008
"20899",2018-03-20 16:27:12,599996.13,3052312.15000008
"20900",2018-03-20 16:27:12,351886.14,3404198.29000008
"8221",2018-03-20 16:34:13,-1740340.24,1663858.05000008
"20901",2018-03-20 17:00:22,-1663858.05,7.54371285438538e-08
"20902",2018-03-20 19:44:20,1283710.73,1283710.73000008
"20903",2018-03-20 19:53:50,1210207.49,2493918.22000008
"20904",2018-03-20 20:09:22,-2493918.22,7.4971467256546e-08
"8222",2018-03-21 02:24:56,40408.14,40408.140000075
"8223",2018-03-21 02:39:34,-40408.14,7.4971467256546e-08
"8224",2018-03-21 03:22:58,161313.34,161313.340000075
"8225",2018-03-21 03:38:24,-161313.34,7.4971467256546e-08
"20905",2018-03-21 03:55:17,30418.12,30418.120000075
"8226",2018-03-21 04:23:43,261565.26,291983.380000075
"8227",2018-03-21 04:39:00,-261565.26,30418.120000075
"8228",2018-03-21 05:35:29,154255.86,184673.980000075
"20906",2018-03-21 05:35:29,13836.56,198510.540000075
"8229",2018-03-21 05:39:35,-154255.86,44254.680000075
"20907",2018-03-21 05:50:40,161634.04,205888.720000075
"8230",2018-03-21 07:21:22,777797.78,983686.500000075
"8231",2018-03-21 07:24:38,-777797.78,205888.720000075
"8232",2018-03-21 07:42:42,777783.93,983672.650000075
"8233",2018-03-21 07:47:21,-777783.93,205888.720000075
"20908",2018-03-21 07:59:18,355049.92,560938.640000075
"20909",2018-03-21 08:21:52,304855.71,865794.350000075
"8234",2018-03-21 08:41:58,12793.16,878587.510000075
"8235",2018-03-21 08:41:58,279329.67,1157917.18000007
"20910",2018-03-21 08:41:58,777783.96,1935701.14000007
"8236",2018-03-21 08:55:21,366005.62,2301706.76000007
"8237",2018-03-21 08:55:21,-292122.83,2009583.93000007
"8238",2018-03-21 09:15:06,-366005.62,1643578.31000007
"8239",2018-03-21 09:40:10,252639.67,1896217.98000007
"20911",2018-03-21 09:40:10,93465.18,1989683.16000007
"20912",2018-03-21 09:40:10,499997.17,2489680.33000007
"8240",2018-03-21 09:47:07,-252639.67,2237040.66000007
"20913",2018-03-21 13:42:57,381164.37,2618205.03000007
"20914",2018-03-21 17:24:07,480301.87,3098506.90000007
"8241",2018-03-21 17:31:51,163100.51,3261607.41000007
"8242",2018-03-21 17:31:51,599997.5,3861604.91000007
"8243",2018-03-21 18:05:50,569191.36,4430796.27000007
"20915",2018-03-21 18:05:50,599997.52,5030793.79000008
"20916",2018-03-21 18:05:50,273630.53,5304424.32000008
"8244",2018-03-21 18:10:13,-763098.01,4541326.31000008
"8245",2018-03-21 18:21:27,-569191.36,3972134.95000008
"20917",2018-03-21 18:21:27,336590.58,4308725.53000008
"20918",2018-03-21 18:21:27,385095.29,4693820.82000008
"20919",2018-03-21 20:19:24,499997.63,5193818.45000008
"20920",2018-03-21 20:19:24,53708.64,5247527.09000008
"20921",2018-03-22 00:55:50,599997.75,5847524.84000008
"20922",2018-03-22 00:55:50,195312.76,6042837.60000008
"20923",2018-03-22 01:00:31,599997.8,6642835.40000007
"20924",2018-03-22 01:00:31,444760.81,7087596.21000007
"8246",2018-03-22 02:00:11,452558.86,7540155.07000007
"8247",2018-03-22 02:00:11,599997.85,8140152.92000007
"8248",2018-03-22 02:51:58,-1052556.71,7087596.21000007
"8249",2018-03-22 08:04:51,1819330.33,8906926.54000007
"8250",2018-03-22 08:16:26,-1819330.33,7087596.21000007
"8251",2018-03-22 16:34:30,288443.53,7376039.74000007
"8252",2018-03-22 16:37:15,-288443.53,7087596.21000007
"8253",2018-03-22 18:04:26,777777.59,7865373.80000007
"8254",2018-03-22 19:22:36,-777777.59,7087596.21000007
"8255",2018-03-22 23:33:50,777779.57,7865375.78000007
"8256",2018-03-22 23:44:28,-777779.57,7087596.21000007
"8257",2018-03-23 02:54:01,1210653.5,8298249.71000007
"8258",2018-03-23 02:56:46,-1210653.5,7087596.21000007
"20925",2018-03-23 04:31:49,274718.73,7362314.94000007
"8259",2018-03-23 08:55:01,1357780.23,8720095.17000007
"8260",2018-03-23 09:10:21,-1357780.23,7362314.94000007
"20926",2018-03-23 09:31:12,230533.07,7592848.01000007
"8261",2018-03-23 10:10:20,201704.14,7794552.15000007
"8262",2018-03-23 10:26:00,-201704.14,7592848.01000007
"20927",2018-03-23 10:43:59,255654.56,7848502.57000007
"20928",2018-03-23 11:03:32,139631.83,7988134.40000007
"20929",2018-03-23 12:09:02,208014.3,8196148.70000007
"8263",2018-03-23 12:33:16,17403.48,8213552.18000007
"8264",2018-03-23 12:41:50,186299.49,8399851.67000007
"8265",2018-03-23 12:41:50,-17403.48,8382448.19000007
"8266",2018-03-23 12:56:41,-186299.49,8196148.70000007
"20930",2018-03-23 13:02:48,182187.89,8378336.59000007
"20931",2018-03-23 13:03:22,220809.4,8599145.99000007
"20932",2018-03-23 13:06:28,193856.78,8793002.77000007
"8267",2018-03-23 13:40:38,118819.71,8911822.48000007
"20933",2018-03-23 13:40:38,9822.12,8921644.60000007
"8268",2018-03-23 13:45:41,-118819.71,8802824.89000007
"20934",2018-03-23 14:00:47,124594.5,8927419.39000007
"20935",2018-03-23 14:24:03,141578.44,9068997.83000007
"20936",2018-03-23 14:24:03,89564.22,9158562.05000007
"20937",2018-03-23 14:40:27,96939.4,9255501.45000007
"8269",2018-03-23 14:44:06,99895.97,9355397.42000007
"8270",2018-03-23 14:49:35,16110.8,9371508.22000007
"8271",2018-03-23 14:49:35,-99895.97,9271612.25000007
"8272",2018-03-23 15:16:43,140192.06,9411804.31000007
"8273",2018-03-23 15:16:43,599994.04,10011798.3500001
"8274",2018-03-23 15:16:43,599994.05,10611792.4000001
"8275",2018-03-23 15:16:43,599994.03,11211786.4300001
"8276",2018-03-23 15:16:43,599994.02,11811780.4500001
"8277",2018-03-23 15:16:43,-16110.8,11795669.6500001
"20938",2018-03-23 15:16:43,107043.86,11902713.5100001
"20939",2018-03-23 15:16:43,599994,12502707.5100001
"20940",2018-03-23 15:16:43,227503.01,12730210.5200001
"20941",2018-03-23 15:16:43,599993.97,13330204.4900001
"20942",2018-03-23 15:16:43,599993.98,13930198.4700001
"20943",2018-03-23 15:16:43,599993.99,14530192.4600001
"8278",2018-03-23 15:38:53,-2540168.2,11990024.2600001
"20944",2018-03-23 15:38:53,599994.08,12590018.3400001
"20945",2018-03-23 15:38:53,346248.09,12936266.4300001
"20946",2018-03-23 23:57:43,480600.98,13416867.4100001
"8279",2018-03-24 03:53:30,1020144.67,14437012.0800001
"8280",2018-03-24 04:02:10,-1020144.67,13416867.4100001
"20947",2018-03-24 05:54:31,1126956.73,14543824.1400001
"8281",2018-03-24 18:13:36,361800.28,14905624.4200001
"8282",2018-03-24 18:15:21,-361800.28,14543824.1400001
"20948",2018-03-25 04:21:08,599994.82,15143818.9600001
"20949",2018-03-25 04:21:08,400358.83,15544177.7900001
"8283",2018-03-25 04:34:53,675809.33,16219987.1200001
"20950",2018-03-25 04:34:53,920314.13,17140301.2500001
"8284",2018-03-25 04:36:22,-675809.33,16464491.9200001
"20951",2018-03-25 07:24:26,963960.25,17428452.1700001
"20952",2018-03-25 08:02:00,476635.33,17905087.5000001
"20953",2018-03-26 09:50:12,592551.4,18497638.9000001
"8285",2018-03-26 10:50:55,769001.79,19266640.6900001
"8286",2018-03-26 11:19:33,-769001.79,18497638.9000001
"20954",2018-03-26 11:28:28,1181560.1,19679199.0000001
"20955",2018-03-26 12:10:29,599995.33,20279194.3300001
"20956",2018-03-26 12:10:29,500769.34,20779963.6700001
"8287",2018-03-26 17:07:41,793526.95,21573490.6200001
"8288",2018-03-26 17:12:07,-793526.95,20779963.6700001
"20957",2018-03-26 17:55:56,13205.62,20793169.2900001
"20958",2018-03-26 17:58:38,599995.61,21393164.9000001
"20959",2018-03-26 17:58:38,599995.6,21993160.5000001
"8289",2018-03-26 18:22:59,1172832.13,23165992.6300001
"8290",2018-03-26 18:45:21,-1172832.13,21993160.5000001
"20960",2018-03-26 22:20:43,588252.76,22581413.2600001
"20961",2018-03-26 22:31:19,599995.74,23181409.0000001
"20962",2018-03-26 22:31:19,273976.75,23455385.7500001
"8291",2018-03-27 02:27:27,680008.59,24135394.3400001
"8292",2018-03-27 02:36:43,-680008.59,23455385.7500001
"8293",2018-03-27 05:44:42,73080.06,23528465.8100001
"8294",2018-03-27 05:44:42,599996.05,24128461.8600001
"8295",2018-03-27 05:49:03,-673076.11,23455385.7500001
"20963",2018-03-27 11:50:31,-23455385.75,7.45058059692383e-08
"8296",2018-03-27 12:49:11,37322.09,37322.0900000745
"8297",2018-03-27 13:22:18,599996.23,637318.320000074
"8298",2018-03-27 13:43:19,-37322.09,599996.230000074
"8299",2018-03-27 14:03:35,-599996.23,7.45058059692383e-08
"20964",2018-03-27 19:27:06,599996.31,599996.310000075
"20965",2018-03-27 19:27:06,213036.34,813032.650000075
"20966",2018-03-27 19:27:06,599996.32,1413028.97000007
"20967",2018-03-27 19:27:06,599996.33,2013025.30000007
"20968",2018-03-27 20:01:23,-2013025.3,7.42729753255844e-08
"20969",2018-03-28 02:39:44,566453.62,566453.620000074
"20970",2018-03-28 02:39:44,599996.61,1166450.23000007
"20971",2018-03-28 02:48:17,-1166450.23,7.42729753255844e-08
"8300",2018-03-28 06:25:41,629572.79,629572.790000074
"8301",2018-03-28 07:08:27,-629572.79,7.42729753255844e-08
"8302",2018-03-28 07:27:52,151419.79,151419.790000074
"8303",2018-03-28 07:27:52,599996.77,751416.560000074
"8304",2018-03-28 07:27:52,599996.78,1351413.34000007
"8305",2018-03-28 07:51:51,-1351413.34,7.42729753255844e-08
"20972",2018-03-28 08:42:44,1036905.74,1036905.74000007
"20973",2018-03-28 09:12:08,-1036905.74,7.42729753255844e-08
"8306",2018-03-28 12:59:34,590122.72,590122.720000074
"8307",2018-03-28 13:01:34,-590122.72,7.42729753255844e-08
"8308",2018-03-29 01:05:30,599997.12,599997.120000074
"8309",2018-03-29 01:05:30,308781.13,908778.250000074
"8310",2018-03-29 01:09:39,-908778.25,7.42729753255844e-08
"20974",2018-03-29 10:16:58,552229.58,552229.580000074
"20975",2018-03-29 10:32:03,-552229.58,7.42729753255844e-08
"20976",2018-03-29 12:43:24,696773.89,696773.890000074
"20977",2018-03-29 12:53:59,496990.76,1193764.65000007
"20978",2018-03-29 13:41:39,-1193764.65,7.45058059692383e-08
"20979",2018-03-29 20:46:21,515495.96,515495.960000075
"20980",2018-03-29 20:46:21,599997.94,1115493.90000007
"20981",2018-03-29 20:46:21,599997.95,1715491.85000007
"20982",2018-03-29 20:46:21,599997.93,2315489.78000007
"20983",2018-03-29 20:59:11,522406,2837895.78000007
"20984",2018-03-29 20:59:11,599997.97,3437893.75000007
"20985",2018-03-29 20:59:11,599997.98,4037891.73000007
"20986",2018-03-29 20:59:11,599997.99,4637889.72000007
"8311",2018-03-29 23:43:18,580008.23,5217897.95000007
"8312",2018-03-29 23:43:18,570008.22,5787906.17000007
"8313",2018-03-29 23:43:18,585008.24,6372914.41000007
"8314",2018-03-30 00:05:17,-1735024.69,4637889.72000007
"20987",2018-03-30 01:20:52,-4637889.72,7.35744833946228e-08
"8315",2018-03-30 16:23:43,599998.84,599998.840000074
"8316",2018-03-30 16:23:43,231922.86,831921.700000074
"8317",2018-03-30 16:23:43,599998.85,1431920.55000007
"20988",2018-03-30 16:23:43,599998.82,2031919.37000007
"20989",2018-03-30 16:23:43,599998.79,2631918.16000007
"20990",2018-03-30 16:23:43,599998.8,3231916.96000007
"20991",2018-03-30 16:23:43,599998.81,3831915.77000007
"20992",2018-03-30 16:23:43,577486.83,4409402.60000007
"8318",2018-03-30 16:38:05,488288.89,4897691.49000007
"8319",2018-03-30 16:38:05,599998.88,5497690.37000007
"8320",2018-03-30 16:38:05,599998.87,6097689.24000007
"8321",2018-03-30 16:43:42,-1431920.55,4665768.69000007
"20993",2018-03-30 16:43:42,-2977482.05,1688286.64000007
"8322",2018-03-30 16:52:12,-1688286.64,7.33416527509689e-08
"8323",2018-03-30 22:27:09,3578434.46,3578434.46000007
"8324",2018-03-30 22:29:59,-3578434.46,7.35744833946228e-08
"20994",2018-03-30 22:42:49,2075200.99,2075200.99000007
"20995",2018-03-30 23:10:54,-2075200.99,7.35744833946228e-08
"8325",2018-03-31 11:05:05,903624.69,903624.690000074
"8326",2018-03-31 11:16:38,-903624.69,7.35744833946228e-08
"8327",2018-04-01 01:51:34,1491452.69,1491452.69000007
"8328",2018-04-01 01:58:55,-1491452.69,7.35744833946228e-08
"20996",2018-04-01 09:13:36,599999.56,599999.560000074
"20997",2018-04-01 09:13:36,423579.57,1023579.13000007
"20998",2018-04-01 09:13:36,599999.55,1623578.68000007
"20999",2018-04-01 09:13:36,599999.54,2223578.22000007
"21000",2018-04-01 09:25:38,-2223578.22,7.35744833946228e-08
"21001",2018-04-01 14:38:19,952163.9,952163.900000074
"21002",2018-04-01 14:47:11,-952163.9,7.35744833946228e-08
"8329",2018-04-02 21:35:59,599999.85,599999.850000074
"8330",2018-04-02 21:35:59,591795.86,1191795.71000007
"8331",2018-04-02 21:50:26,-1191795.71,7.35744833946228e-08
"21003",2018-04-03 03:20:48,1826294.65,1826294.65000007
"21004",2018-04-03 04:00:55,-1826294.65,7.35744833946228e-08
"8332",2018-04-04 03:28:23,1218269.67,1218269.67000007
"8333",2018-04-04 03:53:40,-1218269.67,7.35744833946228e-08
"21005",2018-04-04 05:12:33,464918.38,464918.380000074
"21006",2018-04-04 05:49:30,-464918.38,7.35744833946228e-08
"21007",2018-04-04 09:41:32,1200875.55,1200875.55000007
"21008",2018-04-04 10:09:14,-1200875.55,7.35744833946228e-08
"8334",2018-04-04 13:57:49,520232.09,520232.090000074
"8335",2018-04-04 13:57:49,599990.08,1120222.17000007
"8336",2018-04-04 14:43:14,-1120222.17,7.35744833946228e-08
"8337",2018-04-04 14:55:11,599990.15,599990.150000074
"8338",2018-04-04 14:55:11,599990.16,1199980.31000007
"8339",2018-04-04 14:55:11,233326.17,1433306.48000007
"8340",2018-04-04 15:15:33,-1199980.31,233326.170000073
"8341",2018-04-04 15:24:27,-233326.17,7.34871719032526e-08
"21009",2018-04-04 15:28:07,472919.44,472919.440000074
"21010",2018-04-04 15:44:57,-472919.44,7.35162757337093e-08
"21011",2018-04-04 16:34:40,599990.28,599990.280000074
"21012",2018-04-04 16:34:40,168355.29,768345.570000074
"21013",2018-04-04 16:34:40,599990.27,1368335.84000007
"21014",2018-04-04 16:51:05,-1368335.84,7.35744833946228e-08
"8342",2018-04-05 17:29:32,551665.13,551665.130000074
"8343",2018-04-05 17:43:05,-551665.13,7.35744833946228e-08
"8344",2018-04-05 22:26:23,1375432.92,1375432.92000007
"8345",2018-04-05 22:35:16,-1375432.92,7.35744833946228e-08
"21015",2018-04-06 07:37:56,599990.58,599990.580000074
"21016",2018-04-06 07:37:56,34829.59,634820.170000073
"21017",2018-04-06 07:37:56,599990.57,1234810.74000007
"21018",2018-04-06 08:11:30,-1234810.74,7.33416527509689e-08
"8346",2018-04-06 11:35:09,599990.67,599990.670000073
"8347",2018-04-06 11:35:09,599990.66,1199981.33000007
"8348",2018-04-06 11:35:09,323302.68,1523284.01000007
"8349",2018-04-06 11:54:23,-1523284.01,7.33416527509689e-08
"21019",2018-04-06 12:01:10,599990.69,599990.690000073
"21020",2018-04-06 12:01:10,482166.7,1082157.39000007
"21021",2018-04-06 12:45:00,-1082157.39,7.33416527509689e-08
"8350",2018-04-06 17:09:28,599990.74,599990.740000073
"8351",2018-04-06 17:09:28,255150.75,855141.490000073
"8352",2018-04-06 17:14:28,-855141.49,7.33416527509689e-08
"8353",2018-04-06 23:54:08,1297719.41,1297719.41000007
"8354",2018-04-07 00:18:25,-1297719.41,7.33416527509689e-08
"8355",2018-04-07 04:14:40,783320.63,783320.630000073
"8356",2018-04-07 04:28:47,-783320.63,7.33416527509689e-08
"8357",2018-04-07 11:48:07,1101743.67,1101743.67000007
"8358",2018-04-07 11:52:28,-1101743.67,7.33416527509689e-08
"8359",2018-04-07 16:39:16,1191488.57,1191488.57000007
"8360",2018-04-07 16:51:45,-1191488.57,7.33416527509689e-08
"21022",2018-04-09 23:14:03,599991.29,599991.290000073
"21023",2018-04-09 23:14:03,599991.3,1199982.59000007
"21024",2018-04-09 23:14:03,599991.31,1799973.90000007
"21025",2018-04-09 23:14:03,162361.32,1962335.22000007
"8361",2018-04-10 00:02:02,1320237.78,3282573.00000007
"21026",2018-04-10 00:02:02,-1962335.22,1320237.78000007
"8362",2018-04-10 00:17:36,-1320237.78,7.35744833946228e-08
"8363",2018-04-12 03:57:24,599991.67,599991.670000074
"8364",2018-04-12 03:57:24,599991.66,1199983.33000007
"8365",2018-04-12 03:57:24,33851.68,1233835.01000007
"8366",2018-04-12 04:12:54,-1233835.01,7.35744833946228e-08
"8367",2018-04-12 08:29:35,2099713.34,2099713.34000007
"8368",2018-04-12 08:45:17,-2099713.34,7.35744833946228e-08
"21027",2018-04-12 11:35:53,379050.76,379050.760000074
"21028",2018-04-12 11:35:53,1999991.75,2379042.51000007
"8369",2018-04-12 12:17:30,1042364.86,3421407.37000007
"8370",2018-04-12 12:17:30,1999991.85,5421399.22000007
"8371",2018-04-12 12:17:30,1818319.38,7239718.60000007
"8372",2018-04-12 12:31:44,1081377.54,8321096.14000007
"8373",2018-04-12 12:31:44,-4860676.09,3460420.05000007
"21029",2018-04-12 12:31:44,-2379042.51,1081377.54000007
"8374",2018-04-12 12:45:29,-1081377.54,7.35744833946228e-08
"8375",2018-04-12 14:30:54,1870430.96,1870430.96000007
"8376",2018-04-12 14:51:36,1999991.95,3870422.91000007
"8377",2018-04-12 15:18:15,1999991.97,5870414.88000007
"8378",2018-04-12 15:18:15,984656.98,6855071.86000007
"8379",2018-04-12 15:18:15,-1870430.96,4984640.90000007
"8380",2018-04-12 15:51:26,1467656.9,6452297.80000007
"8381",2018-04-12 16:59:28,600254.03,7052551.83000007
"8382",2018-04-12 16:59:28,1999992.02,9052543.85000007
"8383",2018-04-12 16:59:28,1899306.28,10951850.1300001
"8384",2018-04-12 16:59:31,-4984640.9,5967209.23000007
"8385",2018-04-12 17:11:55,-5967209.23,7.26431608200073e-08
"8386",2018-04-13 01:38:52,1549679.78,1549679.78000007
"8387",2018-04-13 01:43:19,-1549679.78,7.26431608200073e-08
"8388",2018-04-13 21:07:28,599992.38,599992.380000073
"8389",2018-04-13 21:07:28,599992.35,1199984.73000007
"8390",2018-04-13 21:07:28,599992.36,1799977.09000007
"8391",2018-04-13 21:07:28,599992.37,2399969.46000007
"8392",2018-04-13 21:07:28,78612.39,2478581.85000007
"8393",2018-04-13 21:21:43,-2478581.85,7.26431608200073e-08
"8394",2018-04-13 21:24:01,237268.41,237268.410000073
"8395",2018-04-13 21:30:32,1999992.4,2237260.81000007
"8396",2018-04-13 21:30:32,-237268.41,1999992.40000007
"8397",2018-04-13 21:53:38,-1999992.4,7.28759914636612e-08
"21030",2018-04-13 22:23:42,1999992.42,1999992.42000007
"21031",2018-04-13 22:23:42,656393.43,2656385.85000007
"21032",2018-04-13 22:34:53,-2656385.85,7.26431608200073e-08
"8398",2018-04-14 00:33:33,1139386.51,1139386.51000007
"8399",2018-04-14 00:46:54,-1139386.51,7.26431608200073e-08
"21033",2018-04-16 07:36:50,73125.96,73125.9600000726
"21034",2018-04-16 07:36:50,843317.67,916443.630000073
"21035",2018-04-16 07:51:56,965396.06,1881839.69000007
"21036",2018-04-16 08:05:11,-1881839.69,7.26431608200073e-08
"21037",2018-04-16 13:18:28,560268.46,560268.460000073
"21038",2018-04-16 14:02:21,1261287.57,1821556.03000007
"21039",2018-04-16 14:12:33,-1821556.03,7.26431608200073e-08
"21040",2018-04-17 02:43:36,600978.15,600978.150000073
"21041",2018-04-17 03:26:58,-600978.15,7.26431608200073e-08
"21042",2018-04-17 05:55:29,550480.14,550480.140000073
"21043",2018-04-17 05:55:29,599993.13,1150473.27000007
"21044",2018-04-17 06:17:19,-1150473.27,7.26431608200073e-08
"8400",2018-04-20 05:30:35,264223.78,264223.780000073
"8401",2018-04-20 05:30:35,1999993.77,2264217.55000007
"8402",2018-04-20 05:35:38,-2264217.55,7.26431608200073e-08
"21045",2018-04-20 10:52:42,1999993.79,1999993.79000007
"21046",2018-04-20 10:52:42,1407256.8,3407250.59000007
"21047",2018-04-20 11:26:47,-3407250.59,7.26431608200073e-08
"21048",2018-04-20 16:37:14,599993.84,599993.840000073
"21049",2018-04-20 16:37:14,512519.86,1112513.70000007
"21050",2018-04-20 16:37:14,599993.82,1712507.52000007
"21051",2018-04-20 16:37:14,599993.85,2312501.37000007
"21052",2018-04-20 16:37:14,599993.83,2912495.20000007
"21053",2018-04-20 17:02:57,-2912495.2,7.26431608200073e-08
"21054",2018-04-20 23:44:44,223708.09,223708.090000073
"21055",2018-04-20 23:51:05,483778.02,707486.110000073
"21056",2018-04-21 00:04:04,-707486.11,7.26431608200073e-08
"8403",2018-04-21 11:18:04,108401.12,108401.120000073
"8404",2018-04-21 11:18:04,1999994.11,2108395.23000007
"8405",2018-04-21 11:22:55,-2108395.23,7.26431608200073e-08
"8406",2018-04-21 11:30:20,740405.37,740405.370000073
"8407",2018-04-21 11:34:57,-740405.37,7.26431608200073e-08
"21057",2018-04-21 12:08:53,1999994.2,1999994.20000007
"21058",2018-04-21 12:08:53,243216.21,2243210.41000007
"21059",2018-04-21 12:18:17,-2243210.41,7.26431608200073e-08
"8408",2018-04-21 12:29:03,1182564.21,1182564.21000007
"8409",2018-04-21 12:33:15,-1182564.21,7.26431608200073e-08
"8410",2018-04-22 13:11:09,661769.06,661769.060000073
"8411",2018-04-22 13:15:10,-661769.06,7.26431608200073e-08
"8412",2018-04-22 14:42:32,1116293.27,1116293.27000007
"8413",2018-04-22 15:04:12,-1116293.27,7.26431608200073e-08
"21060",2018-04-23 01:08:00,751253.4,751253.400000073
"21061",2018-04-23 01:29:52,-751253.4,7.26431608200073e-08
"8414",2018-04-23 10:33:48,1337148.3,1337148.30000007
"8415",2018-04-23 10:41:08,-1337148.3,7.26431608200073e-08
"21062",2018-04-24 01:37:17,1999994.86,1999994.86000007
"21063",2018-04-24 01:51:13,1192813.87,3192808.73000007
"8416",2018-04-24 11:21:28,963510.93,4156319.66000007
"8417",2018-04-24 11:21:28,1999994.92,6156314.58000007
"8418",2018-04-24 11:35:26,-2963505.85,3192808.73000007
"21064",2018-04-24 13:55:05,1876855.93,5069664.66000007
"21065",2018-04-24 18:56:16,-5069664.66,7.26431608200073e-08
"8419",2018-04-24 21:14:06,599995.1,599995.100000073
"8420",2018-04-24 21:14:06,599995.09,1199990.19000007
"8421",2018-04-24 21:14:06,599995.08,1799985.27000007
"8422",2018-04-24 21:14:06,537399.11,2337384.38000007
"8423",2018-04-24 21:16:46,-2337384.38,7.26431608200073e-08
"8424",2018-04-25 06:19:59,419927.31,419927.310000073
"8425",2018-04-25 06:26:42,219021.31,638948.620000073
"8426",2018-04-25 07:25:25,-419927.31,219021.310000073
"8427",2018-04-25 07:30:02,1999996.41,2219017.72000007
"8428",2018-04-25 07:30:02,1999996.4,4219014.12000007
"8429",2018-04-25 07:30:02,1999996.39,6219010.51000007
"8430",2018-04-25 07:30:02,1045315.42,7264325.93000007
"21066",2018-04-25 07:30:02,1999996.32,9264322.25000007
"21067",2018-04-25 07:30:02,1618500.34,10882822.5900001
"21068",2018-04-25 07:30:02,1999996.31,12882818.9000001
"21069",2018-04-25 07:30:02,1999996.33,14882815.2300001
"8431",2018-04-25 07:53:53,-7264325.93,7618489.30000007
"8432",2018-04-25 08:22:03,2282833.12,9901322.42000007
"8433",2018-04-25 08:22:03,599996.52,10501318.9400001
"8434",2018-04-25 08:22:03,599996.5,11101315.4400001
"8435",2018-04-25 08:22:03,23377.53,11124692.9700001
"8436",2018-04-25 08:22:03,599996.51,11724689.4800001
"21070",2018-04-25 08:22:03,-7618489.3,4106200.18000007
"21071",2018-04-25 08:22:03,599996.44,4706196.62000007
"21072",2018-04-25 08:22:03,330580.46,5036777.08000007
"21073",2018-04-25 08:22:03,599996.43,5636773.51000007
"21074",2018-04-25 08:22:03,599996.45,6236769.96000007
"8437",2018-04-25 08:39:00,-4106200.18,2130569.78000007
"21075",2018-04-25 09:02:22,-2130569.78,7.17118382453918e-08
"21076",2018-04-25 10:16:31,1215504.6,1215504.60000007
"21077",2018-04-25 11:05:42,-1215504.6,7.17118382453918e-08
"21078",2018-04-25 13:14:30,470611.41,470611.410000072
"21079",2018-04-25 13:14:30,599997.39,1070608.80000007
"21080",2018-04-25 13:14:30,599997.4,1670606.20000007
"21081",2018-04-25 13:14:30,599997.38,2270603.58000007
"21082",2018-04-25 13:14:30,599997.37,2870600.95000007
"8438",2018-04-25 13:31:46,358056.73,3228657.68000007
"21083",2018-04-25 13:44:55,-2870600.95,358056.730000072
"8439",2018-04-25 14:09:53,1338230.19,1696286.92000007
"8440",2018-04-25 14:37:10,-358056.73,1338230.19000007
"8441",2018-04-25 14:48:20,-1338230.19,7.17118382453918e-08
"21084",2018-04-25 16:43:37,1013493.91,1013493.91000007
"8442",2018-04-25 16:47:51,1656009.51,2669503.42000007
"8443",2018-04-25 16:47:51,1999997.49,4669500.91000007
"8444",2018-04-25 16:47:51,1999997.5,6669498.41000007
"8445",2018-04-25 16:47:51,1999997.48,8669495.89000007
"21085",2018-04-25 16:47:51,1999997.52,10669493.4100001
"21086",2018-04-25 16:47:51,1999997.53,12669490.9400001
"21087",2018-04-25 16:47:51,1835427.54,14504918.4800001
"8446",2018-04-25 17:47:30,280707.68,14785626.1600001
"8447",2018-04-25 17:47:30,1061451.79,15847077.9500001
"8448",2018-04-25 17:47:30,1999997.67,17847075.6200001
"21088",2018-04-25 17:47:30,-6848916.5,10998159.1200001
"8449",2018-04-25 18:57:36,-7656001.98,3342157.14000007
"8450",2018-04-25 19:05:20,-3342157.14,7.12461769580841e-08
"21089",2018-04-25 19:55:36,2218993.11,2218993.11000007
"21090",2018-04-25 20:01:45,-2218993.11,7.12461769580841e-08
"8451",2018-04-25 20:05:27,599997.34,599997.340000071
"8452",2018-04-25 20:05:27,437195.35,1037192.69000007
"8453",2018-04-25 20:17:54,-1037192.69,7.12461769580841e-08
"8454",2018-04-25 20:18:54,361299.06,361299.060000071
"8455",2018-04-25 20:38:13,-361299.06,7.12461769580841e-08
"8456",2018-05-03 03:40:13,599990.17,599990.170000071
"8457",2018-05-03 03:40:13,34050.2,634040.370000071
"8458",2018-05-03 03:40:13,599990.18,1234030.55000007
"8459",2018-05-03 03:40:13,599990.16,1834020.71000007
"8460",2018-05-03 03:40:13,599990.19,2434010.90000007
"8461",2018-05-03 03:40:13,599990.14,3034001.04000007
"8462",2018-05-03 03:40:13,599990.15,3633991.19000007
"8463",2018-05-03 04:16:02,-3633991.19,7.12461769580841e-08
"8464",2018-05-03 19:49:38,599990.59,599990.590000071
"8465",2018-05-03 19:49:38,599990.58,1199981.17000007
"8466",2018-05-03 19:49:38,599990.6,1799971.77000007
"8467",2018-05-03 19:49:38,599990.62,2399962.39000007
"8468",2018-05-03 19:49:38,599990.61,2999953.00000007
"8469",2018-05-03 19:49:38,29559.64,3029512.64000007
"8470",2018-05-03 19:49:38,599990.63,3629503.27000007
"21091",2018-05-03 19:49:38,599990.53,4229493.80000007
"21092",2018-05-03 19:49:38,599990.55,4829484.35000007
"21093",2018-05-03 19:49:38,599990.54,5429474.89000007
"21094",2018-05-03 19:49:38,599990.56,6029465.45000007
"21095",2018-05-03 19:49:38,599990.52,6629455.97000007
"21096",2018-05-03 19:49:38,278911.57,6908367.54000007
"21097",2018-05-03 20:20:09,-3278864.27,3629503.27000007
"8471",2018-05-03 20:30:26,-3629503.27,7.17118382453918e-08
"8472",2018-05-05 03:55:52,1295774.86,1295774.86000007
"8473",2018-05-05 04:01:59,-1295774.86,7.17118382453918e-08
"21098",2018-05-05 12:45:35,597247.29,597247.290000072
"21099",2018-05-05 12:45:35,599991.28,1197238.57000007
"21100",2018-05-05 12:45:35,599991.27,1797229.84000007
"21101",2018-05-05 12:56:40,-1797229.84,7.17118382453918e-08
"8474",2018-05-05 21:52:49,2976321.92,2976321.92000007
"8475",2018-05-05 22:21:45,-2976321.92,7.17118382453918e-08
"21102",2018-05-05 23:31:15,599991.68,599991.680000072
"21103",2018-05-05 23:31:15,599991.7,1199983.38000007
"21104",2018-05-05 23:31:15,396579.71,1596563.09000007
"21105",2018-05-05 23:31:15,599991.67,2196554.76000007
"21106",2018-05-05 23:31:15,599991.69,2796546.45000007
"21107",2018-05-05 23:38:53,-2796546.45,7.12461769580841e-08
"8476",2018-05-08 12:57:30,3000020.9,3000020.90000007
"21108",2018-05-08 12:57:30,3000020.88,6000041.78000007
"21109",2018-05-08 13:22:03,-3000020.88,3000020.90000007
"8477",2018-05-08 14:12:57,159882.82,3159903.72000007
"8478",2018-05-08 14:12:57,1999992.81,5159896.53000007
"8479",2018-05-08 14:25:15,-3000020.9,2159875.63000007
"8480",2018-05-08 14:59:06,-2159875.63,7.12461769580841e-08
"8481",2018-05-09 14:51:13,3777798.36,3777798.36000007
"21110",2018-05-09 14:51:13,3000021.37,6777819.73000007
"8482",2018-05-09 15:07:29,-3777798.36,3000021.37000007
"21111",2018-05-09 15:12:11,-3000021.37,7.12461769580841e-08
"8483",2018-05-10 15:42:26,3000021.69,3000021.69000007
"21112",2018-05-10 15:42:26,3000021.67,6000043.36000007
"8484",2018-05-10 15:48:57,-3000021.69,3000021.67000007
"21113",2018-05-10 16:10:51,-3000021.67,7.12461769580841e-08
"8485",2018-05-12 01:39:43,1615522.27,1615522.27000007
"8486",2018-05-12 02:11:05,-1615522.27,7.12461769580841e-08
"8487",2018-05-12 16:15:55,1999996.13,1999996.13000007
"21114",2018-05-12 16:17:44,1512232.78,3512228.91000007
"8488",2018-05-12 16:21:40,94377.78,3606606.69000007
"8489",2018-05-12 16:21:40,431671.14,4038277.83000007
"8490",2018-05-12 16:21:40,-1999996.13,2038281.70000007
"8491",2018-05-12 16:31:33,541975.45,2580257.15000007
"8492",2018-05-12 16:31:33,-526048.92,2054208.23000007
"21115",2018-05-12 16:31:33,-1512232.78,541975.450000071
"8493",2018-05-12 16:37:22,-541975.45,7.12461769580841e-08
"8494",2018-05-14 17:23:58,599997.17,599997.170000071
"8495",2018-05-14 17:23:58,226065.18,826062.350000071
"8496",2018-05-14 17:28:25,-826062.35,7.1362592279911e-08
"8497",2018-05-14 17:43:25,599997.37,599997.370000071
"8498",2018-05-14 17:43:25,99916.38,699913.750000071
"8499",2018-05-14 17:43:25,599997.36,1299911.11000007
"8500",2018-05-14 17:43:25,599997.35,1899908.46000007
"8501",2018-05-14 17:46:05,-1899908.46,7.12461769580841e-08
"8502",2018-05-14 22:16:03,1249651.93,1249651.93000007
"8503",2018-05-14 22:19:40,-1249651.93,7.12461769580841e-08
"8504",2018-05-15 02:01:23,1128186.85,1128186.85000007
"8505",2018-05-15 02:04:28,-1128186.85,7.12461769580841e-08
"8506",2018-05-15 20:08:52,599997.94,599997.940000071
"8507",2018-05-15 20:08:52,447304.95,1047302.89000007
"8508",2018-05-15 20:21:10,-1047302.89,7.11297616362572e-08
"8509",2018-05-15 22:09:20,1305559.88,1305559.88000007
"8510",2018-05-15 22:35:11,-1305559.88,7.12461769580841e-08
"8511",2018-05-15 23:24:30,1146153.32,1146153.32000007
"8512",2018-05-15 23:33:46,-1146153.32,7.12461769580841e-08
"21116",2018-05-16 10:22:24,1295959.97,1295959.97000007
"21117",2018-05-16 10:38:57,-1295959.97,7.12461769580841e-08
"8513",2018-05-16 14:33:40,442407.09,442407.090000071
"8514",2018-05-16 14:33:40,599998.08,1042405.17000007
"8515",2018-05-16 14:39:31,-1042405.17,7.11297616362572e-08
"8516",2018-05-16 22:58:25,1385747.07,1385747.07000007
"8517",2018-05-16 23:09:05,-1385747.07,7.10133463144302e-08
"8518",2018-05-18 04:43:55,599999.94,599999.940000071
"8519",2018-05-18 04:43:55,68599.95,668599.890000071
"8520",2018-05-18 04:43:55,599999.93,1268599.82000007
"21118",2018-05-18 04:43:55,1589194.02,2857793.84000007
"8521",2018-05-18 04:47:40,-1268599.82,1589194.02000007
"21119",2018-05-18 05:19:10,-1589194.02,7.10133463144302e-08
"8522",2018-05-18 14:21:33,302408.08,302408.080000071
"8523",2018-05-18 14:21:33,599990.07,902398.150000071
"8524",2018-05-18 14:21:33,599990.06,1502388.21000007
"8525",2018-05-18 14:21:33,599990.05,2102378.26000007
"8526",2018-05-18 14:42:41,-2102378.26,7.12461769580841e-08
"8527",2018-05-18 14:51:31,135100.12,135100.120000071
"8528",2018-05-18 14:51:31,599990.1,735090.220000071
"8529",2018-05-18 14:51:31,599990.11,1335080.33000007
"8530",2018-05-18 15:59:47,-1335080.33,7.12461769580841e-08
"8531",2018-05-19 00:07:52,1999990.13,1999990.13000007
"8532",2018-05-19 00:33:21,92825.14,2092815.27000007
"8533",2018-05-19 00:33:21,-1999990.13,92825.1400000711
"8534",2018-05-19 00:48:11,-92825.14,7.11443135514855e-08
"8535",2018-05-20 03:13:34,599990.22,599990.220000071
"8536",2018-05-20 03:13:34,599990.21,1199980.43000007
"8537",2018-05-20 03:13:34,483423.23,1683403.66000007
"8538",2018-05-20 03:24:51,-1683403.66,7.10133463144302e-08
"21120",2018-05-22 10:37:55,258380.64,258380.640000071
"21121",2018-05-22 10:37:55,599990.63,858371.270000071
"21122",2018-05-22 10:49:41,-858371.27,7.10133463144302e-08
"8539",2018-05-23 07:57:29,97330.61,97330.610000071
"8540",2018-05-23 08:08:02,-97330.61,7.10133463144302e-08
"8541",2018-05-23 08:15:52,1009647.42,1009647.42000007
"8542",2018-05-23 08:35:05,-1009647.42,7.10133463144302e-08
"21123",2018-05-23 15:58:58,332011.72,332011.720000071
"8543",2018-05-23 16:24:18,704419.81,1036431.53000007
"8544",2018-05-23 16:40:30,-704419.81,332011.720000071
"21124",2018-05-23 16:40:30,-332011.72,7.10133463144302e-08
"8545",2018-05-23 16:42:03,599993.88,599993.880000071
"8546",2018-05-23 16:42:03,439350.89,1039344.77000007
"21125",2018-05-23 16:42:03,599993.85,1639338.62000007
"21126",2018-05-23 16:42:03,599993.86,2239332.48000007
"21127",2018-05-23 16:42:03,4198.87,2243531.35000007
"8547",2018-05-23 16:47:59,-1039344.77,1204186.58000007
"21128",2018-05-23 17:02:29,-1204186.58,7.07805156707764e-08
"21129",2018-05-23 22:51:34,115699.06,115699.060000071
"21130",2018-05-23 22:51:34,599994.05,715693.110000071
"21131",2018-05-23 23:08:22,-715693.11,7.08969309926033e-08
"8548",2018-05-24 09:46:25,555559.43,555559.430000071
"21132",2018-05-24 09:46:25,555559.42,1111118.85000007
"8549",2018-05-24 09:58:41,-555559.43,555559.420000071
"21133",2018-05-24 09:58:41,-555559.42,7.07805156707764e-08
"21134",2018-05-24 10:20:07,954835.93,954835.930000071
"21135",2018-05-24 10:30:41,-954835.93,7.07805156707764e-08
"21136",2018-05-24 13:00:26,144346.59,144346.590000071
"21137",2018-05-24 13:00:26,599994.58,744341.170000071
"21138",2018-05-24 13:36:16,-744341.17,7.06641003489494e-08
"21139",2018-05-24 17:03:21,143185.81,143185.810000071
"21140",2018-05-24 17:03:21,599994.8,743180.610000071
"21141",2018-05-24 17:10:08,-743180.61,7.06641003489494e-08
"21142",2018-05-24 17:14:32,599994.82,599994.820000071
"21143",2018-05-24 17:14:32,94947.83,694942.650000071
"21144",2018-05-24 17:23:01,-694942.65,7.05476850271225e-08
"8550",2018-05-24 18:21:29,686171.7,686171.700000071
"8551",2018-05-24 18:25:48,-686171.7,7.05476850271225e-08
"8552",2018-05-25 06:59:18,619500.01,619500.010000071
"8553",2018-05-25 07:05:22,-619500.01,7.05476850271225e-08
"21145",2018-05-25 09:06:18,530014.13,530014.130000071
"21146",2018-05-25 10:34:13,-530014.13,7.05476850271225e-08
"8554",2018-05-25 11:37:22,625410.51,625410.510000071
"8555",2018-05-25 11:46:02,-625410.51,7.05476850271225e-08
"8556",2018-05-26 01:06:15,290950.12,290950.120000071
"8557",2018-05-26 01:06:15,599995.11,890945.230000071
"8558",2018-05-26 01:12:42,-890945.23,7.05476850271225e-08
"8559",2018-05-26 07:44:07,787782.48,787782.480000071
"8560",2018-05-26 07:48:13,-787782.48,7.05476850271225e-08
"8561",2018-05-26 17:36:18,702962.83,702962.830000071
"8562",2018-05-26 17:39:36,-702962.83,7.05476850271225e-08
"8563",2018-05-27 01:35:38,431200.45,431200.450000071
"8564",2018-05-27 01:35:38,599995.44,1031195.89000007
"8565",2018-05-27 01:41:36,-1031195.89,7.04312697052956e-08
"8566",2018-05-27 08:10:31,1195074.55,1195074.55000007
"8567",2018-05-27 08:15:36,-1195074.55,7.05476850271225e-08
"21147",2018-05-27 09:32:29,33092.98,33092.9800000706
"21148",2018-05-27 09:51:34,795493.25,828586.230000071
"8568",2018-05-27 09:55:23,233821.05,1062407.28000007
"8569",2018-05-27 10:03:30,-233821.05,828586.230000071
"21149",2018-05-27 10:03:30,-828586.23,7.05476850271225e-08
"8570",2018-05-27 11:15:15,332599.54,332599.540000071
"8571",2018-05-27 11:22:38,-332599.54,7.05476850271225e-08
"21150",2018-05-27 11:40:00,144185.14,144185.140000071
"21151",2018-05-27 11:40:00,142429.27,286614.410000071
"8572",2018-05-27 12:02:21,135122.9,421737.310000071
"21152",2018-05-27 12:02:21,-286614.41,135122.900000071
"8573",2018-05-27 12:14:37,-135122.9,7.06349965184927e-08
"21153",2018-05-27 12:14:37,128546.31,128546.310000071
"21154",2018-05-27 12:42:49,-128546.31,7.06349965184927e-08
"8574",2018-05-27 13:27:39,117103.56,117103.560000071
"21155",2018-05-27 13:27:39,87717.01,204820.570000071
"21156",2018-05-27 13:27:39,117733.82,322554.390000071
"8575",2018-05-27 13:40:37,-117103.56,205450.830000071
"21157",2018-05-27 13:49:59,-205450.83,7.06349965184927e-08
"21158",2018-05-27 14:17:59,70173.07,70173.0700000706
"8576",2018-05-27 14:19:30,11521.43,81694.5000000706
"8577",2018-05-27 14:22:05,-11521.43,70173.0700000706
"21159",2018-05-27 14:33:29,-70173.07,7.06349965184927e-08
"21160",2018-05-27 14:33:29,123401.45,123401.450000071
"21161",2018-05-27 14:33:29,121207.49,244608.940000071
"21162",2018-05-27 14:53:09,54519.06,299128.000000071
"8578",2018-05-27 15:10:56,37603.08,336731.080000071
"21163",2018-05-27 15:10:56,-299128,37603.0800000707
"21164",2018-05-27 15:10:56,85764.69,123367.770000071
"8579",2018-05-27 15:13:50,-37603.08,85764.6900000707
"21165",2018-05-27 15:27:09,-85764.69,7.06786522641778e-08
"21166",2018-05-27 15:27:09,57586.19,57586.1900000707
"21167",2018-05-27 15:27:09,33432.2,91018.3900000707
"21168",2018-05-27 15:57:16,-91018.39,7.06786522641778e-08
"21169",2018-05-27 15:57:16,24860.41,24860.4100000707
"21170",2018-05-27 16:17:10,-24860.41,7.06786522641778e-08
"21171",2018-05-27 16:17:10,38171.54,38171.5400000707
"8580",2018-05-27 16:20:19,377783.66,415955.200000071
"21172",2018-05-27 16:20:19,377783.64,793738.840000071
"8581",2018-05-27 16:43:47,-377783.66,415955.180000071
"21173",2018-05-27 16:53:06,236957.93,652913.110000071
"21174",2018-05-27 16:53:06,-415955.18,236957.930000071
"8582",2018-05-27 17:01:48,21302.73,258260.660000071
"21175",2018-05-27 17:01:48,229447.35,487708.010000071
"8583",2018-05-27 17:05:13,-21302.73,466405.280000071
"21176",2018-05-27 17:09:26,-466405.28,7.06641003489494e-08
"8584",2018-05-27 17:23:07,777784.06,777784.060000071
"21177",2018-05-27 17:23:07,777784.07,1555568.13000007
"8585",2018-05-27 17:34:53,-777784.06,777784.070000071
"21178",2018-05-27 17:43:36,206410.26,984194.330000071
"21179",2018-05-27 17:59:19,-777784.07,206410.260000071
"21180",2018-05-27 18:19:57,-206410.26,7.06641003489494e-08
"21181",2018-05-27 19:03:04,36180.33,36180.3300000707
"8586",2018-05-27 19:14:45,101149.44,137329.770000071
"8587",2018-05-27 19:24:10,-101149.44,36180.3300000707
"21182",2018-05-27 19:24:10,-36180.33,7.06786522641778e-08
"8588",2018-05-27 19:38:38,246658.24,246658.240000071
"8589",2018-05-27 19:45:02,-246658.24,7.06641003489494e-08
"21183",2018-05-27 21:01:17,98349.48,98349.4800000707
"21184",2018-05-27 21:10:58,-98349.48,7.06641003489494e-08
"8590",2018-05-27 21:34:29,112611.06,112611.060000071
"8591",2018-05-27 21:45:05,-112611.06,7.06641003489494e-08
"21185",2018-05-27 22:00:46,95990.76,95990.7600000707
"21186",2018-05-27 22:20:42,-95990.76,7.06641003489494e-08
"8592",2018-05-27 23:20:34,87677.9,87677.9000000707
"8593",2018-05-27 23:37:49,-87677.9,7.06641003489494e-08
"21187",2018-05-28 03:17:53,619312.04,619312.040000071
"21188",2018-05-28 03:32:12,-619312.04,7.06641003489494e-08
"21189",2018-05-28 03:32:12,563906.92,563906.920000071
"8594",2018-05-28 03:51:27,377786.19,941693.110000071
"21190",2018-05-28 03:51:27,181880.69,1123573.80000007
"8595",2018-05-28 04:03:09,-377786.19,745787.610000071
"21191",2018-05-28 04:03:09,32679.25,778466.860000071
"21192",2018-05-28 04:03:09,153917.79,932384.650000071
"21193",2018-05-28 04:03:09,23977.51,956362.160000071
"21194",2018-05-28 04:03:09,229904.66,1186266.82000007
"21195",2018-05-28 04:22:57,16826.4,1203093.22000007
"21196",2018-05-28 04:22:57,7507.09,1210600.31000007
"21197",2018-05-28 04:22:57,18403.83,1229004.14000007
"21198",2018-05-28 04:22:57,19919.86,1248924.00000007
"21199",2018-05-28 04:22:57,-1186266.82,62657.1800000707
"21200",2018-05-28 04:22:57,29939.88,92597.0600000707
"21201",2018-05-28 04:22:57,29313.13,121910.190000071
"21202",2018-05-28 04:22:57,29630.22,151540.410000071
"21203",2018-05-28 04:22:57,160073.84,311614.250000071
"21204",2018-05-28 04:22:57,79809.87,391424.120000071
"21205",2018-05-28 04:22:57,741882.69,1133306.81000007
"21206",2018-05-28 04:26:59,42894.62,1176201.43000007
"8596",2018-05-28 04:47:53,17714.34,1193915.77000007
"21207",2018-05-28 04:47:53,43134.51,1237050.28000007
"21208",2018-05-28 04:47:53,28885.49,1265935.77000007
"21209",2018-05-28 04:47:53,-1176201.43,89734.3400000709
"21210",2018-05-28 04:47:53,207617.15,297351.490000071
"21211",2018-05-28 04:47:53,37271.61,334623.100000071
"21212",2018-05-28 04:47:53,21120.97,355744.070000071
"21213",2018-05-28 04:47:53,158208.92,513952.990000071
"21214",2018-05-28 04:47:53,211036.52,724989.510000071
"21215",2018-05-28 04:51:27,49561.71,774551.220000071
"8597",2018-05-28 05:00:31,377786.66,1152337.88000007
"8598",2018-05-28 05:00:31,-17714.34,1134623.54000007
"21216",2018-05-28 05:00:31,21728.42,1156351.96000007
"21217",2018-05-28 05:00:31,15849.51,1172201.47000007
"21218",2018-05-28 05:00:31,-756836.88,415364.590000071
"21219",2018-05-28 05:00:31,134121.89,549486.480000071
"21220",2018-05-28 05:00:31,276895.22,826381.700000071
"21221",2018-05-28 05:00:31,86087.54,912469.240000071
"21222",2018-05-28 05:00:31,28462.09,940931.330000071
"21223",2018-05-28 05:00:31,36281.35,977212.680000071
"21224",2018-05-28 05:00:31,62110.76,1039323.44000007
"21225",2018-05-28 05:00:31,17009.1,1056332.54000007
"21226",2018-05-28 05:00:31,68177.01,1124509.55000007
"21227",2018-05-28 05:02:32,27603.95,1152113.50000007
"8599",2018-05-28 05:07:11,-377786.66,774326.840000071
"8600",2018-05-28 05:11:10,777786.87,1552113.71000007
"21228",2018-05-28 05:11:10,-774326.84,777786.870000071
"8601",2018-05-28 05:27:19,-777786.87,7.07805156707764e-08
"8602",2018-05-28 05:39:07,15361.68,15361.6800000708
"8603",2018-05-28 06:17:42,33170.08,48531.7600000708
"8604",2018-05-28 06:17:42,12821.52,61353.2800000708
"8605",2018-05-28 06:17:42,-15361.68,45991.6000000708
"8606",2018-05-28 06:24:23,115610.55,161602.150000071
"8607",2018-05-28 06:24:23,-45991.6,115610.550000071
"8608",2018-05-28 07:51:36,-115610.55,7.0765963755548e-08
"8609",2018-05-28 08:49:08,852600.73,852600.730000071
"8610",2018-05-28 09:01:00,-852600.73,7.07805156707764e-08
"8611",2018-05-28 09:56:06,599990.79,599990.790000071
"8612",2018-05-28 09:56:06,599990.78,1199981.57000007
"8613",2018-05-28 09:56:06,569346.82,1769328.39000007
"8614",2018-05-28 09:56:06,599990.8,2369319.19000007
"8615",2018-05-28 09:56:06,599990.81,2969310.00000007
"8616",2018-05-28 09:56:06,599990.77,3569300.77000007
"8617",2018-05-28 10:09:37,-3569300.77,7.12461769580841e-08
"8618",2018-05-29 05:58:03,1724757.14,1724757.14000007
"8619",2018-05-29 06:04:32,-1724757.14,7.12461769580841e-08
"8620",2018-05-29 20:46:14,77329.43,77329.4300000712
"8621",2018-05-29 21:10:00,-77329.43,7.12461769580841e-08
"8622",2018-05-31 12:33:15,599991.5,599991.500000071
"8623",2018-05-31 12:33:15,599991.51,1199983.01000007
"8624",2018-05-31 12:33:15,499070.52,1699053.53000007
"8625",2018-05-31 12:41:25,-1699053.53,7.12461769580841e-08
"8626",2018-06-02 17:28:28,599992.65,599992.650000071
"8627",2018-06-02 17:36:29,-599992.65,7.12461769580841e-08
"8628",2018-06-02 17:36:29,599992.66,599992.660000071
"8629",2018-06-02 17:36:29,599992.67,1199985.33000007
"8630",2018-06-02 17:36:29,497350.68,1697336.01000007
"8631",2018-06-02 17:39:58,-1697336.01,7.12461769580841e-08
"8632",2018-06-04 17:16:25,1999993.06,1999993.06000007
"8633",2018-06-04 17:16:25,203407.07,2203400.13000007
"8634",2018-06-04 17:29:10,-2203400.13,7.12461769580841e-08
"8635",2018-06-10 08:48:07,412707.32,412707.320000071
"8636",2018-06-10 09:15:38,-412707.32,7.12461769580841e-08
"21229",2018-06-10 18:45:57,555559.19,555559.190000071
"21230",2018-06-10 18:52:44,-555559.19,7.12461769580841e-08
"8637",2018-06-11 07:11:50,19883.28,19883.2800000712
"8638",2018-06-11 07:23:36,39873.69,59756.9700000712
"8639",2018-06-11 07:23:36,-19883.28,39873.6900000712
"8640",2018-06-11 07:42:37,-39873.69,7.12461769580841e-08
"8641",2018-06-11 08:37:51,12413.06,12413.0600000712
"8642",2018-06-11 08:37:51,397031.62,409444.680000071
"8643",2018-06-11 08:50:09,-409444.68,7.12461769580841e-08
"8644",2018-06-11 09:23:44,42352.54,42352.5400000712
"8645",2018-06-11 09:29:37,-42352.54,7.12461769580841e-08
"8646",2018-06-11 12:13:31,125255.71,125255.710000071
"8647",2018-06-11 12:21:46,-125255.71,7.12461769580841e-08
"8648",2018-06-11 15:57:02,131205.22,131205.220000071
"8649",2018-06-11 16:07:40,90164.59,221369.810000071
"8650",2018-06-11 16:07:40,-131205.22,90164.5900000712
"8651",2018-06-11 16:27:56,74243.67,164408.260000071
"8652",2018-06-11 16:27:56,-90164.59,74243.6700000713
"8653",2018-06-11 16:38:51,-74243.67,7.12607288733125e-08
"8654",2018-06-11 16:57:22,74527.46,74527.4600000713
"8655",2018-06-11 17:01:55,73575,148102.460000071
"8656",2018-06-11 17:01:55,-74527.46,73575.0000000713
"8657",2018-06-11 17:11:07,-73575,7.12607288733125e-08
"8658",2018-06-11 17:11:07,599995.65,599995.650000071
"8659",2018-06-11 17:11:07,599995.66,1199991.31000007
"8660",2018-06-11 17:11:07,494498.67,1694489.98000007
"8661",2018-06-11 17:23:40,706597.44,2401087.42000007
"8662",2018-06-11 17:23:40,-1694489.98,706597.440000071
"8663",2018-06-11 17:33:27,-706597.44,7.12461769580841e-08
"21231",2018-06-11 18:17:08,777782.73,777782.730000071
"21232",2018-06-11 18:22:50,-777782.73,7.12461769580841e-08
"21233",2018-06-11 23:17:34,599995.78,599995.780000071
"21234",2018-06-11 23:17:34,489850.8,1089846.58000007
"21235",2018-06-11 23:17:34,599995.79,1689842.37000007
"21236",2018-06-11 23:24:16,-1689842.37,7.12461769580841e-08
"8664",2018-06-11 23:43:32,409054.03,409054.030000071
"8665",2018-06-12 00:11:41,-409054.03,7.12461769580841e-08
"8666",2018-06-12 00:15:40,273007,273007.000000071
"21237",2018-06-12 00:15:40,1046170.81,1319177.81000007
"8667",2018-06-12 00:25:32,-273007,1046170.81000007
"21238",2018-06-12 00:25:32,-1046170.81,7.12461769580841e-08
"8668",2018-06-12 05:51:44,657907.99,657907.990000071
"8669",2018-06-12 05:56:29,-657907.99,7.12461769580841e-08
"8670",2018-06-12 13:09:10,735574.03,735574.030000071
"8671",2018-06-12 13:21:04,-735574.03,7.12461769580841e-08
"21239",2018-06-12 17:24:10,287971.68,287971.680000071
"8672",2018-06-12 17:49:23,599996.63,887968.310000071
"8673",2018-06-12 18:10:05,-599996.63,287971.680000071
"21240",2018-06-12 18:17:26,-287971.68,7.13043846189976e-08
"21241",2018-06-12 18:44:30,519136.78,519136.780000071
"21242",2018-06-12 19:27:29,-519136.78,7.13043846189976e-08
"8674",2018-06-12 20:44:04,41844.95,41844.9500000713
"8675",2018-06-12 21:24:31,29464.76,71309.7100000713
"8676",2018-06-12 21:24:31,-41844.95,29464.7600000713
"8677",2018-06-12 21:34:46,-29464.76,7.13007466401905e-08
"8678",2018-06-12 22:04:05,599996.78,599996.780000071
"21243",2018-06-12 22:04:05,599996.8,1199993.58000007
"8679",2018-06-12 22:11:10,-599996.78,599996.800000071
"21244",2018-06-12 22:11:10,-599996.8,7.12461769580841e-08
"8680",2018-06-12 22:26:54,711940.33,711940.330000071
"8681",2018-06-12 22:26:54,55562.41,767502.740000071
"8682",2018-06-12 22:31:23,-767502.74,7.12461769580841e-08
"8683",2018-06-12 22:36:47,570601.51,570601.510000071
"21245",2018-06-12 22:36:47,69323.22,639924.730000071
"21246",2018-06-12 22:36:47,365340.42,1005265.15000007
"21247",2018-06-12 22:36:47,175823.06,1181088.21000007
"8684",2018-06-12 22:43:01,-570601.51,610486.700000071
"21248",2018-06-12 22:43:01,900146.85,1510633.55000007
"8685",2018-06-12 22:58:40,599997.53,2110631.08000007
"21249",2018-06-12 22:58:40,-1510633.55,599997.530000071
"8686",2018-06-12 23:05:48,-599997.53,7.07805156707764e-08
"21250",2018-06-13 02:10:41,425922.51,425922.510000071
"21251",2018-06-13 02:35:03,-425922.51,7.07805156707764e-08
"8687",2018-06-13 08:40:42,219960.72,219960.720000071
"8688",2018-06-13 08:43:02,-219960.72,7.07805156707764e-08
"8689",2018-06-13 09:56:08,274448.4,274448.400000071
"8690",2018-06-13 10:02:37,129777.38,404225.780000071
"21252",2018-06-13 10:02:37,225068.94,629294.720000071
"8691",2018-06-13 10:26:27,148409.57,777704.290000071
"8692",2018-06-13 10:26:27,394271.79,1171976.08000007
"8693",2018-06-13 10:26:27,-274448.4,897527.680000071
"21253",2018-06-13 10:26:27,465193.29,1362720.97000007
"8694",2018-06-13 11:04:23,135390.29,1498111.26000007
"8695",2018-06-13 11:04:23,-672458.74,825652.520000071
"21254",2018-06-13 11:04:23,-690262.23,135390.290000071
"21255",2018-06-13 11:04:23,248008.04,383398.330000071
"8696",2018-06-13 11:13:22,291967.11,675365.440000071
"8697",2018-06-13 11:13:22,-135390.29,539975.150000071
"8698",2018-06-13 11:36:36,-291967.11,248008.040000071
"21256",2018-06-13 11:36:36,-248008.04,7.08096195012331e-08
"21257",2018-06-13 11:54:59,234796.44,234796.440000071
"8699",2018-06-13 12:28:11,339488.27,574284.710000071
"8700",2018-06-13 12:32:52,-339488.27,234796.440000071
"21258",2018-06-13 12:40:08,-234796.44,7.08387233316898e-08
"21259",2018-06-13 13:29:26,360887.63,360887.630000071
"8701",2018-06-13 14:56:18,422503.66,783391.290000071
"21260",2018-06-13 14:56:18,-360887.63,422503.660000071
"21261",2018-06-13 14:56:18,189293.49,611797.150000071
"8702",2018-06-13 15:24:55,-422503.66,189293.490000071
"8703",2018-06-13 15:55:13,359350.73,548644.220000071
"21262",2018-06-13 15:55:13,-189293.49,359350.730000071
"8704",2018-06-13 16:08:18,-359350.73,7.07805156707764e-08
"21263",2018-06-13 16:08:18,198259.96,198259.960000071
"21264",2018-06-13 16:33:12,-198259.96,7.07805156707764e-08
"8705",2018-06-13 16:53:38,226038.73,226038.730000071
"21265",2018-06-13 16:53:38,80606.85,306645.580000071
"21266",2018-06-13 16:53:38,531830.23,838475.810000071
"8706",2018-06-13 17:13:20,-226038.73,612437.080000071
"21267",2018-06-13 17:24:39,-612437.08,7.08969309926033e-08
"21268",2018-06-13 17:24:39,599999.46,599999.460000071
"8707",2018-06-13 17:25:26,555564.4,1155563.86000007
"8708",2018-06-13 17:30:38,-555564.4,599999.460000071
"8709",2018-06-13 17:40:53,315559.82,915559.280000071
"21269",2018-06-13 17:40:53,-599999.46,315559.820000071
"8710",2018-06-13 17:46:23,-315559.82,7.08387233316898e-08
"8711",2018-06-13 17:47:07,599999.49,599999.490000071
"21270",2018-06-13 17:47:07,599999.5,1199998.99000007
"8712",2018-06-13 17:55:08,-599999.49,599999.500000071
"8713",2018-06-13 19:23:53,354941.06,954940.560000071
"21271",2018-06-13 19:23:53,-599999.5,354941.060000071
"8714",2018-06-13 19:55:37,-354941.06,7.08387233316898e-08
"21272",2018-06-13 21:00:52,582790.35,582790.350000071
"21273",2018-06-13 21:00:52,721670.37,1304460.72000007
"8715",2018-06-13 21:08:51,599999.59,1904460.31000007
"21274",2018-06-13 21:08:51,599999.53,2504459.84000007
"8716",2018-06-13 21:37:37,-599999.59,1904460.25000007
"21275",2018-06-13 21:41:07,-1904460.25,7.07805156707764e-08
"21276",2018-06-13 23:15:38,599999.68,599999.680000071
"21277",2018-06-13 23:36:24,-599999.68,7.07805156707764e-08
"21278",2018-06-14 02:46:56,769480.59,769480.590000071
"21279",2018-06-14 03:04:09,-769480.59,7.07805156707764e-08
"8717",2018-06-14 17:00:32,599990.05,599990.050000071
"21280",2018-06-14 17:00:32,599990.04,1199980.09000007
"8718",2018-06-14 17:04:23,-599990.05,599990.040000071
"8719",2018-06-14 17:14:20,599990.12,1199980.16000007
"21281",2018-06-14 17:14:20,-599990.04,599990.120000071
"21282",2018-06-14 17:14:20,599990.1,1199980.22000007
"8720",2018-06-14 17:19:41,-599990.12,599990.100000071
"21283",2018-06-14 17:28:38,-599990.1,7.10133463144302e-08
"21284",2018-06-14 17:28:38,599990.14,599990.140000071
"21285",2018-06-14 17:37:33,-599990.14,7.10133463144302e-08
"8721",2018-06-16 10:40:13,599990.62,599990.620000071
"8722",2018-06-16 10:59:32,-599990.62,7.10133463144302e-08
"8723",2018-06-16 16:29:49,599990.75,599990.750000071
"21286",2018-06-16 16:29:49,599990.76,1199981.51000007
"8724",2018-06-16 16:39:17,-599990.75,599990.760000071
"21287",2018-06-16 16:39:17,-599990.76,7.10133463144302e-08
"8725",2018-06-16 16:47:13,599990.81,599990.810000071
"21288",2018-06-16 16:47:13,599990.82,1199981.63000007
"8726",2018-06-16 16:52:15,-599990.81,599990.820000071
"21289",2018-06-16 16:58:08,-599990.82,7.11297616362572e-08
"8727",2018-06-17 07:55:48,599990.85,599990.850000071
"8728",2018-06-17 08:30:28,-599990.85,7.11297616362572e-08
"21290",2018-06-18 08:30:55,825781.02,825781.020000071
"21291",2018-06-18 09:03:39,-825781.02,7.11297616362572e-08
"8729",2018-06-18 16:59:11,939665.87,939665.870000071
"8730",2018-06-18 17:13:27,-939665.87,7.11297616362572e-08
"8731",2018-06-19 10:06:02,153714.27,153714.270000071
"8732",2018-06-19 10:12:17,-153714.27,7.11297616362572e-08
"8733",2018-06-19 11:43:14,599991.18,599991.180000071
"8734",2018-06-19 12:16:07,-599991.18,7.11297616362572e-08
"8735",2018-06-20 02:59:33,1034700.67,1034700.67000007
"8736",2018-06-20 03:37:38,-1034700.67,7.11297616362572e-08
"8737",2018-06-20 03:55:43,559472.9,559472.900000071
"8738",2018-06-20 03:55:43,808584.7,1368057.60000007
"8739",2018-06-20 04:19:46,599991.31,1968048.91000007
"8740",2018-06-20 04:19:46,-1368057.6,599991.310000071
"8741",2018-06-20 04:47:22,-599991.31,7.10133463144302e-08
"21292",2018-06-20 05:04:44,599991.85,599991.850000071
"21293",2018-06-20 05:08:43,-599991.85,7.10133463144302e-08
"21294",2018-06-20 10:39:25,599991.9,599991.900000071
"21295",2018-06-20 10:50:44,-599991.9,7.10133463144302e-08
"21296",2018-06-20 12:13:38,599991.88,599991.880000071
"21297",2018-06-20 12:23:19,-599991.88,7.10133463144302e-08
"8742",2018-06-21 14:15:56,3000003.38,3000003.38000007
"8743",2018-06-21 14:21:51,-3000003.38,7.07805156707764e-08
"21298",2018-06-22 09:25:13,523127.28,523127.280000071
"21299",2018-06-22 09:39:42,431093.04,954220.320000071
"21300",2018-06-22 09:39:42,-523127.28,431093.040000071
"21301",2018-06-22 09:51:09,-431093.04,7.08387233316898e-08
"21302",2018-06-22 15:29:07,393501.98,393501.980000071
"21303",2018-06-22 15:57:08,599992.37,993494.350000071
"21304",2018-06-22 16:12:06,97740.97,1091235.32000007
"21305",2018-06-22 16:12:06,-993494.35,97740.9700000709
"21306",2018-06-22 16:12:06,599992.41,697733.380000071
"21307",2018-06-22 16:29:35,599992.42,1297725.80000007
"21308",2018-06-22 16:36:01,-1297725.8,7.10133463144302e-08
"21309",2018-06-22 16:47:46,599992.44,599992.440000071
"21310",2018-06-22 17:22:36,-599992.44,7.10133463144302e-08
"21311",2018-06-22 18:11:02,599992.46,599992.460000071
"21312",2018-06-22 18:32:41,-599992.46,7.10133463144302e-08
"21313",2018-06-22 21:30:42,599992.51,599992.510000071
"21314",2018-06-22 21:45:28,-599992.51,7.10133463144302e-08
"21315",2018-06-23 01:58:01,599992.57,599992.570000071
"21316",2018-06-23 02:33:46,-599992.57,7.10133463144302e-08
"21317",2018-06-24 06:31:54,210102.43,210102.430000071
"21318",2018-06-24 06:46:37,-210102.43,7.10133463144302e-08
"21319",2018-06-24 07:48:32,694397.68,694397.680000071
"21320",2018-06-24 08:00:17,-694397.68,7.10133463144302e-08
"21321",2018-06-24 08:47:19,953901.11,953901.110000071
"21322",2018-06-24 09:12:14,-953901.11,7.10133463144302e-08
"21323",2018-06-24 09:34:59,527099.36,527099.360000071
"21324",2018-06-24 09:49:17,-527099.36,7.10133463144302e-08
"21325",2018-06-24 10:41:57,867883.48,867883.480000071
"21326",2018-06-24 11:03:20,-867883.48,7.10133463144302e-08
"8744",2018-06-24 16:54:30,599993.34,599993.340000071
"8745",2018-06-24 16:58:54,-599993.34,7.10133463144302e-08
"21327",2018-06-24 17:34:58,1072274.9,1072274.90000007
"8746",2018-06-24 17:53:10,1047071.63,2119346.53000007
"8747",2018-06-24 18:16:59,-1047071.63,1072274.90000007
"21328",2018-06-24 18:16:59,-1072274.9,7.12461769580841e-08
"8748",2018-06-26 05:42:04,944054.94,944054.940000071
"8749",2018-06-26 05:48:48,-944054.94,7.12461769580841e-08
"8750",2018-06-26 15:59:23,599994.05,599994.050000071
"21329",2018-06-26 15:59:23,599994.08,1199988.13000007
"8751",2018-06-26 16:07:27,-599994.05,599994.080000071
"21330",2018-06-26 16:07:27,-599994.08,7.11297616362572e-08
"8752",2018-06-26 16:11:08,599994.09,599994.090000071
"8753",2018-06-26 16:17:48,-599994.09,7.11297616362572e-08
"21331",2018-06-26 21:59:34,599994.11,599994.110000071
"21332",2018-06-26 22:10:44,-599994.11,7.11297616362572e-08
"8754",2018-06-27 11:11:18,599994.18,599994.180000071
"21333",2018-06-27 11:11:18,599994.17,1199988.35000007
"8755",2018-06-27 11:29:29,-599994.18,599994.170000071
"21334",2018-06-27 11:38:57,-599994.17,7.12461769580841e-08
"8756",2018-06-27 22:13:08,599994.25,599994.250000071
"8757",2018-06-27 22:20:21,-599994.25,7.12461769580841e-08
"8758",2018-06-28 12:59:02,599994.3,599994.300000071
"8759",2018-06-28 13:28:22,-599994.3,7.12461769580841e-08
"8760",2018-06-28 22:22:49,599994.34,599994.340000071
"8761",2018-06-28 22:40:09,-599994.34,7.12461769580841e-08
"8762",2018-06-29 12:09:32,599994.44,599994.440000071
"8763",2018-06-29 12:14:13,-599994.44,7.12461769580841e-08
"21335",2018-06-29 12:33:19,599994.45,599994.450000071
"21336",2018-06-29 13:27:51,599994.46,1199988.91000007
"21337",2018-06-29 13:34:54,-1199988.91,7.12461769580841e-08
"21338",2018-06-29 14:09:34,599994.47,599994.470000071
"21339",2018-06-29 14:39:26,-599994.47,7.12461769580841e-08
"21340",2018-06-29 14:39:26,599994.49,599994.490000071
"21341",2018-06-29 14:55:02,599994.5,1199988.99000007
"21342",2018-06-29 15:19:18,-1199988.99,7.12461769580841e-08
"21343",2018-06-29 15:19:18,599994.51,599994.510000071
"21344",2018-06-29 15:55:02,-599994.51,7.12461769580841e-08
"21345",2018-06-29 21:21:44,599994.53,599994.530000071
"21346",2018-06-29 21:49:50,-599994.53,7.12461769580841e-08
"21347",2018-06-30 00:42:33,1559773.05,1559773.05000007
"21348",2018-06-30 01:08:23,-1559773.05,7.12461769580841e-08
"8764",2018-06-30 02:02:29,1545235.71,1545235.71000007
"8765",2018-06-30 02:11:09,-1545235.71,7.12461769580841e-08
"8766",2018-06-30 18:52:10,1620803.47,1620803.47000007
"8767",2018-06-30 18:55:06,-1620803.47,7.12461769580841e-08
"8768",2018-07-01 21:53:52,555559.81,555559.810000071
"8769",2018-07-01 21:53:52,588892.83,1144452.64000007
"8770",2018-07-01 21:53:52,577781.82,1722234.46000007
"8771",2018-07-01 21:59:18,-1722234.46,7.12461769580841e-08
"8772",2018-07-02 14:47:29,1581115.73,1581115.73000007
"8773",2018-07-02 15:25:07,-1581115.73,7.12461769580841e-08
"8774",2018-07-02 17:16:50,7e+05,700000.000000071
"8775",2018-07-02 17:27:30,-7e+05,7.12461769580841e-08
"8776",2018-07-03 01:04:43,1108025.22,1108025.22000007
"8777",2018-07-03 01:09:02,-1108025.22,7.12461769580841e-08
"8778",2018-07-03 13:57:40,7e+05,700000.000000071
"8779",2018-07-03 14:13:45,-7e+05,7.12461769580841e-08
"8780",2018-07-03 22:36:33,599995.22,599995.220000071
"8781",2018-07-03 22:42:04,-599995.22,7.12461769580841e-08
"8782",2018-07-04 01:14:56,599995.25,599995.250000071
"8783",2018-07-04 01:26:22,-599995.25,7.12461769580841e-08
"8784",2018-07-04 05:00:12,628525.17,628525.170000071
"8785",2018-07-04 05:34:32,-628525.17,7.12461769580841e-08
"8786",2018-07-04 08:29:08,599995.27,599995.270000071
"8787",2018-07-04 08:51:01,-599995.27,7.12461769580841e-08
"21349",2018-07-05 18:32:32,599995.56,599995.560000071
"21350",2018-07-05 19:29:02,-599995.56,7.12461769580841e-08
"21351",2018-07-06 01:44:24,599995.64,599995.640000071
"21352",2018-07-06 02:45:42,-599995.64,7.12461769580841e-08
"21353",2018-07-06 08:26:30,617760.77,617760.770000071
"21354",2018-07-06 08:43:17,-617760.77,7.12461769580841e-08
"21355",2018-07-06 12:16:42,811202.41,811202.410000071
"21356",2018-07-06 13:42:55,-811202.41,7.12461769580841e-08
"8788",2018-07-08 16:34:32,735671.24,735671.240000071
"8789",2018-07-08 16:42:33,-735671.24,7.12461769580841e-08
"8790",2018-07-10 08:39:30,336369.61,336369.610000071
"8791",2018-07-10 08:44:48,-336369.61,7.12461769580841e-08
"21357",2018-07-10 10:33:22,581695.82,581695.820000071
"21358",2018-07-10 11:58:57,-581695.82,7.12461769580841e-08
"21359",2018-07-12 06:46:18,428372.37,428372.370000071
"21360",2018-07-12 07:19:10,438131.44,866503.810000071
"21361",2018-07-12 07:33:04,248827.26,1115331.07000007
"21362",2018-07-12 07:33:04,599996.64,1715327.71000007
"21363",2018-07-12 07:48:02,-1715327.71,7.12461769580841e-08
"21364",2018-07-12 08:07:15,568983.59,568983.590000071
"21365",2018-07-12 08:22:46,-568983.59,7.12461769580841e-08
"21366",2018-07-12 08:22:46,599996.67,599996.670000071
"21367",2018-07-12 08:40:32,404019.49,1004016.16000007
"21368",2018-07-12 08:40:32,465561.04,1469577.20000007
"21369",2018-07-12 08:49:32,-1469577.2,7.12461769580841e-08
"21370",2018-07-12 09:03:58,456244.97,456244.970000071
"8792",2018-07-12 10:04:27,7e+05,1156244.97000007
"8793",2018-07-12 10:30:44,-7e+05,456244.970000071
"21371",2018-07-12 11:39:18,-456244.97,7.12461769580841e-08
"21372",2018-07-12 20:47:17,682182.55,682182.550000071
"21373",2018-07-12 20:56:08,-682182.55,7.12461769580841e-08
"21374",2018-07-13 00:25:34,1204444.3,1204444.30000007
"21375",2018-07-13 00:44:12,-1204444.3,7.12461769580841e-08
"8794",2018-07-13 04:23:08,599996.84,599996.840000071
"8795",2018-07-13 04:52:28,-599996.84,7.12461769580841e-08
"8796",2018-07-13 19:52:04,599996.88,599996.880000071
"8797",2018-07-13 19:58:04,-599996.88,7.12461769580841e-08
"8798",2018-07-13 20:02:58,147372,147372.000000071
"8799",2018-07-13 20:10:03,-147372,7.12461769580841e-08
"8800",2018-07-13 20:20:13,599996.91,599996.910000071
"8801",2018-07-13 20:53:42,-599996.91,7.12461769580841e-08
"21376",2018-07-14 19:02:21,612382.32,612382.320000071
"21377",2018-07-14 19:12:58,-612382.32,7.12461769580841e-08
"21378",2018-07-15 10:33:45,599997.09,599997.090000071
"21379",2018-07-15 11:00:29,-599997.09,7.12461769580841e-08
"8802",2018-07-15 11:52:34,599997.13,599997.130000071
"8803",2018-07-15 12:01:12,-599997.13,7.12461769580841e-08
"8804",2018-07-15 12:14:34,599997.14,599997.140000071
"8805",2018-07-15 12:31:06,-599997.14,7.12461769580841e-08
"21380",2018-07-15 17:16:09,599997.22,599997.220000071
"21381",2018-07-16 10:20:17,599997.29,1199994.51000007
"21382",2018-07-16 11:38:10,599997.32,1799991.83000007
"8806",2018-07-16 16:13:44,1049756.12,2849747.95000007
"8807",2018-07-16 16:21:44,-1049756.12,1799991.83000007
"21383",2018-07-16 17:45:59,930042.62,2730034.45000007
"8808",2018-07-16 23:01:48,774936.26,3504970.71000007
"8809",2018-07-16 23:10:26,-774936.26,2730034.45000007
"21384",2018-07-17 18:19:20,760269,3490303.45000007
"8810",2018-07-17 18:37:48,589833.15,4080136.60000007
"8811",2018-07-17 18:43:42,99171.35,4179307.95000007
"8812",2018-07-17 18:43:42,-589833.15,3589474.80000007
"8813",2018-07-17 18:47:41,424204.72,4013679.52000007
"8814",2018-07-17 18:55:12,674441.58,4688121.10000007
"8815",2018-07-17 18:55:12,449931.38,5138052.48000007
"8816",2018-07-17 18:55:12,-99171.35,5038881.13000007
"8817",2018-07-17 19:31:41,174944.94,5213826.07000007
"8818",2018-07-17 19:31:41,-1548577.68,3665248.39000007
"8819",2018-07-17 19:41:29,-174944.94,3490303.45000007
"8820",2018-07-17 20:20:49,413624.14,3903927.59000007
"8821",2018-07-17 20:25:58,-413624.14,3490303.45000007
"8822",2018-07-17 20:27:52,521935.37,4012238.82000007
"8823",2018-07-17 20:52:33,-521935.37,3490303.45000007
"8824",2018-07-17 21:05:14,592884.27,4083187.72000007
"8825",2018-07-17 21:42:30,-592884.27,3490303.45000007
"8826",2018-07-17 21:51:58,581146.18,4071449.63000007
"8827",2018-07-17 21:58:22,-581146.18,3490303.45000007
"8828",2018-07-17 23:30:08,599997.73,4090301.18000007
"8829",2018-07-17 23:49:36,-599997.73,3490303.45000007
"8830",2018-07-18 00:47:30,448851.55,3939155.00000007
"8831",2018-07-18 01:39:53,661154.93,4600309.93000007
"8832",2018-07-18 01:50:12,-448851.55,4151458.38000007
"8833",2018-07-18 01:56:10,-661154.93,3490303.45000007
"21385",2018-07-18 03:17:14,521203.6,4011507.05000007
"8834",2018-07-18 09:37:38,324359.96,4335867.01000007
"8835",2018-07-18 09:48:14,-324359.96,4011507.05000007
"21386",2018-07-18 16:39:44,599998.46,4611505.51000007
"8836",2018-07-18 16:56:43,599998.49,5211504.00000007
"8837",2018-07-18 17:13:06,-599998.49,4611505.51000007
"8838",2018-07-18 20:53:03,599998.57,5211504.08000007
"8839",2018-07-18 21:02:09,-599998.57,4611505.51000007
"21387",2018-07-18 21:23:31,599998.62,5211504.13000007
"21388",2018-07-19 16:15:26,-5211504.13,7.35744833946228e-08
"21389",2018-07-19 23:13:07,600390.75,600390.750000074
"21390",2018-07-20 00:10:26,-600390.75,7.35744833946228e-08
"21391",2018-07-20 08:21:50,599998.86,599998.860000074
"21392",2018-07-20 08:35:06,-599998.86,7.35744833946228e-08
"8840",2018-07-23 16:50:01,657186.88,657186.880000074
"8841",2018-07-23 17:14:47,-657186.88,7.35744833946228e-08
"8842",2018-07-24 03:52:18,377777.01,377777.010000074
"8843",2018-07-24 04:06:07,-377777.01,7.35744833946228e-08
"8844",2018-07-24 08:52:35,377777,377777.000000074
"8845",2018-07-24 09:00:23,-377777,7.35744833946228e-08
"8846",2018-07-24 09:40:55,122000,122000.000000074
"8847",2018-07-24 10:05:36,-122000,7.35744833946228e-08
"8848",2018-07-24 14:19:33,599990.4,599990.400000074
"8849",2018-07-24 14:34:26,-599990.4,7.35744833946228e-08
"8850",2018-07-24 15:04:18,846277.21,846277.210000074
"8851",2018-07-24 15:06:46,-846277.21,7.35744833946228e-08
"8852",2018-07-24 18:09:09,833585.79,833585.790000074
"21393",2018-07-24 18:09:09,754238.52,1587824.31000007
"8853",2018-07-24 18:20:50,-833585.79,754238.520000074
"21394",2018-07-24 19:34:19,416864.14,1171102.66000007
"21395",2018-07-24 21:23:04,-1171102.66,7.38073140382767e-08
"21396",2018-07-24 21:23:04,543391.96,543391.960000074
"21397",2018-07-24 21:50:40,-543391.96,7.38073140382767e-08
"8854",2018-07-25 11:37:11,5e+05,500000.000000074
"8855",2018-07-25 11:51:09,-5e+05,7.38073140382767e-08
"21398",2018-07-25 16:04:28,735160.7,735160.700000074
"21399",2018-07-25 16:17:58,-735160.7,7.38073140382767e-08
"8856",2018-07-26 22:05:33,599991.04,599991.040000074
"8857",2018-07-26 22:11:05,-599991.04,7.38073140382767e-08
"21400",2018-07-26 23:28:26,923849.02,923849.020000074
"21401",2018-07-26 23:32:42,-923849.02,7.38073140382767e-08
"8858",2018-07-27 04:01:29,830959.99,830959.990000074
"8859",2018-07-27 04:38:55,-830959.99,7.38073140382767e-08
"8860",2018-07-27 10:44:05,5e+05,500000.000000074
"8861",2018-07-27 10:51:57,-5e+05,7.38073140382767e-08
"21402",2018-07-27 15:24:21,848124.24,848124.240000074
"21403",2018-07-27 15:38:48,-848124.24,7.38073140382767e-08
"21404",2018-07-28 08:49:03,589664.18,589664.180000074
"21405",2018-07-28 09:35:41,-589664.18,7.38073140382767e-08
"21406",2018-07-28 16:38:21,901042.18,901042.180000074
"21407",2018-07-28 17:03:47,-901042.18,7.38073140382767e-08
"8862",2018-07-28 20:30:17,5e+05,500000.000000074
"8863",2018-07-28 20:39:38,-5e+05,7.38073140382767e-08
"21408",2018-07-30 06:47:30,883904.36,883904.360000074
"21409",2018-07-30 08:02:11,-883904.36,7.38073140382767e-08
"8864",2018-07-30 18:09:51,599993.3,599993.300000074
"21410",2018-07-30 18:09:51,599993.31,1199986.61000007
"8865",2018-07-30 18:44:30,-599993.3,599993.310000074
"21411",2018-07-30 19:02:04,-599993.31,7.38073140382767e-08
"21412",2018-07-30 20:38:08,658240.12,658240.120000074
"21413",2018-07-30 20:52:40,-658240.12,7.38073140382767e-08
"8866",2018-08-01 03:13:39,213907.85,213907.850000074
"8867",2018-08-01 03:19:27,-213907.85,7.38073140382767e-08
"8868",2018-08-02 01:24:52,599993.93,599993.930000074
"8869",2018-08-02 01:51:32,-599993.93,7.38073140382767e-08
"8870",2018-08-02 13:16:26,680742.44,680742.440000074
"8871",2018-08-02 13:43:37,-680742.44,7.38073140382767e-08
"8872",2018-08-03 08:41:50,599995.06,599995.060000074
"8873",2018-08-03 08:59:08,-599995.06,7.38073140382767e-08
"21414",2018-08-03 14:08:36,693215.61,693215.610000074
"21415",2018-08-03 14:36:34,-693215.61,7.38073140382767e-08
"21416",2018-08-04 00:28:36,411904.32,411904.320000074
"21417",2018-08-04 00:59:30,-411904.32,7.38073140382767e-08
"21418",2018-08-04 08:28:48,599995.21,599995.210000074
"21419",2018-08-04 08:50:41,-599995.21,7.38073140382767e-08
"8874",2018-08-04 14:58:13,599995.32,599995.320000074
"8875",2018-08-04 15:02:11,-599995.32,7.38073140382767e-08
"8876",2018-08-05 02:30:19,5e+05,500000.000000074
"8877",2018-08-05 02:38:54,-5e+05,7.38073140382767e-08
"21420",2018-08-07 02:01:05,599995.59,599995.590000074
"21421",2018-08-07 02:10:21,-599995.59,7.38073140382767e-08
"8878",2018-08-07 02:53:32,599995.61,599995.610000074
"8879",2018-08-07 03:04:40,-599995.61,7.38073140382767e-08
"21422",2018-08-07 03:28:11,599995.62,599995.620000074
"21423",2018-08-07 03:47:03,-599995.62,7.38073140382767e-08
"8880",2018-08-07 21:59:09,599995.83,599995.830000074
"8881",2018-08-07 22:02:25,-599995.83,7.38073140382767e-08
"8882",2018-08-08 04:44:05,359132.25,359132.250000074
"8883",2018-08-08 04:46:59,-359132.25,7.38073140382767e-08
"8884",2018-08-08 06:30:57,7e+05,700000.000000074
"8885",2018-08-08 06:54:09,5e+05,1200000.00000007
"8886",2018-08-08 06:54:09,-7e+05,500000.000000074
"8887",2018-08-08 07:24:20,-5e+05,7.38073140382767e-08
"21424",2018-08-08 14:47:38,237047.86,237047.860000074
"21425",2018-08-08 14:59:14,-237047.86,7.38073140382767e-08
"21426",2018-08-08 15:06:03,204327.99,204327.990000074
"21427",2018-08-08 15:08:51,228424.35,432752.340000074
"21428",2018-08-08 15:18:18,-432752.34,7.37491063773632e-08
"8888",2018-08-08 15:35:08,225230.66,225230.660000074
"21429",2018-08-08 15:35:08,214666.69,439897.350000074
"8889",2018-08-08 15:48:33,-225230.66,214666.690000074
"21430",2018-08-08 16:27:19,-214666.69,7.37782102078199e-08
"8890",2018-08-08 16:30:01,599996.76,599996.760000074
"21431",2018-08-08 16:30:01,599996.75,1199993.51000007
"8891",2018-08-08 16:32:47,-599996.76,599996.750000074
"21432",2018-08-08 17:21:43,-599996.75,7.38073140382767e-08
"8892",2018-08-08 17:47:51,599996.86,599996.860000074
"21433",2018-08-08 17:47:51,599996.85,1199993.71000007
"8893",2018-08-08 17:57:51,-599996.86,599996.850000074
"21434",2018-08-08 17:57:51,599996.88,1199993.73000007
"21435",2018-08-08 18:04:03,-1199993.73,7.38073140382767e-08
"8894",2018-08-08 18:11:31,599996.9,599996.900000074
"8895",2018-08-08 18:30:54,-599996.9,7.38073140382767e-08
"8896",2018-08-09 15:02:23,1217041.68,1217041.68000007
"8897",2018-08-09 15:21:28,-1217041.68,7.38073140382767e-08
"8898",2018-08-10 05:09:15,495228.84,495228.840000074
"8899",2018-08-10 05:28:21,-495228.84,7.38073140382767e-08
"8900",2018-08-10 12:18:24,497619.58,497619.580000074
"8901",2018-08-10 12:21:36,-497619.58,7.38073140382767e-08
"8902",2018-08-10 21:19:12,599997.49,599997.490000074
"21436",2018-08-10 21:19:12,599997.48,1199994.97000007
"8903",2018-08-10 21:31:35,-599997.49,599997.480000074
"21437",2018-08-10 21:31:35,-599997.48,7.38073140382767e-08
"21438",2018-08-10 21:41:18,642762.47,642762.470000074
"21439",2018-08-10 21:49:26,-642762.47,7.38073140382767e-08
"21440",2018-08-11 18:14:00,495169.58,495169.580000074
"21441",2018-08-11 18:44:22,-495169.58,7.38073140382767e-08
"8904",2018-08-12 16:04:21,340822.46,340822.460000074
"8905",2018-08-12 16:32:34,-340822.46,7.38073140382767e-08
"8906",2018-08-12 23:44:38,444508.38,444508.380000074
"8907",2018-08-13 00:14:44,-444508.38,7.38073140382767e-08
"8908",2018-08-13 16:33:15,347543.86,347543.860000074
"21442",2018-08-13 16:33:15,301329.13,648872.990000074
"8909",2018-08-13 16:44:58,-347543.86,301329.130000074
"21443",2018-08-13 16:44:58,-301329.13,7.38073140382767e-08
"8910",2018-08-13 18:42:13,599998.44,599998.440000074
"21444",2018-08-13 18:42:13,599998.45,1199996.89000007
"8911",2018-08-13 19:10:18,-599998.44,599998.450000074
"21445",2018-08-13 19:55:46,-599998.45,7.38073140382767e-08
"8912",2018-08-14 02:01:11,515168.74,515168.740000074
"8913",2018-08-14 02:14:09,-515168.74,7.38073140382767e-08
"8914",2018-08-14 02:55:23,618619.97,618619.970000074
"8915",2018-08-14 03:10:59,-618619.97,7.38073140382767e-08
"21446",2018-08-14 06:33:17,528251.21,528251.210000074
"21447",2018-08-14 07:24:39,-528251.21,7.38073140382767e-08
"8916",2018-08-14 08:29:39,537007.61,537007.610000074
"8917",2018-08-14 08:39:51,-537007.61,7.38073140382767e-08
"21448",2018-08-14 11:17:29,573204.38,573204.380000074
"21449",2018-08-14 12:16:53,-573204.38,7.38073140382767e-08
"8918",2018-08-14 13:18:01,691883.13,691883.130000074
"21450",2018-08-14 13:18:01,721157.54,1413040.67000007
"8919",2018-08-14 13:44:29,-691883.13,721157.540000074
"21451",2018-08-14 14:01:19,-721157.54,7.39237293601036e-08
"8920",2018-08-14 15:20:12,319420.58,319420.580000074
"8921",2018-08-14 15:30:16,-319420.58,7.39237293601036e-08
"8922",2018-08-14 16:36:47,602054.04,602054.040000074
"8923",2018-08-14 16:52:31,-602054.04,7.39237293601036e-08
"21452",2018-08-14 18:18:13,304171.57,304171.570000074
"21453",2018-08-14 18:30:52,-304171.57,7.39237293601036e-08
"21454",2018-08-14 19:25:02,612995.6,612995.600000074
"21455",2018-08-14 19:34:56,-612995.6,7.39237293601036e-08
"21456",2018-08-14 21:35:00,566295.98,566295.980000074
"21457",2018-08-14 22:24:02,-566295.98,7.39237293601036e-08
"8924",2018-08-14 23:13:54,550867.97,550867.970000074
"8925",2018-08-14 23:24:39,-550867.97,7.39237293601036e-08
"21458",2018-08-14 23:36:27,837913.31,837913.310000074
"8926",2018-08-14 23:52:16,581066.2,1418979.51000007
"8927",2018-08-15 00:15:41,-581066.2,837913.310000074
"21459",2018-08-15 00:22:09,-837913.31,7.38073140382767e-08
"21460",2018-08-15 07:49:10,551473.41,551473.410000074
"8928",2018-08-15 08:04:13,102243.72,653717.130000074
"21461",2018-08-15 08:04:13,-551473.41,102243.720000074
"8929",2018-08-15 08:10:08,312836.19,415079.910000074
"8930",2018-08-15 08:10:08,-102243.72,312836.190000074
"8931",2018-08-15 08:40:19,-312836.19,7.37491063773632e-08
"21462",2018-08-15 12:12:42,616844.1,616844.100000074
"21463",2018-08-15 12:12:42,250,617094.100000074
"21464",2018-08-15 12:34:54,-616844.1,250.000000073691
"8932",2018-08-15 17:47:21,1228588.35,1228838.35000007
"21465",2018-08-15 17:47:21,1436164.63,2665002.98000007
"8933",2018-08-15 18:16:05,-1228588.35,1436414.63000007
"21466",2018-08-15 18:16:05,-1436164.63,250.000000073574
"8934",2018-08-15 19:44:50,558923.82,559173.820000074
"8935",2018-08-15 19:57:19,-558923.82,250.000000073574
"8936",2018-08-16 00:04:27,539443.07,539693.070000074
"8937",2018-08-16 00:08:16,-539443.07,250.000000073574
"21467",2018-08-16 01:09:35,518246.52,518496.520000074
"21468",2018-08-16 01:21:07,-518246.52,250.000000073574
"8938",2018-08-16 04:43:56,256888.75,257138.750000074
"8939",2018-08-16 04:57:49,-256888.75,250.000000073574
"21469",2018-08-16 14:51:40,489824.73,490074.730000074
"21470",2018-08-16 15:10:40,-489824.73,250.000000073574
"8940",2018-08-16 18:02:46,571330.34,571580.340000074
"8941",2018-08-16 18:05:48,-571330.34,250.000000073574
"21471",2018-08-16 18:31:53,401962.47,402212.470000074
"21472",2018-08-16 18:55:22,-401962.47,250.000000073574
"21473",2018-08-17 01:41:22,550739.83,550989.830000074
"21474",2018-08-17 02:14:53,-550739.83,250.000000073574
"8942",2018-08-17 02:59:26,446180.25,446430.250000074
"8943",2018-08-17 03:01:31,-446180.25,250.000000073574
"8944",2018-08-17 07:47:51,627559.19,627809.190000074
"8945",2018-08-17 07:51:58,-627559.19,250.000000073574
"21475",2018-08-17 17:37:24,546973.36,547223.360000074
"21476",2018-08-17 18:20:41,-546973.36,250.000000073574
"21477",2018-08-17 20:19:18,557856.82,558106.820000074
"21478",2018-08-17 20:59:26,-557856.82,250.000000073574
"8946",2018-08-17 23:15:41,653559.2,653809.200000074
"8947",2018-08-17 23:27:09,-653559.2,250.000000073574
"8948",2018-08-19 00:23:52,3e+05,300250.000000074
"8949",2018-08-19 00:42:30,-3e+05,250.000000073574
"8950",2018-08-19 00:42:30,456996.87,457246.870000074
"8951",2018-08-19 01:01:10,-456996.87,250.000000073574
"21479",2018-08-20 22:32:11,599995.37,600245.370000074
"21480",2018-08-20 22:41:25,-599995.37,250.000000073574
"8952",2018-08-20 22:46:15,674366.38,674616.380000074
"8953",2018-08-20 23:09:24,-674366.38,250.000000073574
"21481",2018-08-21 08:17:12,730633.41,730883.410000074
"21482",2018-08-21 08:36:00,-730633.41,250.000000073574
"8954",2018-08-22 01:14:45,647745.77,647995.770000074
"8955",2018-08-22 01:17:57,734892.9,1382888.67000007
"8956",2018-08-22 01:25:45,-647745.77,735142.900000073
"8957",2018-08-22 01:50:47,1000866.93,1736009.83000007
"8958",2018-08-22 01:50:47,-734892.9,1001116.93000007
"21483",2018-08-22 01:50:47,699281.82,1700398.75000007
"8959",2018-08-22 01:57:46,418908.24,2119306.99000007
"8960",2018-08-22 01:57:46,-1000866.93,1118440.06000007
"8961",2018-08-22 02:16:36,299583.51,1418023.57000007
"8962",2018-08-22 02:16:36,337811.03,1755834.60000007
"8963",2018-08-22 02:16:36,-418908.24,1336926.36000007
"8964",2018-08-22 02:28:33,35201.09,1372127.45000007
"8965",2018-08-22 02:28:33,-637394.54,734732.910000074
"21484",2018-08-22 02:28:33,-699281.82,35451.0900000738
"8966",2018-08-22 02:59:14,336459.52,371910.610000074
"8967",2018-08-22 02:59:14,-35201.09,336709.520000074
"8968",2018-08-22 03:18:31,-336459.52,250.000000073807
"8969",2018-08-22 20:31:04,599996.19,600246.190000074
"21485",2018-08-22 20:31:04,599996.18,1200242.37000007
"8970",2018-08-22 20:39:55,-599996.19,600246.180000074
"21486",2018-08-22 21:22:03,-599996.18,250.000000073691
"21487",2018-08-22 22:59:03,599996.3,600246.300000074
"21488",2018-08-22 23:30:21,-599996.3,250.000000073691
"8971",2018-08-23 22:42:54,220511.64,220761.640000074
"8972",2018-08-23 23:02:30,-220511.64,250.000000073691
"21489",2018-08-24 17:07:41,599996.52,600246.520000074
"21490",2018-08-24 17:49:26,-599996.52,250.000000073691
"8973",2018-08-25 03:14:31,480484.82,480734.820000074
"8974",2018-08-25 03:23:08,-480484.82,250.000000073691
"8975",2018-08-25 06:41:52,775077.2,775327.200000074
"8976",2018-08-25 07:04:25,-775077.2,250.000000073691
"8977",2018-08-26 00:34:13,756979.3,757229.300000074
"8978",2018-08-26 00:37:58,-756979.3,250.000000073691
"21491",2018-08-26 11:25:54,728031.27,728281.270000074
"21492",2018-08-26 11:40:32,-728031.27,250.000000073691
"8979",2018-08-27 08:07:15,798649.39,798899.390000074
"8980",2018-08-27 08:34:18,-798649.39,250.000000073691
"21493",2018-08-27 16:46:57,811471.22,811721.220000074
"21494",2018-08-27 17:23:16,-811471.22,250.000000073691
"8981",2018-08-28 01:52:00,805764.35,806014.350000074
"8982",2018-08-28 02:04:07,-805764.35,250.000000073691
"8983",2018-08-28 15:25:49,448934.37,449184.370000074
"8984",2018-08-28 15:51:56,-448934.37,250.000000073691
"8985",2018-08-28 17:00:10,599996.92,600246.920000074
"8986",2018-08-28 17:03:47,-599996.92,250.000000073691
"8987",2018-08-28 19:36:41,599996.97,600246.970000074
"8988",2018-08-28 19:52:59,-599996.97,250.000000073691
"8989",2018-08-29 00:25:30,351360.48,351610.480000074
"8990",2018-08-29 01:00:53,-351360.48,250.000000073691
"8991",2018-08-29 05:50:09,783903.21,784153.210000074
"8992",2018-08-29 06:02:23,-783903.21,250.000000073691
"8993",2018-08-29 14:13:28,599997.11,600247.110000074
"8994",2018-08-29 14:29:44,-599997.11,250.000000073691
"8995",2018-08-29 16:32:45,599997.19,600247.190000074
"8996",2018-08-29 16:43:41,-599997.19,250.000000073691
"8997",2018-08-29 23:10:46,599997.25,600247.250000074
"8998",2018-08-29 23:14:30,-599997.25,250.000000073691
"8999",2018-08-30 03:30:02,599997.27,600247.270000074
"9000",2018-08-30 03:45:44,-599997.27,250.000000073691
"21495",2018-08-31 17:32:20,599997.44,600247.440000074
"21496",2018-08-31 19:03:11,-599997.44,250.000000073691
"9001",2018-09-02 00:14:19,347783.81,348033.810000074
"9002",2018-09-02 00:30:32,-347783.81,250.000000073691
"9003",2018-09-02 01:29:58,839009.57,839259.570000074
"9004",2018-09-02 01:56:48,-839009.57,250.000000073691
"21497",2018-09-02 09:02:46,848736.88,848986.880000074
"21498",2018-09-02 09:29:08,-848736.88,250.000000073691
"9005",2018-09-02 16:26:43,839683.86,839933.860000074
"9006",2018-09-02 16:38:43,-839683.86,250.000000073691
"9007",2018-09-03 04:41:27,599997.71,600247.710000074
"9008",2018-09-03 04:47:41,-599997.71,250.000000073691
"21499",2018-09-03 07:05:29,485574.92,485824.920000074
"21500",2018-09-03 07:59:40,-485574.92,250.000000073691
"9009",2018-09-05 16:48:24,63353.77,63603.7700000737
"9010",2018-09-05 16:48:24,599999.99,663603.760000074
"9011",2018-09-05 16:55:29,-663353.76,250.000000073691
"9012",2018-09-07 00:09:50,830963.4,831213.400000074
"9013",2018-09-07 00:28:56,-830963.4,250.000000073691
"21501",2018-09-07 17:36:28,599992.17,600242.170000074
"21502",2018-09-07 18:01:31,-599992.17,250.000000073691
"21503",2018-09-09 09:53:09,571990.72,572240.720000074
"21504",2018-09-09 10:59:32,-571990.72,250.000000073691
"9014",2018-09-09 18:08:54,569008.43,569258.430000074
"9015",2018-09-09 18:14:14,-569008.43,250.000000073691
"21505",2018-09-10 01:59:50,599992.56,600242.560000074
"21506",2018-09-10 02:52:17,-599992.56,250.000000073691
"9016",2018-09-10 11:54:33,599992.66,600242.660000074
"9017",2018-09-10 12:26:16,-599992.66,250.000000073691
"21507",2018-09-10 16:46:00,599992.74,600242.740000074
"21508",2018-09-10 16:54:26,-599992.74,250.000000073691
"9018",2018-09-11 15:13:44,529231.51,529481.510000074
"9019",2018-09-11 15:24:03,-529231.51,250.000000073691
"9020",2018-09-11 16:14:56,768524.44,768774.440000074
"9021",2018-09-11 16:36:32,-768524.44,250.000000073691
"21509",2018-09-11 16:46:10,485664.84,485914.840000074
"21510",2018-09-11 17:27:34,-485664.84,250.000000073691
"9022",2018-09-11 23:11:36,408882.59,409132.590000074
"9023",2018-09-11 23:20:18,-408882.59,250.000000073691
"21511",2018-09-11 23:49:04,512324.92,512574.920000074
"21512",2018-09-12 00:02:37,-512324.92,250.000000073691
"9024",2018-09-12 19:48:49,647676.51,647926.510000074
"9025",2018-09-12 20:02:12,-647676.51,250.000000073691
"9026",2018-09-13 14:29:38,559811.76,560061.760000074
"9027",2018-09-13 14:39:00,-559811.76,250.000000073691
"9028",2018-09-13 18:07:30,599993.27,600243.270000074
"9029",2018-09-13 18:23:47,-599993.27,250.000000073691
"9030",2018-09-14 02:31:01,383296.39,383546.390000074
"9031",2018-09-14 02:59:17,-383296.39,250.000000073691
"9032",2018-09-14 07:10:37,160329.2,160579.200000074
"9033",2018-09-14 07:17:09,-160329.2,250.000000073691
"9034",2018-09-14 09:19:33,76232.03,76482.0300000737
"9035",2018-09-14 09:31:45,-76232.03,250.000000073691
"9036",2018-09-14 09:55:38,60066.71,60316.7100000737
"9037",2018-09-14 09:58:54,-60066.71,250.000000073691
"9038",2018-09-14 13:32:31,1340422.74,1340672.74000007
"21513",2018-09-14 13:32:31,1050099.35,2390772.09000007
"9039",2018-09-14 13:34:52,-1340422.74,1050349.35000007
"21514",2018-09-14 13:48:57,-1050099.35,250.000000073807
"21515",2018-09-14 19:08:35,448697.98,448947.980000074
"21516",2018-09-14 19:36:26,-448697.98,250.000000073807
"9040",2018-09-15 05:10:05,24691.91,24941.9100000738
"9041",2018-09-15 05:18:54,511220.12,536162.030000074
"9042",2018-09-15 05:18:54,-24691.91,511470.120000074
"9043",2018-09-15 05:36:33,-511220.12,250.000000073866
"9044",2018-09-15 13:40:51,544215.93,544465.930000074
"9045",2018-09-15 13:47:43,-544215.93,250.000000073924
"9046",2018-09-15 16:34:05,250594.16,250844.160000074
"9047",2018-09-15 16:45:03,-250594.16,250.000000073924
"9048",2018-09-15 21:03:21,96879.39,97129.3900000739
"9049",2018-09-15 21:06:39,-96879.39,250.000000073924
"9050",2018-09-15 22:20:09,447044.83,447294.830000074
"9051",2018-09-15 22:36:49,-447044.83,250.000000073924
"21517",2018-09-16 05:14:05,599993.92,600243.920000074
"21518",2018-09-16 07:39:53,-599993.92,250.000000073924
"21519",2018-09-16 19:38:34,527860.31,528110.310000074
"21520",2018-09-16 20:20:02,-527860.31,250.000000073924
"9052",2018-09-17 00:30:20,570304.5,570554.500000074
"9053",2018-09-17 00:55:33,-570304.5,250.000000073924
"21521",2018-09-17 16:13:02,599994.16,600244.160000074
"21522",2018-09-17 16:22:34,-599994.16,250.000000073924
"9054",2018-09-18 00:29:26,599994.3,600244.300000074
"9055",2018-09-18 00:36:47,-599994.3,250.000000073924
"9056",2018-09-18 06:09:55,599994.35,600244.350000074
"9057",2018-09-18 06:23:24,-599994.35,250.000000073924
"21523",2018-09-18 13:32:27,845586.58,845836.580000074
"21524",2018-09-18 13:55:32,-845586.58,250.000000073924
"9058",2018-09-18 18:06:23,495392.24,495642.240000074
"9059",2018-09-18 18:25:38,-495392.24,250.000000073924
"9060",2018-09-20 08:33:19,645391.79,645641.790000074
"9061",2018-09-20 08:40:57,-645391.79,250.000000073924
"21525",2018-09-20 23:04:48,888790.84,889040.840000074
"21526",2018-09-20 23:27:45,-888790.84,250.000000073924
"9062",2018-09-21 03:22:50,715201.64,715451.640000074
"9063",2018-09-21 03:53:13,-715201.64,250.000000073924
"21527",2018-09-21 07:39:43,743760.67,744010.670000074
"9064",2018-09-21 08:02:02,755376.98,1499387.65000007
"21528",2018-09-21 08:02:02,-743760.67,755626.980000074
"9065",2018-09-21 08:05:58,-755376.98,250.000000073924
"9066",2018-09-21 09:12:16,77443.85,77693.8500000739
"9067",2018-09-21 09:12:16,755666.04,833359.890000074
"9068",2018-09-21 09:13:25,717768.59,1551128.48000007
"9069",2018-09-21 09:32:12,-833109.89,718018.590000074
"9070",2018-09-21 09:44:23,-717768.59,250.00000007404
"9071",2018-09-21 12:57:53,699287.93,699537.930000074
"9072",2018-09-21 13:25:07,-699287.93,250.00000007404
"21529",2018-09-21 13:47:14,624087.25,624337.250000074
"21530",2018-09-21 14:06:26,-624087.25,250.00000007404
"9073",2018-09-21 16:28:47,599995.26,600245.260000074
"9074",2018-09-21 16:33:52,-599995.26,250.00000007404
"9075",2018-09-21 19:25:13,730580.73,730830.730000074
"9076",2018-09-21 19:34:15,-730580.73,250.00000007404
"21531",2018-09-21 21:06:56,178742.02,178992.020000074
"21532",2018-09-21 21:22:34,-178742.02,250.00000007404
"21533",2018-09-21 21:22:34,139761.59,140011.590000074
"9077",2018-09-21 21:44:39,764697.36,904708.950000074
"21534",2018-09-21 21:44:39,-139761.59,764947.360000074
"9078",2018-09-21 21:49:03,-764697.36,250.00000007404
"9079",2018-09-21 22:52:59,599995.45,600245.450000074
"21535",2018-09-21 22:52:59,599995.47,1200240.92000007
"9080",2018-09-21 23:25:52,-599995.45,600245.470000074
"21536",2018-09-21 23:25:52,-599995.47,250.00000007404
"9081",2018-09-22 02:21:52,128848.75,129098.750000074
"9082",2018-09-22 02:49:51,-128848.75,250.00000007404
"9083",2018-09-22 04:47:53,599995.63,600245.630000074
"21537",2018-09-22 04:47:53,599995.64,1200241.27000007
"9084",2018-09-22 04:58:15,-599995.63,600245.640000074
"21538",2018-09-22 05:28:33,-599995.64,250.00000007404
"9085",2018-09-22 07:40:25,734147.46,734397.460000074
"9086",2018-09-22 07:47:16,-734147.46,250.00000007404
"21539",2018-09-22 10:12:12,599995.73,600245.730000074
"21540",2018-09-22 10:51:18,-599995.73,250.00000007404
"9087",2018-09-22 12:47:38,277849.31,278099.310000074
"9088",2018-09-22 12:54:16,-277849.31,250.00000007404
"9089",2018-09-22 15:51:02,712859.04,713109.040000074
"9090",2018-09-22 15:55:19,-712859.04,250.00000007404
"9091",2018-09-24 09:11:58,537944.86,538194.860000074
"21541",2018-09-24 09:11:58,541308.45,1079503.31000007
"9092",2018-09-24 09:29:25,-537944.86,541558.450000074
"21542",2018-09-24 10:01:46,-541308.45,250.000000074157
"21543",2018-09-24 11:33:30,895691.95,895941.950000074
"21544",2018-09-24 11:47:07,-895691.95,250.000000074157
"21545",2018-09-24 18:21:35,231301.59,231551.590000074
"21546",2018-09-24 18:38:20,-231301.59,250.000000074157
"9093",2018-09-25 01:27:46,599996.36,600246.360000074
"9094",2018-09-25 01:35:59,-599996.36,250.000000074157
"9095",2018-09-25 20:16:06,380000,380250.000000074
"9096",2018-09-25 20:21:27,-380000,250.000000074157
"21547",2018-09-26 07:11:26,766931.86,767181.860000074
"9097",2018-09-26 16:39:15,484832.79,1252014.65000007
"9098",2018-09-26 17:33:11,-484832.79,767181.860000074
"21548",2018-09-27 00:31:21,403342.85,1170524.71000007
"21549",2018-09-27 07:04:15,709320.43,1879845.14000007
"21550",2018-09-27 20:00:50,482720.23,2362565.37000007
"9099",2018-09-27 22:40:53,374541.81,2737107.18000007
"9100",2018-09-27 22:46:33,-374541.81,2362565.37000007
"9101",2018-09-28 00:14:19,561093.58,2923658.95000007
"9102",2018-09-28 00:38:16,-561093.58,2362565.37000007
"9103",2018-09-28 03:46:10,697851.45,3060416.82000007
"9104",2018-09-28 03:53:24,-697851.45,2362565.37000007
"9105",2018-09-28 06:43:25,710686.48,3073251.85000007
"9106",2018-09-28 06:51:11,-710686.48,2362565.37000007
"9107",2018-09-28 18:08:53,495312.24,2857877.61000007
"9108",2018-09-28 18:12:17,-495312.24,2362565.37000007
"21551",2018-09-29 02:26:33,-2362315.37,250.000000073574
"9109",2018-09-29 03:03:05,67479.7,67729.7000000736
"9110",2018-09-29 03:12:29,-67479.7,250.000000073574
"21552",2018-09-29 09:17:54,347373.26,347623.260000074
"21553",2018-09-29 10:09:05,-347373.26,250.000000073574
"21554",2018-09-29 11:08:22,725278.27,725528.270000074
"21555",2018-09-29 11:18:43,-725278.27,250.000000073574
"9111",2018-09-30 05:37:51,647140.93,647390.930000074
"9112",2018-09-30 05:51:29,-647140.93,250.000000073574
"21556",2018-09-30 07:21:52,347958.87,348208.870000074
"21557",2018-09-30 07:40:42,-347958.87,250.000000073574
"9113",2018-09-30 15:45:58,166680.62,166930.620000074
"9114",2018-09-30 15:49:42,-166680.62,250.000000073574
"21558",2018-09-30 15:49:42,684718.77,684968.770000074
"21559",2018-09-30 16:40:48,-684718.77,250.000000073574
"21560",2018-10-02 21:54:54,486753.49,487003.490000074
"21561",2018-10-02 22:09:20,-486753.49,250.000000073574
"21562",2018-10-03 04:30:36,338481.33,338731.330000074
"21563",2018-10-03 04:35:58,-338481.33,250.000000073574
"21564",2018-10-04 01:56:08,468294.86,468544.860000074
"21565",2018-10-04 02:21:46,-468294.86,250.000000073574
"21566",2018-10-08 13:12:50,89724.75,89974.7500000736
"21567",2018-10-08 13:25:35,-89724.75,250.000000073574
"9115",2018-10-09 00:32:10,762208.14,762458.140000074
"9116",2018-10-09 01:00:58,-762208.14,250.000000073574
"9117",2018-10-10 15:19:13,599991.26,600241.260000074
"9118",2018-10-10 15:23:36,-599991.26,250.000000073574
"9119",2018-10-11 01:33:31,130255.96,130505.960000074
"9120",2018-10-11 01:36:27,-130255.96,250.000000073574
"21568",2018-10-11 05:11:14,599991.76,600241.760000074
"21569",2018-10-11 05:17:28,-599991.76,250.000000073574
"21570",2018-10-11 05:44:08,599991.82,600241.820000074
"21571",2018-10-11 05:55:34,-599991.82,250.000000073574
"9121",2018-10-15 05:50:48,599993.65,600243.650000074
"9122",2018-10-15 05:59:56,-599993.65,250.000000073574
"21572",2018-10-15 05:59:56,599993.63,600243.630000074
"9123",2018-10-15 06:11:04,599993.76,1200237.39000007
"21573",2018-10-15 06:11:04,599993.78,1800231.17000007
"9124",2018-10-15 06:27:55,658533.16,2458764.33000007
"9125",2018-10-15 06:27:55,732800.22,3191564.55000007
"9126",2018-10-15 06:27:55,-599993.76,2591570.79000007
"21574",2018-10-15 06:27:55,-1199987.41,1391583.38000007
"9127",2018-10-15 06:42:33,-1391333.38,250.000000073807
"9128",2018-10-15 06:47:30,411304.8,411554.800000074
"9129",2018-10-15 06:49:08,-411304.8,250.000000073807
"9130",2018-10-15 07:00:20,713038.2,713288.200000074
"21575",2018-10-15 07:00:20,135422.92,848711.120000074
"9131",2018-10-15 07:09:12,777781.15,1626492.27000007
"9132",2018-10-15 07:09:12,-713038.2,913454.070000074
"9133",2018-10-15 07:36:29,418620.22,1332074.29000007
"9134",2018-10-15 07:36:29,-777781.15,554293.140000074
"9135",2018-10-15 07:56:34,432139.97,986433.110000074
"9136",2018-10-15 07:56:34,-418620.22,567812.890000074
"9137",2018-10-15 08:08:09,-432139.97,135672.920000074
"21576",2018-10-15 08:15:35,-135422.92,250.000000073836
"9138",2018-10-15 08:34:27,1207902.14,1208152.14000007
"9139",2018-10-15 08:34:27,407004.13,1615156.27000007
"9140",2018-10-15 08:43:23,-1614906.27,250.000000073574
"21577",2018-10-15 12:09:23,609374.84,609624.840000074
"21578",2018-10-15 12:40:21,-609374.84,250.000000073574
"9141",2018-10-15 13:45:27,579439.13,579689.130000074
"21579",2018-10-15 13:45:27,307093.58,886782.710000074
"9142",2018-10-15 13:53:10,40172.38,926955.090000074
"9143",2018-10-15 13:53:10,-579439.13,347515.960000074
"21580",2018-10-15 13:53:10,-307093.58,40422.3800000735
"9144",2018-10-15 13:56:41,132329.97,172752.350000074
"9145",2018-10-15 14:07:12,-40172.38,132579.970000074
"9146",2018-10-15 14:13:49,-132329.97,250.000000073516
"9147",2018-10-15 14:35:40,372889.27,373139.270000074
"9148",2018-10-15 14:43:22,-372889.27,250.000000073516
"9149",2018-10-15 18:03:22,551547.21,551797.210000074
"9150",2018-10-15 18:14:15,-551547.21,250.000000073574
"21581",2018-10-15 20:53:30,599999.24,600249.240000074
"9151",2018-10-15 21:38:30,789411.73,1389660.97000007
"9152",2018-10-15 21:44:00,-789411.73,600249.240000074
"21582",2018-10-15 21:44:00,-599999.24,250.000000073574
"9153",2018-10-16 20:57:32,2e+05,200250.000000074
"9154",2018-10-16 21:00:25,-2e+05,250.000000073574
"9155",2018-10-29 17:33:59,2e+05,200250.000000074
"9156",2018-10-29 17:45:28,-2e+05,250.000000073574
"9157",2018-10-30 14:51:24,2e+05,200250.000000074
"9158",2018-10-30 15:10:45,-2e+05,250.000000073574
"9159",2018-10-31 09:11:33,84289.77,84539.7700000736
"9160",2018-10-31 09:30:24,-84289.77,250.000000073574
"9161",2018-10-31 13:09:34,380000,380250.000000074
"9162",2018-10-31 13:16:47,-380000,250.000000073574
"9163",2018-11-04 17:01:53,294248.33,294498.330000074
"9164",2018-11-04 17:23:22,-294248.33,250.000000073574
"21583",2018-11-05 15:26:09,364597.41,364847.410000074
"21584",2018-11-06 00:27:53,-364597.41,250.000000073574
"9165",2018-11-06 10:31:05,406839.92,407089.920000074
"9166",2018-11-06 10:38:50,-406839.92,250.000000073574
"21585",2018-11-06 11:10:44,387492.54,387742.540000074
"21586",2018-11-06 11:20:01,-387492.54,250.000000073574
"21587",2018-11-06 14:02:48,252789.79,253039.790000074
"21588",2018-11-06 14:40:25,-252789.79,250.000000073574
"21589",2018-11-06 18:33:27,386576.38,386826.380000074
"21590",2018-11-06 19:15:10,-386576.38,250.000000073574
"9167",2018-11-06 23:18:08,389288.98,389538.980000074
"9168",2018-11-06 23:31:55,-389288.98,250.000000073574
"9169",2018-11-07 00:44:27,258814.51,259064.510000074
"9170",2018-11-07 01:05:40,-258814.51,250.000000073574
"9171",2018-11-07 08:09:16,190153.43,190403.430000074
"9172",2018-11-07 08:15:10,-190153.43,250.000000073574
"9173",2018-11-07 10:13:52,431149,431399.000000074
"9174",2018-11-07 10:19:55,-431149,250.000000073574
"9175",2018-11-07 10:37:00,202251.62,202501.620000074
"9176",2018-11-07 10:47:52,-202251.62,250.000000073574
"9177",2018-11-07 17:48:52,218922.58,219172.580000074
"9178",2018-11-07 17:59:55,-218922.58,250.000000073574
"21591",2018-11-08 05:43:14,175588.97,175838.970000074
"21592",2018-11-08 05:48:10,-175588.97,250.000000073574
"21593",2018-11-08 08:46:51,167868.02,168118.020000074
"21594",2018-11-08 08:59:01,-167868.02,250.000000073574
"21595",2018-11-10 07:46:40,101646.51,101896.510000074
"21596",2018-11-10 08:40:51,376792.57,478689.080000074
"21597",2018-11-10 08:46:29,-478439.08,250.000000073574
"21598",2018-11-14 17:31:53,266997.21,267247.210000074
"21599",2018-11-14 18:30:05,-266997.21,250.000000073574
"21600",2018-11-14 19:19:13,58466.31,58716.3100000736
"21601",2018-11-14 19:19:13,25874.47,84590.7800000736
"21602",2018-11-14 19:22:05,101705.87,186296.650000074
"21603",2018-11-14 20:10:58,-186046.65,250.000000073574
"21606",2018-11-14 20:56:11,50946.05,51196.0500000736
"9179",2018-11-14 20:56:35,24536.01,75732.0600000736
"9180",2018-11-14 20:56:35,65920.71,141652.770000074
"21604",2018-11-14 20:56:35,58995.48,200648.250000074
"21605",2018-11-14 20:56:35,46130.2,246778.450000074
"21607",2018-11-14 21:11:42,-156071.73,90706.7200000736
"21608",2018-11-14 21:11:42,28302.05,119008.770000074
"21609",2018-11-14 21:25:12,31096.83,150105.600000074
"21610",2018-11-14 21:25:12,57767.73,207873.330000074
"9181",2018-11-14 21:28:49,-90456.72,117416.610000074
"21611",2018-11-14 21:28:49,28143.28,145559.890000074
"21612",2018-11-14 21:28:49,44745.14,190305.030000074
"21613",2018-11-14 21:28:49,200271.08,390576.110000074
"21614",2018-11-14 21:57:25,-117166.61,273409.500000074
"21615",2018-11-14 21:57:25,192352.6,465762.100000074
"21616",2018-11-14 22:02:17,-465512.1,250.000000073574
"21617",2018-11-14 22:02:17,109659.56,109909.560000074
"21618",2018-11-14 22:05:11,128570.1,238479.660000074
"21619",2018-11-14 22:10:33,-238229.66,250.000000073574
"21620",2018-11-14 22:58:43,61620.22,61870.2200000736
"9182",2018-11-14 23:06:33,85165.79,147036.010000074
"21621",2018-11-14 23:06:33,-61620.22,85415.7900000736
"9183",2018-11-14 23:10:17,-85165.79,250.000000073589
"9184",2018-11-14 23:27:59,212103.58,212353.580000074
"9185",2018-11-14 23:50:16,-212103.58,250.000000073604
"21622",2018-11-14 23:50:16,69125.79,69375.7900000736
"21623",2018-11-15 00:01:30,46757.52,116133.310000074
"21624",2018-11-15 00:01:30,49575.31,165708.620000074
"21625",2018-11-15 00:01:30,24636.17,190344.790000074
"21626",2018-11-15 00:16:56,-69125.79,121219.000000074
"21627",2018-11-15 00:16:56,137453.94,258672.940000074
"21628",2018-11-15 01:11:50,-258422.94,250.000000073633
"9186",2018-11-15 01:46:46,18488.87,18738.8700000736
"21629",2018-11-15 01:46:46,22066.21,40805.0800000736
"21630",2018-11-15 01:46:46,28791.21,69596.2900000736
"9187",2018-11-15 01:55:06,-18488.87,51107.4200000736
"21631",2018-11-15 01:55:06,-50857.42,250.000000073647
"9188",2018-11-15 02:02:40,56303.9,56553.9000000736
"9189",2018-11-15 02:07:12,-56303.9,250.000000073647
"21632",2018-11-15 03:02:16,38166.74,38416.7400000736
"21633",2018-11-15 03:08:16,-38166.74,250.000000073647
"21634",2018-11-15 03:08:16,393709.78,393959.780000074
"21635",2018-11-15 03:16:52,-393709.78,250.000000073633
"9190",2018-11-15 03:26:45,126050.24,126300.240000074
"9191",2018-11-15 03:26:45,242120.97,368421.210000074
"21636",2018-11-15 03:26:45,146030.03,514451.240000074
"9192",2018-11-15 03:37:07,-368171.21,146280.030000074
"21637",2018-11-15 03:37:07,238419.84,384699.870000074
"21638",2018-11-15 03:56:00,-384449.87,250.000000073691
"21639",2018-11-15 03:56:00,423861.25,424111.250000074
"9193",2018-11-15 03:56:51,292758.51,716869.760000074
"9194",2018-11-15 04:03:08,-292758.51,424111.250000074
"21640",2018-11-15 04:03:08,-423861.25,250.000000073691
"9195",2018-11-15 05:53:37,192802.69,193052.690000074
"21641",2018-11-15 05:53:37,147229.51,340282.200000074
"9196",2018-11-15 05:55:42,-192802.69,147479.510000074
"21642",2018-11-15 06:02:15,-147229.51,250.000000073691
"9197",2018-11-15 10:41:19,188255.56,188505.560000074
"9198",2018-11-15 10:59:12,-188255.56,250.000000073691
"21643",2018-11-15 12:27:18,376491.77,376741.770000074
"21644",2018-11-15 12:54:40,-376491.77,250.000000073691
"21645",2018-11-15 17:11:17,87212.35,87462.3500000737
"9199",2018-11-15 17:33:29,322163,409625.350000074
"9200",2018-11-15 17:33:29,639297.92,1048923.27000007
"9201",2018-11-15 17:33:29,345501.37,1394424.64000007
"21646",2018-11-15 17:33:29,348548.63,1742973.27000007
"9202",2018-11-15 17:56:50,-1306962.29,436010.980000074
"21647",2018-11-15 18:06:08,-435760.98,250.000000073574
"9203",2018-11-15 18:35:05,464760.32,465010.320000074
"21648",2018-11-15 18:35:05,425968.27,890978.590000074
"9204",2018-11-15 19:02:08,-464760.32,426218.270000074
"21649",2018-11-15 19:02:08,-425968.27,250.000000073633
"21650",2018-11-15 20:22:53,30426.68,30676.6800000736
"21651",2018-11-15 20:29:23,-30426.68,250.000000073633
"9205",2018-11-16 22:29:32,250843.68,251093.680000074
"9206",2018-11-16 22:31:37,-250843.68,250.000000073633
"9207",2018-11-17 07:27:38,347356.83,347606.830000074
"9208",2018-11-17 07:59:24,-347356.83,250.000000073633
"9209",2018-11-19 03:26:09,199434.77,199684.770000074
"9210",2018-11-19 03:32:25,-199434.77,250.000000073633
"9211",2018-11-19 09:29:29,302957.37,303207.370000074
"9212",2018-11-19 09:45:04,-302957.37,250.000000073633
"9213",2018-11-19 10:17:08,379556.09,379806.090000074
"9214",2018-11-19 10:25:39,-379556.09,250.000000073633
"9215",2018-11-19 14:37:51,322549.58,322799.580000074
"9216",2018-11-19 16:08:55,-322549.58,250.000000073633
"9217",2018-11-19 18:42:54,377782.75,378032.750000074
"21652",2018-11-19 18:42:54,377782.74,755815.490000074
"9218",2018-11-19 19:02:20,177782.89,933598.380000074
"21653",2018-11-19 19:02:20,177782.87,1111381.25000007
"21654",2018-11-19 19:14:54,-555565.61,555815.640000074
"9219",2018-11-19 19:32:26,449730.86,1005546.50000007
"9220",2018-11-19 19:32:26,266550.1,1272096.60000007
"21655",2018-11-19 19:32:26,177782.91,1449879.51000007
"21656",2018-11-19 19:32:26,349397.29,1799276.80000007
"21657",2018-11-19 19:32:26,222719.79,2021996.59000007
"21658",2018-11-19 19:32:26,187753.23,2209749.82000007
"21659",2018-11-19 19:32:26,247081.84,2456831.66000007
"21660",2018-11-19 19:32:26,115236.95,2572068.61000007
"21661",2018-11-19 19:32:26,324651.07,2896719.68000007
"21662",2018-11-19 19:46:37,-1624623.08,1272096.60000007
"9221",2018-11-19 19:53:11,-377782.75,894313.850000074
"9222",2018-11-19 20:04:24,-894063.85,250.000000073691
"9223",2018-11-19 21:42:32,270516.99,270766.990000074
"9224",2018-11-19 21:49:24,-270516.99,250.000000073691
"9225",2018-11-19 23:28:31,131176.4,131426.400000074
"9226",2018-11-19 23:28:31,223862.56,355288.960000074
"9227",2018-11-19 23:40:59,-355038.96,250.000000073633
"9228",2018-11-20 00:34:10,287459.34,287709.340000074
"9229",2018-11-20 00:42:26,-287459.34,250.000000073633
"9230",2018-11-20 04:38:32,226972.93,227222.930000074
"9231",2018-11-20 04:38:32,233774.91,460997.840000074
"9232",2018-11-20 04:38:32,231814.48,692812.320000074
"9233",2018-11-20 04:44:30,-692562.32,250.000000073691
"9234",2018-11-20 07:07:49,161312.64,161562.640000074
"9235",2018-11-20 07:42:13,-161312.64,250.000000073691
"9236",2018-11-20 09:21:39,300006.89,300256.890000074
"9237",2018-11-20 09:38:18,-300006.89,250.000000073691
"21663",2018-11-20 10:37:11,177804.23,178054.230000074
"21664",2018-11-20 11:00:05,-177804.23,250.000000073691
"21665",2018-11-20 11:51:54,177784.03,178034.030000074
"21666",2018-11-20 12:32:58,-177784.03,250.000000073691
"21667",2018-11-20 12:32:58,377783.94,378033.940000074
"21668",2018-11-20 13:31:08,-377783.94,250.000000073691
"9238",2018-11-20 13:52:42,300007.1,300257.100000074
"9239",2018-11-20 14:17:04,377784.06,678041.160000074
"9240",2018-11-20 15:08:24,377784.12,1055825.28000007
"9241",2018-11-20 15:27:41,-300007.1,755818.180000074
"9242",2018-11-20 15:49:41,-755568.18,250.000000073807
"21669",2018-11-20 23:38:08,196306.63,196556.630000074
"21670",2018-11-20 23:38:08,300007.39,496564.020000074
"21671",2018-11-21 00:35:39,-496314.02,250.000000073807
"21672",2018-11-21 00:35:39,93721.22,93971.2200000738
"9243",2018-11-21 00:35:40,255976.2,349947.420000074
"21673",2018-11-21 00:35:40,395215.29,745162.710000074
"9244",2018-11-21 00:42:28,-255976.2,489186.510000074
"21674",2018-11-21 01:42:18,-488936.51,250.000000073749
"21675",2018-11-21 03:49:30,239351.48,239601.480000074
"21676",2018-11-21 03:56:48,-239351.48,250.000000073749
"9245",2018-11-21 04:48:39,329910.17,330160.170000074
"9246",2018-11-21 05:07:06,-329910.17,250.000000073749
"21677",2018-11-21 07:39:59,135844.65,136094.650000074
"21678",2018-11-21 08:23:58,-135844.65,250.000000073749
"9247",2018-11-21 08:37:29,151009.33,151259.330000074
"21679",2018-11-21 08:37:29,44469.87,195729.200000074
"21680",2018-11-21 08:37:29,70274.14,266003.340000074
"21681",2018-11-21 08:37:29,197684.93,463688.270000074
"9248",2018-11-21 08:42:21,-151009.33,312678.940000074
"21682",2018-11-21 08:59:48,-312428.94,250.000000073749
"9249",2018-11-22 22:10:40,343377.42,343627.420000074
"9250",2018-11-22 22:43:20,280601.9,624229.320000074
"9251",2018-11-22 22:43:20,-343377.42,280851.900000074
"9252",2018-11-22 22:54:13,-280601.9,250.000000073749
"9253",2018-11-23 02:36:47,318494.86,318744.860000074
"9254",2018-11-23 02:51:36,-318494.86,250.000000073749
"21683",2018-11-23 03:27:54,315347.31,315597.310000074
"21684",2018-11-23 04:08:26,-315347.31,250.000000073749
"9255",2018-11-23 05:54:12,249773.79,250023.790000074
"9256",2018-11-23 06:20:38,-249773.79,250.000000073749
"21685",2018-11-23 09:03:58,196704.5,196954.500000074
"9257",2018-11-23 09:21:27,350928.34,547882.840000074
"21686",2018-11-23 09:21:27,-196704.5,351178.340000074
"9258",2018-11-23 09:37:14,-350928.34,250.000000073749
"9259",2018-11-23 13:39:12,321292.74,321542.740000074
"9260",2018-11-23 13:58:22,-321292.74,250.000000073749
"9261",2018-11-23 14:15:24,274760.27,275010.270000074
"9262",2018-11-23 14:26:53,-274760.27,250.000000073749
"9263",2018-11-23 15:52:13,288037.36,288287.360000074
"9264",2018-11-23 16:09:00,-288037.36,250.000000073749
"9265",2018-11-24 01:23:09,311380.07,311630.070000074
"9266",2018-11-24 01:26:29,-311380.07,250.000000073749
"9267",2018-11-24 19:48:32,418063.13,418313.130000074
"9268",2018-11-24 20:02:21,-418063.13,250.000000073749
"9269",2018-11-25 00:04:31,569832.04,570082.040000074
"21687",2018-11-25 00:04:31,248204.58,818286.620000074
"9270",2018-11-25 00:12:55,-569832.04,248454.580000074
"9271",2018-11-25 10:38:52,296553.59,545008.170000074
"9272",2018-11-25 10:55:04,-296553.59,248454.580000074
"9273",2018-11-25 11:22:03,334574.87,583029.450000074
"9274",2018-11-25 11:49:47,-334574.87,248454.580000074
"9275",2018-11-25 12:02:16,561042.41,809496.990000074
"9276",2018-11-25 12:12:13,-561042.41,248454.580000074
"21688",2018-11-25 14:22:36,-248204.58,250.000000073778
"21689",2018-11-25 22:36:26,421768.78,422018.780000074
"21690",2018-11-25 22:54:51,-421768.78,250.000000073807
"9277",2018-11-26 16:02:35,278241.16,278491.160000074
"9278",2018-11-26 16:07:33,-278241.16,250.000000073807
"9279",2018-11-27 13:30:42,300004.61,300254.610000074
"9280",2018-11-27 13:53:33,-300004.61,250.000000073807
"9281",2018-11-28 00:41:54,15647.7,15897.7000000738
"9282",2018-11-28 00:41:54,51708.16,67605.8600000738
"9283",2018-11-28 00:50:39,-67355.86,250.000000073807
"9284",2018-11-28 01:24:46,23415.04,23665.0400000738
"9285",2018-11-28 01:32:33,-23415.04,250.000000073807
"9286",2018-11-28 01:32:33,33728.29,33978.2900000738
"9287",2018-11-28 01:46:29,30393.52,64371.8100000738
"9288",2018-11-28 01:46:29,-33728.29,30643.5200000738
"9289",2018-11-28 02:23:52,-30393.52,250.000000073804
"9290",2018-11-28 03:05:38,42001.75,42251.7500000738
"9291",2018-11-28 03:19:30,-42001.75,250.000000073807
"9292",2018-11-28 03:19:30,43119.97,43369.9700000738
"9293",2018-11-28 03:42:51,45219.85,88589.8200000738
"9294",2018-11-28 03:42:51,-43119.97,45469.8500000738
"9295",2018-11-28 04:27:04,96834.28,142304.130000074
"9296",2018-11-28 04:27:04,-45219.85,97084.2800000738
"9297",2018-11-28 04:42:55,-96834.28,250.000000073807
"21691",2018-11-28 04:57:05,34925.52,35175.5200000738
"21692",2018-11-28 05:07:24,-34925.52,250.000000073807
"9298",2018-11-28 06:19:08,15429.44,15679.4400000738
"9299",2018-11-28 06:19:08,37548.02,53227.4600000738
"9300",2018-11-28 06:19:08,43711.49,96938.9500000738
"9301",2018-11-28 06:25:24,154566.19,251505.140000074
"9302",2018-11-28 06:25:24,-96688.95,154816.190000074
"9303",2018-11-28 06:33:54,-154566.19,250.000000073807
"9304",2018-11-28 06:40:46,96753.13,97003.1300000738
"9305",2018-11-28 06:46:59,-96753.13,250.000000073807
"9306",2018-11-28 07:19:35,30110.75,30360.7500000738
"9307",2018-11-28 07:24:15,-30110.75,250.000000073807
"9308",2018-11-28 07:24:15,66635.17,66885.1700000738
"9309",2018-11-28 07:31:00,-66635.17,250.000000073807
"9310",2018-11-28 08:35:20,40056.81,40306.8100000738
"9311",2018-11-28 08:48:44,11226.35,51533.1600000738
"9312",2018-11-28 08:48:44,48861.34,100394.500000074
"9313",2018-11-28 08:48:44,-40056.81,60337.6900000738
"9314",2018-11-28 08:59:10,-60087.69,250.000000073807
"21693",2018-11-28 09:08:14,7672.46,7922.46000007381
"21694",2018-11-28 09:40:35,-7672.46,250.000000073807
"9315",2018-11-28 14:36:52,100006.76,100256.760000074
"9316",2018-11-28 14:47:18,-100006.76,250.000000073807
"9317",2018-11-28 14:47:18,77783.82,78033.8200000738
"9318",2018-11-28 16:03:37,777784.13,855817.950000074
"9319",2018-11-28 16:03:37,-77783.82,778034.130000074
"21695",2018-11-28 16:03:37,377784.21,1155818.34000007
"9320",2018-11-28 16:35:44,-777784.13,378034.210000074
"21696",2018-11-28 17:04:52,-377784.21,250.000000073633
"21697",2018-11-28 18:11:54,483469.13,483719.130000074
"21698",2018-11-28 18:37:05,-483469.13,250.000000073633
"9321",2018-11-28 22:09:52,184378.23,184628.230000074
"9322",2018-11-28 22:24:17,-184378.23,250.000000073633
"9323",2018-11-29 09:48:38,377785.77,378035.770000074
"21699",2018-11-29 09:48:38,377785.75,755821.520000074
"9324",2018-11-29 09:58:59,-377785.77,378035.750000074
"21700",2018-11-29 09:58:59,167946.28,545982.030000074
"21701",2018-11-29 10:11:59,-545732.03,250.000000073574
"9325",2018-11-29 10:30:49,227289.37,227539.370000074
"9326",2018-11-29 11:00:02,-227289.37,250.000000073574
"9327",2018-11-29 11:50:44,254068.5,254318.500000074
"9328",2018-11-29 11:56:14,-254068.5,250.000000073574
"21702",2018-11-29 14:07:40,222246.44,222496.440000074
"21703",2018-11-29 14:21:20,-222246.44,250.000000073574
"9329",2018-11-29 17:03:33,377786.33,378036.330000074
"9330",2018-11-29 17:18:05,-377786.33,250.000000073574
"21704",2018-11-30 00:33:05,178262.43,178512.430000074
"21705",2018-11-30 01:18:42,-178262.43,250.000000073574
"9331",2018-11-30 08:06:58,300009.5,300259.500000074
"9332",2018-11-30 08:14:23,-300009.5,250.000000073574
"21706",2018-11-30 12:12:44,334704.38,334954.380000074
"21707",2018-11-30 12:24:26,-334704.38,250.000000073574
"21708",2018-12-02 08:11:19,256600.81,256850.810000074
"21709",2018-12-02 08:16:11,-256600.81,250.000000073574
"21710",2018-12-03 22:13:21,155035.31,155285.310000074
"21711",2018-12-03 22:30:44,-155035.31,250.000000073574
"21712",2018-12-04 06:10:58,263914.05,264164.050000074
"21713",2018-12-04 06:22:44,-263914.05,250.000000073574
"21714",2018-12-05 01:13:35,494565.13,494815.130000074
"21715",2018-12-05 01:13:35,247331.56,742146.690000074
"21716",2018-12-05 01:27:27,-741896.69,250.000000073574
"21717",2018-12-07 20:27:51,777784.02,778034.020000074
"9333",2018-12-07 20:36:43,377784.28,1155818.30000007
"9334",2018-12-07 20:41:18,-377784.28,778034.020000074
"21718",2018-12-07 20:43:01,-777784.02,250.000000073574
"9335",2018-12-08 05:59:38,777785.3,778035.300000074
"9336",2018-12-08 06:20:04,-777785.3,250.000000073574
"21719",2018-12-09 00:52:03,377785.41,378035.410000074
"21720",2018-12-09 01:39:14,-377785.41,250.000000073574
"9337",2018-12-14 15:29:33,454057.94,454307.940000074
"9338",2018-12-14 15:35:45,-454057.94,250.000000073574
"9339",2018-12-14 15:35:45,263700.05,263950.050000074
"9340",2018-12-14 16:09:42,-263700.05,250.000000073574
"9341",2018-12-16 11:01:19,395211.1,395461.100000074
"9342",2018-12-16 11:01:19,537529.45,932990.550000074
"9343",2018-12-16 11:11:38,-932740.55,250.000000073458
"9344",2018-12-17 17:15:48,327747,327997.000000073
"9345",2018-12-17 17:15:48,596120.73,924117.730000073
"9346",2018-12-17 17:23:04,-923867.73,250.000000073458
"9347",2018-12-17 19:06:55,377779.66,378029.660000073
"9348",2018-12-17 19:13:25,-377779.66,250.000000073458
"9349",2018-12-17 21:36:43,777780.87,778030.870000073
"9350",2018-12-17 21:41:01,-777780.87,250.000000073458
"9351",2018-12-18 09:15:54,377784,378034.000000073
"9352",2018-12-18 09:38:41,-377784,250.000000073458
"9353",2018-12-18 18:15:19,777777.54,778027.540000073
"9354",2018-12-18 19:16:51,-777777.54,250.000000073458
"9355",2018-12-20 18:05:25,1081662.2,1081912.20000007
"9356",2018-12-20 18:12:28,-1081662.2,250.000000073342
"9357",2018-12-21 19:55:38,276266.24,276516.240000073
"9358",2018-12-21 20:00:56,-276266.24,250.000000073342
"9359",2018-12-24 00:54:48,166622.02,166872.020000073
"9360",2018-12-24 00:54:48,599991.39,766863.410000073
"9361",2018-12-24 00:58:18,-766613.41,250.000000073342
"9362",2018-12-24 00:58:18,87589.44,87839.4400000733
"9363",2018-12-24 01:05:29,58140.02,145979.460000073
"9364",2018-12-24 01:05:29,173092.01,319071.470000073
"9365",2018-12-24 01:05:29,-87589.44,231482.030000073
"9366",2018-12-24 01:15:28,-231232.03,250.000000073313
"9367",2018-12-29 21:24:42,407564.12,407814.120000073
"9368",2018-12-29 21:32:30,260672.86,668486.980000073
"9369",2018-12-29 21:32:30,-407564.12,260922.860000073
"9370",2018-12-29 21:48:41,-260672.86,250.000000073342
"9371",2018-12-30 00:21:40,602218.61,602468.610000073
"9372",2018-12-30 00:21:40,300092.44,902561.050000073
"9373",2018-12-30 00:35:13,-902311.05,250.000000073342
"9374",2019-01-13 17:20:08,338157.04,338407.040000073
"9375",2019-01-13 17:50:37,-338157.04,250.000000073342
"9376",2019-01-13 17:50:37,418438.68,418688.680000073
"9377",2019-01-13 18:12:14,-418438.68,250.000000073342
"9378",2019-01-14 22:11:37,339209.61,339459.610000073
"9379",2019-01-14 22:34:52,-339209.61,250.000000073342
"9380",2019-01-18 23:15:12,194226.51,194476.510000073
"9381",2019-01-18 23:20:50,-194226.51,250.000000073342
"9382",2019-01-20 12:26:50,394911.66,395161.660000073
"9383",2019-01-20 12:41:04,-394911.66,250.000000073342
"9384",2019-01-20 12:41:04,238468.82,238718.820000073
"9385",2019-01-20 12:45:52,-238468.82,250.000000073342
"21721",2019-01-22 14:40:09,478260.55,478510.550000073
"21722",2019-01-22 14:47:45,-478260.55,250.000000073342
"9386",2019-01-23 14:47:11,3e+05,300250.000000073
"9387",2019-01-23 15:06:41,-3e+05,250.000000073342
"21723",2019-01-26 07:54:46,254422.27,254672.270000073
"21724",2019-01-26 08:27:44,-254422.27,250.000000073342
"9388",2019-01-26 08:27:46,83254.22,83504.2200000733
"9389",2019-01-26 08:34:44,-83254.22,250.000000073342
"9390",2019-01-26 14:43:59,97556.74,97806.7400000733
"9391",2019-01-26 15:06:54,-97556.74,250.000000073342
"9392",2019-01-26 20:07:36,300003.82,300253.820000073
"9393",2019-01-26 20:12:00,-300003.82,250.000000073342
"21725",2019-01-26 20:12:00,200003.84,200253.840000073
"21726",2019-01-26 21:01:04,-200003.84,250.000000073342
"9394",2019-01-27 09:24:38,200004.15,200254.150000073
"21727",2019-01-27 09:24:38,100004.19,300258.340000073
"9395",2019-01-27 09:39:14,-200004.15,100254.190000073
"21728",2019-01-27 09:39:14,-100004.19,250.000000073313
"9396",2019-01-27 16:19:02,55729.57,55979.5700000733
"9397",2019-01-27 16:19:02,57657.61,113637.180000073
"9398",2019-01-27 16:24:17,-113387.18,250.000000073313
"9399",2019-01-27 16:27:23,127999.52,128249.520000073
"9400",2019-01-27 16:27:23,151291.72,279541.240000073
"9401",2019-01-27 16:36:49,-279291.24,250.000000073342
"9402",2019-01-28 06:35:13,188892.58,189142.580000073
"9403",2019-01-28 06:39:13,-188892.58,250.000000073342
"21729",2019-01-28 06:50:30,97602.39,97852.3900000733
"21730",2019-01-28 07:17:51,-97602.39,250.000000073342
"9404",2019-01-28 16:17:29,88892.75,89142.7500000733
"9405",2019-01-28 16:21:00,-88892.75,250.000000073342
"9406",2019-01-28 18:55:01,68846.87,69096.8700000733
"9407",2019-01-28 19:11:03,-68846.87,250.000000073342
"9408",2019-01-29 06:14:03,150005.12,150255.120000073
"21731",2019-01-29 06:14:03,100005.13,250260.250000073
"9409",2019-01-29 06:19:12,-150005.12,100255.130000073
"21732",2019-01-29 07:14:07,-100005.13,250.000000073342
"21733",2019-01-29 21:25:59,150005.32,150255.320000073
"9410",2019-01-29 21:33:26,150005.31,300260.630000073
"9411",2019-01-29 21:38:53,-150005.31,150255.320000073
"21734",2019-01-29 21:38:53,-150005.32,250.000000073342
"9412",2019-01-30 07:06:04,86097.47,86347.4700000733
"9413",2019-01-30 07:24:09,-86097.47,250.000000073342
"9414",2019-01-30 23:49:36,85309,85559.0000000733
"9415",2019-01-30 23:59:17,-85309,250.000000073342
"9416",2019-02-01 07:59:17,72679.63,72929.6300000733
"9417",2019-02-01 08:15:22,-72679.63,250.000000073342
"9418",2019-02-02 02:19:49,91784.74,92034.7400000733
"9419",2019-02-02 02:28:55,-91784.74,250.000000073342
"9420",2019-02-02 12:18:48,93648.13,93898.1300000733
"9421",2019-02-02 12:25:49,-93648.13,250.000000073342
"9422",2019-02-02 17:01:06,87983.34,88233.3400000733
"9423",2019-02-02 17:07:29,-87983.34,250.000000073342
"9424",2019-02-03 00:25:23,120485.82,120735.820000073
"9425",2019-02-03 00:42:40,-120485.82,250.000000073342
"9426",2019-02-03 22:42:13,80454.13,80704.1300000733
"9427",2019-02-03 23:02:43,-80454.13,250.000000073342
"9428",2019-02-06 15:46:38,98240.85,98490.8500000733
"9429",2019-02-06 16:03:14,-98240.85,250.000000073342
"9430",2019-02-08 09:27:24,129472.38,129722.380000073
"9431",2019-02-08 09:33:58,-129472.38,250.000000073342
"21735",2019-02-08 16:20:41,40860.52,41110.5200000733
"21736",2019-02-08 16:47:08,-40860.52,250.000000073342
"21737",2019-02-08 16:50:54,77685.63,77935.6300000733
"21738",2019-02-08 17:15:11,83157.11,161092.740000073
"9432",2019-02-08 17:15:58,139064.72,300157.460000073
"9433",2019-02-08 17:24:44,-139064.72,161092.740000073
"21739",2019-02-08 17:37:23,64161.17,225253.910000073
"21740",2019-02-08 17:45:28,85987.89,311241.800000073
"21741",2019-02-08 18:09:42,-310991.8,250.000000073342
"21742",2019-02-08 18:24:29,68210.55,68460.5500000733
"21743",2019-02-08 18:40:39,-68210.55,250.000000073342
"21744",2019-02-08 20:15:49,57540.98,57790.9800000733
"21745",2019-02-08 20:43:04,-57540.98,250.000000073342
"21746",2019-02-08 21:35:58,89542.62,89792.6200000733
"21747",2019-02-08 22:17:27,-89542.62,250.000000073342
"9434",2019-02-09 14:27:12,102941.85,103191.850000073
"9435",2019-02-09 14:53:40,-102941.85,250.000000073342
"9436",2019-02-09 17:56:53,57784.05,58034.0500000733
"9437",2019-02-09 18:00:30,-57784.05,250.000000073342
"9438",2019-02-09 22:29:41,100789.34,101039.340000073
"9439",2019-02-09 22:55:14,-100789.34,250.000000073342
"9440",2019-02-10 17:37:19,95913.27,96163.2700000733
"9441",2019-02-10 17:40:43,-95913.27,250.000000073342
"9442",2019-02-12 10:10:22,83650.05,83900.0500000733
"9443",2019-02-12 10:29:14,-83650.05,250.000000073342
"21748",2019-02-14 18:00:15,101845.11,102095.110000073
"21749",2019-02-14 19:01:56,-101845.11,250.000000073342
"9444",2019-02-25 20:21:53,785.33,1035.33000007334
"9445",2019-02-25 20:31:54,-785.33,250.000000073342
"9446",2019-03-01 09:33:33,177785.39,178035.390000073
"9447",2019-03-01 09:39:35,-177785.39,250.000000073342
"9448",2019-03-01 09:51:21,126071.79,126321.790000073
"9449",2019-03-01 10:17:06,-126071.79,250.000000073342
"9450",2019-03-01 11:04:23,127219.68,127469.680000073
"9451",2019-03-01 11:12:34,-127219.68,250.000000073342
"9452",2019-03-01 12:56:04,173578.32,173828.320000073
"9453",2019-03-01 13:14:22,-173578.32,250.000000073342
"9454",2019-03-01 13:53:56,84074.49,84324.4900000733
"9455",2019-03-01 14:03:33,-84074.49,250.000000073342
"9456",2019-03-01 18:26:01,103111.79,103361.790000073
"9457",2019-03-01 18:34:26,-103111.79,250.000000073342
"9458",2019-03-01 18:48:01,85729.38,85979.3800000733
"9459",2019-03-01 19:11:02,-85729.38,250.000000073342
"9460",2019-03-04 23:13:34,83683.14,83933.1400000733
"9461",2019-03-04 23:39:23,-83683.14,250.000000073342
"9462",2019-03-05 08:49:59,173163.25,173413.250000073
"9463",2019-03-05 08:55:22,-173163.25,250.000000073342
"9464",2019-03-05 09:21:59,136204.25,136454.250000073
"9465",2019-03-05 09:48:25,-136204.25,250.000000073342
"9466",2019-03-05 10:14:24,129676.9,129926.900000073
"9467",2019-03-05 10:22:44,-129676.9,250.000000073342
"9468",2019-03-05 13:41:59,190477.76,190727.760000073
"9469",2019-03-05 14:19:36,163356.62,354084.380000073
"9470",2019-03-05 14:19:36,-190477.76,163606.620000073
"9471",2019-03-05 14:33:36,-163356.62,250.000000073342
"9472",2019-03-05 15:42:04,115635.37,115885.370000073
"9473",2019-03-05 15:45:43,-115635.37,250.000000073342
"9474",2019-03-05 17:41:57,113430.11,113680.110000073
"9475",2019-03-05 17:52:57,-113430.11,250.000000073342
"9476",2019-03-14 19:02:28,29265.24,29515.2400000733
"9477",2019-03-14 19:23:29,-29265.24,250.000000073342
"9478",2019-04-19 01:23:37,21172.12,21422.1200000733
"9479",2019-04-19 03:09:54,-21172.12,250.000000073342
"9480",2019-05-10 22:16:42,30000,30250.0000000733
"9481",2019-05-10 22:33:54,-30000,250.000000073342
"9482",2019-05-12 16:35:45,77773,78023.0000000733
"9483",2019-05-12 17:06:56,-77773,250.000000073342
"9484",2019-06-07 23:18:50,1136.384,1386.38400007334
"9485",2019-06-07 23:25:10,-1136.384,250.000000073342
