"","Time","Amount","Balance"
"1",2017-03-27 08:09:55,72976.36229315,72976.36229315
"2",2017-03-27 08:11:22,-72976.36229315,0
"3",2017-03-28 09:54:23,4910.5,4910.5
"4",2017-03-28 10:03:41,-4910.5,0
"5",2017-03-28 12:35:02,4766.07,4766.07
"6",2017-03-28 12:46:54,-4766.07,0
"7",2017-03-29 18:29:53,4700.7,4700.7
"8",2017-03-29 18:38:13,-4700.7,0
"9",2017-03-31 12:06:20,7478.96,7478.96
"10",2017-03-31 12:17:36,-7478.96,0
"11",2017-03-31 15:52:50,5395.48,5395.48
"12",2017-03-31 16:04:26,-5395.48,0
"13",2017-03-31 16:59:27,4927.56,4927.56
"14",2017-03-31 17:19:04,-4927.56,0
"15",2017-04-02 06:47:47,4442.88,4442.88
"16",2017-04-02 07:13:00,-4442.88,0
"17",2017-04-03 01:03:41,4493.54,4493.54
"18",2017-04-03 01:08:34,-4493.54,0
"19",2017-04-03 19:53:53,4466.39,4466.39
"20",2017-04-03 19:59:23,-4466.39,0
"21",2017-04-04 03:20:08,4697.2,4697.2
"22",2017-04-04 03:22:32,-4697.2,0
"23",2017-04-04 21:20:18,4105.79,4105.79
"24",2017-04-04 21:34:35,-4105.79,0
"25",2017-04-06 21:30:24,4789.18,4789.18
"26",2017-04-06 21:30:24,8290.75,13079.93
"27",2017-04-06 21:33:50,-8290.75,4789.18
"28",2017-04-06 21:33:50,-4789.18,0
"29",2017-04-07 01:28:35,4194.27,4194.27
"30",2017-04-07 01:40:13,-4194.27,0
"31",2017-04-07 06:02:59,4992.97,4992.97
"32",2017-04-07 06:10:59,-4992.97,0
"33",2017-04-07 16:17:50,5060.26,5060.26
"34",2017-04-07 16:24:32,-5060.26,0
"35",2017-04-08 04:03:49,4067.02,4067.02
"36",2017-04-08 04:31:24,-4067.02,0
"37",2017-04-11 16:33:02,5644.53,5644.53
"38",2017-04-11 16:35:17,-5644.53,0
"39",2017-04-11 19:33:23,7848.39,7848.39
"40",2017-04-11 19:45:52,-7848.39,0
"41",2017-04-13 19:33:42,4877.81,4877.81
"42",2017-04-13 22:17:26,4294.76,9172.57
"43",2017-04-13 22:33:17,-4294.76,4877.81
"44",2017-04-13 23:05:54,-4877.81,-9.09494701772928e-13
"45",2017-04-14 04:01:01,14175.5,14175.5
"46",2017-04-14 04:33:21,-14175.5,0
"47",2017-04-14 14:22:19,16948.11,16948.11
"48",2017-04-14 14:42:14,-16948.11,0
"49",2017-04-14 15:21:42,6389.17,6389.17
"50",2017-04-14 15:27:48,-6389.17,0
"51",2017-04-14 16:00:40,4435.42,4435.42
"52",2017-04-14 16:10:12,-4435.42,0
"53",2017-04-15 02:30:03,4773.34,4773.34
"54",2017-04-15 02:47:42,-4773.34,0
"55",2017-04-17 16:35:18,4308.66,4308.66
"56",2017-04-17 16:38:24,-4308.66,0
"57",2017-04-17 20:30:56,5530.23,5530.23
"58",2017-04-17 20:43:59,-5530.23,0
"59",2017-04-17 20:43:59,6662.79,6662.79
"60",2017-04-17 20:54:50,-6662.79,0
"61",2017-04-18 04:08:27,4377.93,4377.93
"62",2017-04-18 04:18:11,-4377.93,0
"63",2017-04-18 04:55:11,4162.51,4162.51
"64",2017-04-18 04:58:32,-4162.51,0
"65",2017-04-18 09:43:25,4547.48,4547.48
"66",2017-04-18 10:04:18,-4547.48,0
"67",2017-04-18 13:32:01,5052.54,5052.54
"68",2017-04-18 19:01:17,-5052.54,0
"69",2017-04-18 20:25:24,4214.27,4214.27
"70",2017-04-18 20:26:50,-4214.27,0
"71",2017-04-18 22:08:42,10253.74,10253.74
"72",2017-04-18 22:21:32,-10253.74,0
"73",2017-04-19 01:01:44,10405.33,10405.33
"74",2017-04-19 01:03:18,-10405.33,0
"75",2017-04-19 07:01:17,6954.23,6954.23
"76",2017-04-19 07:05:10,-6954.23,0
"77",2017-04-19 15:44:29,6918.09,6918.09
"78",2017-04-19 15:47:44,-6918.09,0
"79",2017-04-19 20:45:45,7911.92,7911.92
"80",2017-04-19 20:51:41,-7911.92,0
"81",2017-04-19 22:53:15,9619.91,9619.91
"82",2017-04-19 23:02:34,-9619.91,0
"83",2017-04-20 17:33:36,9083.03,9083.03
"84",2017-04-20 17:46:59,-9083.03,0
"85",2017-04-20 19:17:30,7938.98,7938.98
"86",2017-04-20 19:20:47,-7938.98,0
"87",2017-04-21 09:33:16,30049.66,30049.66
"88",2017-04-21 09:33:16,28230.23,58279.89
"89",2017-04-21 10:01:53,47049.67,105329.56
"90",2017-04-21 10:27:01,-47049.67,58279.89
"91",2017-04-21 10:43:56,-30049.66,28230.23
"92",2017-04-21 10:43:56,-28230.23,0
"93",2017-04-22 16:59:20,17649.26,17649.26
"94",2017-04-22 17:04:11,-17649.26,0
"95",2017-04-22 22:19:28,40557.15,40557.15
"96",2017-04-22 22:24:25,-40557.15,0
"97",2017-05-01 13:27:46,18126.33,18126.33
"98",2017-05-01 13:36:45,-18126.33,0
"99",2017-05-01 16:20:25,20317.01,20317.01
"100",2017-05-01 16:27:59,-20317.01,0
"101",2017-05-01 21:52:30,17726.77,17726.77
"102",2017-05-01 22:00:12,-17726.77,0
"103",2017-05-01 22:22:12,21836.8,21836.8
"104",2017-05-01 22:30:03,-21836.8,0
"105",2017-05-03 22:28:03,23503.91,23503.91
"106",2017-05-03 22:32:59,-23503.91,0
"107",2017-05-04 06:23:09,11807.13,11807.13
"108",2017-05-04 06:42:49,-11807.13,0
"109",2017-05-04 14:18:57,12450.69,12450.69
"110",2017-05-04 14:20:39,-12450.69,0
"111",2017-05-04 17:40:15,19345.68,19345.68
"112",2017-05-04 18:58:12,17459.42,36805.1
"113",2017-05-04 19:32:05,-19345.68,17459.42
"114",2017-05-04 19:32:05,-17459.42,0
"115",2017-05-04 21:18:56,13146.42,13146.42
"116",2017-05-04 21:22:22,21900.87,35047.29
"117",2017-05-04 22:04:09,-13146.42,21900.87
"118",2017-05-04 22:04:09,-21900.87,3.63797880709171e-12
"119",2017-05-05 07:00:08,11866.49,11866.49
"120",2017-05-05 07:04:07,-11866.49,3.63797880709171e-12
"121",2017-05-05 08:30:53,11800.36,11800.36
"122",2017-05-05 08:31:45,-11800.36,3.63797880709171e-12
"123",2017-05-05 13:21:27,13138.43,13138.43
"124",2017-05-05 13:56:45,-13138.43,3.63797880709171e-12
"125",2017-05-05 16:49:15,12916.78,12916.78
"126",2017-05-05 16:57:37,-12916.78,3.63797880709171e-12
"127",2017-05-05 17:28:42,30053.49,30053.49
"128",2017-05-05 17:28:42,14017.38,44070.87
"129",2017-05-05 17:28:42,16340.81,60411.68
"130",2017-05-05 18:03:38,-16340.81,44070.87
"131",2017-05-05 18:03:38,-30053.49,14017.38
"132",2017-05-05 18:03:38,-14017.38,1.81898940354586e-12
"133",2017-05-05 19:55:12,24066.9,24066.9
"134",2017-05-05 20:19:33,15110.09,39176.99
"135",2017-05-05 20:19:33,-24066.9,15110.09
"136",2017-05-05 20:24:46,-15110.09,3.63797880709171e-12
"137",2017-05-05 21:08:56,19332.71,19332.71
"138",2017-05-05 22:44:50,-19332.71,3.63797880709171e-12
"139",2017-05-06 08:54:18,25968.02,25968.02
"140",2017-05-06 09:17:31,-25968.02,3.63797880709171e-12
"141",2017-05-07 07:56:28,18338,18338
"142",2017-05-07 08:07:55,-18338,3.63797880709171e-12
"143",2017-05-07 20:41:17,13169.35,13169.35
"144",2017-05-07 20:46:10,-13169.35,3.63797880709171e-12
"145",2017-05-07 23:46:45,26053.16,26053.16
"146",2017-05-07 23:52:34,-26053.16,3.63797880709171e-12
"147",2017-05-08 04:40:29,12178.35,12178.35
"148",2017-05-08 04:50:21,-12178.35,3.63797880709171e-12
"149",2017-05-08 06:26:18,11299.62,11299.62
"150",2017-05-08 06:38:50,-11299.62,3.63797880709171e-12
"151",2017-05-09 18:54:36,27918.58,27918.58
"152",2017-05-09 19:09:01,-27918.58,3.63797880709171e-12
"153",2017-05-09 20:48:12,12160.26,12160.26
"154",2017-05-09 21:04:50,-12160.26,3.63797880709171e-12
"155",2017-05-09 21:04:50,30095.1,30095.1
"156",2017-05-09 21:34:37,-30095.1,3.63797880709171e-12
"157",2017-05-10 16:05:00,18889.68,18889.68
"158",2017-05-10 16:27:15,-18889.68,3.63797880709171e-12
"159",2017-05-10 19:05:01,11368.18,11368.18
"160",2017-05-10 19:08:48,-11368.18,3.63797880709171e-12
"161",2017-05-10 23:06:30,11709.48,11709.48
"162",2017-05-10 23:17:57,-11709.48,3.63797880709171e-12
"163",2017-05-11 03:57:45,11447.96,11447.96
"164",2017-05-11 04:20:09,-11447.96,3.63797880709171e-12
"165",2017-05-11 05:45:22,31980.04,31980.04
"166",2017-05-11 05:45:22,16552.09,48532.13
"167",2017-05-11 05:55:37,-31980.04,16552.09
"168",2017-05-11 06:00:18,-16552.09,3.63797880709171e-12
"169",2017-05-11 07:50:50,24242.43,24242.43
"170",2017-05-11 07:50:50,30000.8,54243.23
"171",2017-05-11 08:13:18,-24242.43,30000.8
"172",2017-05-11 08:15:54,-30000.8,3.63797880709171e-12
"173",2017-05-11 08:44:46,37777.83,37777.83
"174",2017-05-11 09:31:46,-37777.83,0
"175",2017-05-11 16:30:58,38888.91,38888.91
"176",2017-05-11 16:41:07,-38888.91,0
"177",2017-05-12 20:24:34,30001.3,30001.3
"178",2017-05-12 21:11:40,-30001.3,0
"179",2017-05-12 22:02:11,30001.33,30001.33
"180",2017-05-13 00:22:27,-30001.33,0
"181",2017-05-13 03:14:50,37778.5,37778.5
"182",2017-05-13 03:43:09,-37778.5,0
"183",2017-05-13 07:10:20,22156.79,22156.79
"184",2017-05-13 07:30:53,-22156.79,0
"185",2017-05-13 21:44:50,23634.17,23634.17
"186",2017-05-13 21:48:53,-23634.17,0
"187",2017-05-13 22:55:29,17853.43,17853.43
"188",2017-05-13 23:20:19,-17853.43,0
"189",2017-05-14 10:25:07,19295.77,19295.77
"190",2017-05-14 10:38:33,-19295.77,0
"191",2017-05-15 06:00:02,29895.24,29895.24
"192",2017-05-17 12:40:28,37780.13,67675.37
"193",2017-05-17 12:41:51,-29895.24,37780.13
"194",2017-05-17 19:17:19,-37780.13,-7.27595761418343e-12
"195",2017-05-18 03:45:27,50003.19,50003.19
"196",2017-05-18 04:05:29,-50003.19,-7.27595761418343e-12
"197",2017-05-18 10:16:23,20512.62,20512.62
"198",2017-05-18 10:25:42,-20512.62,-7.27595761418343e-12
"199",2017-05-18 14:23:16,22126.55,22126.55
"200",2017-05-18 15:36:37,-22126.55,-7.27595761418343e-12
"201",2017-05-18 18:03:22,30003.65,30003.65
"202",2017-05-19 04:26:33,70003.75,100007.4
"203",2017-05-19 05:06:53,-30003.65,70003.75
"204",2017-05-19 15:08:26,70003.85,140007.6
"205",2017-05-19 22:35:16,-140007.6,0
"206",2017-05-20 23:49:56,40064.79,40064.79
"207",2017-05-21 00:55:42,-40064.79,0
"208",2017-05-21 23:35:31,37781.75,37781.75
"209",2017-05-22 00:34:23,-37781.75,0
"210",2017-05-22 07:11:57,23165.39,23165.39
"211",2017-05-22 09:45:04,50004.91,73170.3
"212",2017-05-22 13:00:18,46520.33,119690.63
"213",2017-05-22 17:54:15,35967.8,155658.43
"214",2017-05-22 23:37:52,14939.39,170597.82
"215",2017-05-23 00:05:46,19525.54,190123.36
"216",2017-05-27 22:58:12,-23165.39,166957.97
"217",2017-05-29 14:38:57,7000,173957.97
"218",2017-05-29 23:25:13,70025.23,243983.2
"219",2017-05-29 23:54:51,-173957.97,70025.23
"220",2017-05-30 00:02:57,-70025.23,1.45519152283669e-11
"221",2017-05-30 00:10:20,47862.56,47862.56
"222",2017-05-30 00:20:28,-47862.56,1.45519152283669e-11
"223",2017-05-30 00:37:31,42973.96,42973.96
"224",2017-05-30 00:43:24,-42973.96,1.45519152283669e-11
"225",2017-05-30 02:05:57,34153.13,34153.13
"226",2017-05-30 02:09:12,-34153.13,1.45519152283669e-11
"227",2017-05-30 02:48:41,33555.41,33555.41
"228",2017-05-30 02:50:32,-33555.41,1.45519152283669e-11
"229",2017-05-30 03:45:05,36991.74,36991.74
"230",2017-05-30 04:15:49,-36991.74,1.45519152283669e-11
"231",2017-05-30 07:23:47,53910.7,53910.7
"232",2017-05-30 07:25:15,-53910.7,1.45519152283669e-11
"233",2017-05-30 09:20:19,59361.71,59361.71
"234",2017-05-30 09:26:16,-59361.71,1.45519152283669e-11
"235",2017-05-30 12:26:13,51077.79,51077.79
"236",2017-05-30 12:32:22,-51077.79,1.45519152283669e-11
"237",2017-05-30 13:47:17,58564.74,58564.74
"238",2017-05-30 13:53:58,-58564.74,1.45519152283669e-11
"239",2017-05-30 14:42:56,36321.3,36321.3
"240",2017-05-30 14:49:47,-36321.3,1.45519152283669e-11
"241",2017-05-30 16:24:52,25566.24,25566.24
"242",2017-05-30 16:34:02,-25566.24,1.45519152283669e-11
"243",2017-05-30 17:37:32,40683.22,40683.22
"244",2017-05-30 18:03:45,-40683.22,1.45519152283669e-11
"245",2017-05-30 19:28:12,50967.86,50967.86
"246",2017-05-30 19:48:15,-50967.86,1.45519152283669e-11
"247",2017-05-30 20:32:15,58933.23,58933.23
"248",2017-05-30 20:39:17,-58933.23,1.45519152283669e-11
"249",2017-05-30 20:49:59,39296.35,39296.35
"250",2017-05-30 20:59:18,-39296.35,1.45519152283669e-11
"251",2017-05-30 22:30:53,23401.93,23401.93
"252",2017-05-30 22:30:53,41883.55,65285.48
"253",2017-05-30 22:33:17,-65285.48,1.45519152283669e-11
"254",2017-05-30 23:12:18,32137.82,32137.82
"255",2017-05-30 23:15:29,-32137.82,1.45519152283669e-11
"256",2017-05-30 23:38:28,42801.08,42801.08
"257",2017-05-30 23:48:31,-42801.08,1.45519152283669e-11
"258",2017-05-31 00:23:45,13671.74,13671.74
"259",2017-05-31 00:31:14,-13671.74,1.45519152283669e-11
"260",2017-05-31 00:51:13,24230.82,24230.82
"261",2017-05-31 00:52:02,-24230.82,1.45519152283669e-11
"262",2017-05-31 04:17:29,52732.22,52732.22
"263",2017-05-31 04:39:32,-52732.22,1.45519152283669e-11
"264",2017-05-31 05:34:31,42244.78,42244.78
"265",2017-05-31 05:40:47,-42244.78,1.45519152283669e-11
"266",2017-05-31 06:12:59,68572.6,68572.6
"267",2017-05-31 06:24:33,-68572.6,1.45519152283669e-11
"268",2017-05-31 07:04:05,51722.82,51722.82
"269",2017-05-31 07:27:34,-51722.82,1.45519152283669e-11
"270",2017-05-31 10:03:41,54815.54,54815.54
"271",2017-05-31 10:28:38,-54815.54,1.45519152283669e-11
"272",2017-05-31 11:02:43,12276.49,12276.49
"273",2017-05-31 11:06:20,-12276.49,1.45519152283669e-11
"274",2017-05-31 16:07:51,3277.06,3277.06000000001
"275",2017-05-31 16:22:51,-3277.06,1.45519152283669e-11
"276",2017-05-31 16:33:53,27810.34,27810.34
"277",2017-05-31 16:48:50,-27810.34,1.45519152283669e-11
"278",2017-05-31 19:46:09,48955.91,48955.91
"279",2017-05-31 19:49:29,-48955.91,1.45519152283669e-11
"280",2017-06-01 01:44:50,63343.07,63343.07
"281",2017-06-01 01:48:36,-63343.07,1.45519152283669e-11
"282",2017-06-01 02:05:08,3305.2,3305.20000000001
"283",2017-06-01 02:19:48,-3305.2,1.45519152283669e-11
"284",2017-06-01 02:34:01,14160.58,14160.58
"285",2017-06-01 02:52:27,-14160.58,1.45519152283669e-11
"286",2017-06-01 03:03:31,68105.1,68105.1
"287",2017-06-01 03:09:19,-68105.1,1.45519152283669e-11
"288",2017-06-01 04:07:37,12851.55,12851.55
"289",2017-06-01 04:25:11,-12851.55,1.45519152283669e-11
"290",2017-06-01 04:44:43,44720.89,44720.89
"291",2017-06-01 04:49:33,-44720.89,1.45519152283669e-11
"292",2017-06-01 05:05:26,37518.97,37518.97
"293",2017-06-01 05:18:03,-37518.97,1.45519152283669e-11
"294",2017-06-01 05:33:39,9120.79,9120.79000000002
"295",2017-06-01 05:41:40,-9120.79,1.45519152283669e-11
"296",2017-06-01 05:55:10,8754.56,8754.56000000001
"297",2017-06-01 05:57:32,-8754.56,1.45519152283669e-11
"298",2017-06-01 07:03:55,30809.61,30809.61
"299",2017-06-01 07:11:05,-30809.61,1.45519152283669e-11
"300",2017-06-01 07:36:39,14506.99,14506.99
"301",2017-06-01 07:59:00,-14506.99,1.45519152283669e-11
"302",2017-06-01 08:09:13,10452.47,10452.47
"303",2017-06-01 08:32:54,-10452.47,1.45519152283669e-11
"304",2017-06-01 09:31:36,53364.4,53364.4
"305",2017-06-01 10:02:13,-53364.4,1.45519152283669e-11
"306",2017-06-01 10:21:35,35483.41,35483.41
"307",2017-06-01 10:52:28,-35483.41,1.45519152283669e-11
"308",2017-06-01 11:40:33,50434.8,50434.8
"309",2017-06-01 11:46:08,-50434.8,1.45519152283669e-11
"310",2017-06-01 12:37:09,39593.32,39593.32
"311",2017-06-01 12:38:34,-39593.32,1.45519152283669e-11
"312",2017-06-01 17:57:42,13352.47,13352.47
"313",2017-06-01 18:09:47,-13352.47,1.45519152283669e-11
"314",2017-06-01 18:09:47,6230.14,6230.14000000001
"315",2017-06-01 18:14:27,-6230.14,1.45519152283669e-11
"316",2017-06-01 18:32:34,14318.83,14318.83
"317",2017-06-01 18:51:43,-14318.83,1.45519152283669e-11
"318",2017-06-01 22:39:20,58060.53,58060.53
"319",2017-06-01 22:45:07,-58060.53,1.45519152283669e-11
"320",2017-06-01 23:05:49,30384.79,30384.79
"321",2017-06-01 23:14:18,-30384.79,1.45519152283669e-11
"322",2017-06-02 02:21:30,51184.35,51184.35
"323",2017-06-02 02:28:01,-51184.35,1.45519152283669e-11
"324",2017-06-02 06:13:03,59962.58,59962.58
"325",2017-06-02 06:40:01,-59962.58,1.45519152283669e-11
"326",2017-06-02 07:59:13,31821.84,31821.84
"327",2017-06-02 08:01:21,-31821.84,1.45519152283669e-11
"328",2017-06-02 08:26:01,59559.66,59559.66
"329",2017-06-02 08:34:03,-59559.66,1.45519152283669e-11
"330",2017-06-02 09:07:35,42074.45,42074.45
"331",2017-06-02 09:15:00,-42074.45,1.45519152283669e-11
"332",2017-06-02 09:42:46,45195.93,45195.93
"333",2017-06-02 09:47:53,-45195.93,1.45519152283669e-11
"334",2017-06-02 10:23:03,54303.51,54303.51
"335",2017-06-02 10:28:42,-54303.51,1.45519152283669e-11
"336",2017-06-02 10:55:06,65308.98,65308.98
"337",2017-06-02 11:07:12,-65308.98,1.45519152283669e-11
"338",2017-06-02 13:33:36,67566.5,67566.5
"339",2017-06-02 13:41:04,-67566.5,1.45519152283669e-11
"340",2017-06-02 15:52:06,3640.43,3640.43000000001
"341",2017-06-02 15:57:04,-3640.43,1.45519152283669e-11
"342",2017-06-02 16:05:26,17362.14,17362.14
"343",2017-06-02 16:11:54,-17362.14,1.45519152283669e-11
"344",2017-06-02 16:29:22,54558.51,54558.51
"345",2017-06-02 16:52:44,-54558.51,1.45519152283669e-11
"346",2017-06-02 18:03:27,12673.68,12673.68
"347",2017-06-02 18:06:46,-12673.68,1.45519152283669e-11
"348",2017-06-02 19:07:03,27662.06,27662.06
"349",2017-06-02 19:15:01,-27662.06,1.45519152283669e-11
"350",2017-06-02 19:37:27,9834.44,9834.44000000002
"351",2017-06-02 19:39:29,-9834.44,1.45519152283669e-11
"352",2017-06-02 21:13:56,13219.94,13219.94
"353",2017-06-02 21:18:07,-13219.94,1.45519152283669e-11
"354",2017-06-02 22:50:40,31256.45,31256.45
"355",2017-06-03 00:54:53,-31256.45,1.45519152283669e-11
"356",2017-06-03 04:57:53,30019.23,30019.23
"357",2017-06-03 04:59:26,-30019.23,1.45519152283669e-11
"358",2017-06-03 05:14:19,14757.57,14757.57
"359",2017-06-03 05:18:32,-14757.57,1.45519152283669e-11
"360",2017-06-03 05:42:42,11990.26,11990.26
"361",2017-06-03 05:54:51,-11990.26,1.45519152283669e-11
"362",2017-06-03 06:38:34,27393.59,27393.59
"363",2017-06-03 06:44:10,-27393.59,1.45519152283669e-11
"364",2017-06-03 07:11:16,37233.47,37233.47
"365",2017-06-03 07:41:39,-37233.47,1.45519152283669e-11
"366",2017-06-03 07:58:09,26061.92,26061.92
"367",2017-06-03 07:59:56,-26061.92,1.45519152283669e-11
"368",2017-06-03 08:31:08,28898.96,28898.96
"369",2017-06-03 08:44:05,-28898.96,1.45519152283669e-11
"370",2017-06-03 09:28:01,13155.08,13155.08
"371",2017-06-03 09:37:23,-13155.08,1.45519152283669e-11
"372",2017-06-03 10:06:44,9139.1,9139.10000000001
"373",2017-06-03 10:17:37,-9139.1,1.45519152283669e-11
"374",2017-06-03 10:50:50,38021.37,38021.37
"375",2017-06-03 10:56:37,-38021.37,1.45519152283669e-11
"376",2017-06-03 11:23:26,28112.81,28112.81
"377",2017-06-03 11:33:58,-28112.81,1.45519152283669e-11
"378",2017-06-03 14:34:28,51959.23,51959.23
"379",2017-06-03 14:41:29,-51959.23,1.45519152283669e-11
"380",2017-06-03 15:06:23,21419.71,21419.71
"381",2017-06-03 15:26:54,-21419.71,1.45519152283669e-11
"382",2017-06-03 16:47:50,34202.49,34202.49
"383",2017-06-03 16:57:32,-34202.49,1.45519152283669e-11
"384",2017-06-03 17:39:13,17137,17137
"385",2017-06-03 17:42:47,-17137,1.45519152283669e-11
"386",2017-06-03 19:03:43,32118.02,32118.02
"387",2017-06-03 19:09:02,-32118.02,1.45519152283669e-11
"388",2017-06-03 20:11:26,57413.25,57413.25
"389",2017-06-03 21:08:14,-57413.25,1.45519152283669e-11
"390",2017-06-03 22:43:04,60092.32,60092.32
"391",2017-06-03 22:51:41,-60092.32,1.45519152283669e-11
"392",2017-06-04 01:07:46,35359.04,35359.04
"393",2017-06-04 01:11:08,-35359.04,1.45519152283669e-11
"394",2017-06-04 03:20:57,51683.25,51683.25
"395",2017-06-04 03:27:26,-51683.25,1.45519152283669e-11
"396",2017-06-04 04:35:58,56444.97,56444.97
"397",2017-06-04 05:01:04,-56444.97,1.45519152283669e-11
"398",2017-06-04 05:48:23,45755.35,45755.35
"399",2017-06-04 06:02:38,-45755.35,1.45519152283669e-11
"400",2017-06-04 06:24:49,44452.31,44452.31
"401",2017-06-04 06:34:34,-44452.31,1.45519152283669e-11
"402",2017-06-04 07:03:23,12260.11,12260.11
"403",2017-06-04 07:17:43,-12260.11,1.45519152283669e-11
"404",2017-06-04 07:46:43,50027.37,50027.37
"405",2017-06-04 07:49:13,-50027.37,1.45519152283669e-11
"406",2017-06-04 07:59:28,56842.94,56842.94
"407",2017-06-04 08:17:51,-56842.94,1.45519152283669e-11
"408",2017-06-04 08:50:58,66694.97,66694.97
"409",2017-06-04 08:58:28,-66694.97,1.45519152283669e-11
"410",2017-06-04 10:12:36,60289.33,60289.33
"411",2017-06-04 10:24:47,-60289.33,1.45519152283669e-11
"412",2017-06-04 14:43:59,90368.21,90368.21
"413",2017-06-04 14:51:47,-90368.21,1.45519152283669e-11
"414",2017-06-04 21:46:07,61386.47,61386.47
"415",2017-06-04 22:17:00,-61386.47,1.45519152283669e-11
"416",2017-06-04 23:34:47,48494.13,48494.13
"417",2017-06-04 23:51:20,-48494.13,1.45519152283669e-11
"418",2017-06-05 00:39:46,45596.47,45596.47
"419",2017-06-05 00:47:22,-45596.47,1.45519152283669e-11
"420",2017-06-05 01:18:56,19242.95,19242.95
"421",2017-06-05 01:32:41,-19242.95,1.45519152283669e-11
"422",2017-06-05 01:49:32,8772.04,8772.04000000002
"423",2017-06-05 01:57:05,-8772.04,1.45519152283669e-11
"424",2017-06-05 04:16:07,60169.34,60169.34
"425",2017-06-05 04:47:46,-60169.34,1.45519152283669e-11
"426",2017-06-05 05:12:09,16038.4,16038.4
"427",2017-06-05 05:26:07,-16038.4,1.45519152283669e-11
"428",2017-06-05 05:37:21,11968.44,11968.44
"429",2017-06-05 05:40:57,-11968.44,1.45519152283669e-11
"430",2017-06-05 06:04:58,5033,5033.00000000001
"431",2017-06-05 06:04:58,22969,28002
"432",2017-06-05 06:09:14,-28002,1.45519152283669e-11
"433",2017-06-05 06:28:58,7795.39,7795.39000000001
"434",2017-06-05 06:28:58,5232.92,13028.31
"435",2017-06-05 06:32:33,-13028.31,1.63709046319127e-11
"436",2017-06-05 07:21:55,23868.46,23868.46
"437",2017-06-05 07:48:17,-23868.46,1.45519152283669e-11
"438",2017-06-05 07:55:56,10178.52,10178.52
"439",2017-06-05 07:59:20,-10178.52,1.45519152283669e-11
"440",2017-06-05 08:58:44,18385.28,18385.28
"441",2017-06-05 09:12:29,39844.09,58229.37
"442",2017-06-05 09:12:29,-18385.28,39844.09
"443",2017-06-05 09:34:54,-39844.09,1.45519152283669e-11
"444",2017-06-05 10:36:57,63335.58,63335.58
"445",2017-06-05 10:40:40,-63335.58,1.45519152283669e-11
"446",2017-06-05 11:41:06,59278.3,59278.3
"447",2017-06-05 11:48:14,-59278.3,1.45519152283669e-11
"448",2017-06-05 14:46:33,62245.17,62245.17
"449",2017-06-05 14:59:16,-62245.17,1.45519152283669e-11
"450",2017-06-05 16:07:18,5411.81,5411.81000000001
"451",2017-06-05 16:12:19,-5411.81,1.45519152283669e-11
"452",2017-06-05 16:21:48,6390.67,6390.67000000001
"453",2017-06-05 16:24:58,-6390.67,1.45519152283669e-11
"454",2017-06-05 17:04:56,54070.79,54070.79
"455",2017-06-05 17:19:44,-54070.79,1.45519152283669e-11
"456",2017-06-05 17:39:10,54508.78,54508.78
"457",2017-06-05 17:44:36,-54508.78,1.45519152283669e-11
"458",2017-06-05 18:45:22,26220.17,26220.17
"459",2017-06-05 18:59:53,-26220.17,1.45519152283669e-11
"460",2017-06-05 20:16:04,38887.21,38887.21
"461",2017-06-05 20:22:41,-38887.21,1.45519152283669e-11
"462",2017-06-05 20:40:13,63482.08,63482.08
"463",2017-06-05 21:25:40,-63482.08,1.45519152283669e-11
"464",2017-06-05 21:32:06,48976.35,48976.35
"465",2017-06-05 21:38:44,-48976.35,1.45519152283669e-11
"466",2017-06-05 21:40:28,12258.18,12258.18
"467",2017-06-05 21:54:32,42386.84,54645.02
"468",2017-06-05 21:54:32,-12258.18,42386.84
"469",2017-06-05 22:14:52,-42386.84,1.45519152283669e-11
"470",2017-06-05 22:58:32,34909.55,34909.55
"471",2017-06-05 22:58:32,45125.72,80035.27
"472",2017-06-05 23:05:05,-80035.27,1.45519152283669e-11
"473",2017-06-06 03:37:51,64262.35,64262.35
"474",2017-06-06 03:37:51,48914.15,113176.5
"475",2017-06-06 03:42:42,-113176.5,1.45519152283669e-11
"476",2017-06-06 04:01:00,45830.58,45830.58
"477",2017-06-06 04:07:05,32599.92,78430.5
"478",2017-06-06 04:07:05,-45830.58,32599.92
"479",2017-06-06 04:07:05,4377.08,36977
"480",2017-06-06 04:13:26,46284.76,83261.76
"481",2017-06-06 04:13:26,-36977,46284.76
"482",2017-06-06 04:28:28,-46284.76,7.27595761418343e-12
"483",2017-06-06 04:35:55,26012.67,26012.67
"484",2017-06-06 04:35:55,27889.69,53902.36
"485",2017-06-06 04:43:10,-53902.36,0
"486",2017-06-06 05:13:47,64835.12,64835.12
"487",2017-06-06 05:25:10,45633.43,110468.55
"488",2017-06-06 05:25:10,-64835.12,45633.43
"489",2017-06-06 05:38:55,-45633.43,0
"490",2017-06-06 05:55:04,47426.8,47426.8
"491",2017-06-06 06:15:40,38525.51,85952.31
"492",2017-06-06 06:15:40,-47426.8,38525.51
"493",2017-06-06 06:25:45,-38525.51,-7.27595761418343e-12
"494",2017-06-06 07:50:28,46548.2,46548.2
"495",2017-06-06 08:06:30,-46548.2,-7.27595761418343e-12
"496",2017-06-06 08:29:57,13057.1,13057.1
"497",2017-06-06 08:36:25,-13057.1,-7.27595761418343e-12
"498",2017-06-06 10:10:25,67689,67689
"499",2017-06-06 10:15:44,-67689,0
"500",2017-06-06 11:14:18,68568.25,68568.25
"501",2017-06-06 11:31:27,-68568.25,0
"502",2017-06-06 12:02:06,49432.38,49432.38
"503",2017-06-06 12:11:05,-49432.38,0
"504",2017-06-06 12:32:23,42677.9,42677.9
"505",2017-06-06 12:32:23,74463.28,117141.18
"506",2017-06-06 13:04:44,-117141.18,0
"507",2017-06-06 13:24:38,52354,52354
"508",2017-06-06 13:45:16,52242.27,104596.27
"509",2017-06-06 13:45:16,-52354,52242.27
"510",2017-06-06 13:58:13,-52242.27,-7.27595761418343e-12
"511",2017-06-06 14:12:50,10740.58,10740.58
"512",2017-06-06 14:16:47,-10740.58,-7.27595761418343e-12
"513",2017-06-06 15:02:51,54569.19,54569.19
"514",2017-06-06 15:07:51,-54569.19,-7.27595761418343e-12
"515",2017-06-06 15:07:51,67751.92,67751.92
"516",2017-06-06 16:04:17,51365.64,119117.56
"517",2017-06-06 16:38:38,-67751.92,51365.64
"518",2017-06-06 16:38:38,80035.25,131400.89
"519",2017-06-06 16:45:37,-131400.89,-2.91038304567337e-11
"520",2017-06-06 16:50:33,110033.81,110033.81
"521",2017-06-06 16:57:40,-110033.81,-2.91038304567337e-11
"522",2017-06-06 17:15:02,13223.2,13223.2
"523",2017-06-06 17:15:02,8802.86,22026.06
"524",2017-06-06 17:18:08,-22026.06,-2.91038304567337e-11
"525",2017-06-06 18:02:01,65942.87,65942.87
"526",2017-06-06 18:05:14,-65942.87,-2.91038304567337e-11
"527",2017-06-06 18:05:14,157390.77,157390.77
"528",2017-06-06 18:10:22,54612.9,212003.67
"529",2017-06-06 18:10:22,-157390.77,54612.9
"530",2017-06-06 18:27:37,-54612.9,-3.63797880709171e-11
"531",2017-06-06 18:43:26,87190.22,87190.22
"532",2017-06-06 19:46:56,-87190.22,-2.91038304567337e-11
"533",2017-06-06 22:06:41,53263.1,53263.1
"534",2017-06-06 22:18:39,-53263.1,-2.91038304567337e-11
"535",2017-06-06 23:14:17,59170.42,59170.42
"536",2017-06-06 23:21:22,-59170.42,-2.91038304567337e-11
"537",2017-06-07 00:03:02,91856.94,91856.94
"538",2017-06-07 00:06:11,-91856.94,-2.91038304567337e-11
"539",2017-06-07 01:16:01,16606.34,16606.34
"540",2017-06-07 01:19:43,-16606.34,-2.91038304567337e-11
"541",2017-06-07 02:58:14,55032.15,55032.15
"542",2017-06-07 03:02:22,-55032.15,-2.91038304567337e-11
"543",2017-06-07 05:55:48,13428.99,13428.99
"544",2017-06-07 06:05:57,-13428.99,-2.91038304567337e-11
"545",2017-06-07 07:39:14,58054.84,58054.84
"546",2017-06-07 07:57:57,-58054.84,-2.91038304567337e-11
"547",2017-06-07 08:34:00,76756.42,76756.42
"548",2017-06-07 09:18:31,-76756.42,-2.91038304567337e-11
"549",2017-06-07 09:36:08,58404.81,58404.81
"550",2017-06-07 09:46:26,-58404.81,-2.91038304567337e-11
"551",2017-06-07 10:06:16,13347.77,13347.77
"552",2017-06-07 10:34:02,-13347.77,-2.91038304567337e-11
"553",2017-06-07 13:00:44,19692.77,19692.77
"554",2017-06-07 13:18:07,-19692.77,-2.91038304567337e-11
"555",2017-06-07 13:59:54,21521.79,21521.79
"556",2017-06-07 14:06:02,-21521.79,-2.91038304567337e-11
"557",2017-06-07 14:54:35,69507.96,69507.96
"558",2017-06-07 15:04:21,-69507.96,-2.91038304567337e-11
"559",2017-06-07 16:04:20,87893.72,87893.72
"560",2017-06-07 16:04:20,26487.67,114381.39
"561",2017-06-07 16:04:57,-114381.39,-2.91038304567337e-11
"562",2017-06-07 16:31:10,18704.78,18704.78
"563",2017-06-07 16:35:15,-18704.78,-2.91038304567337e-11
"564",2017-06-07 17:17:30,26886.55,26886.55
"565",2017-06-07 17:31:03,-26886.55,-2.91038304567337e-11
"566",2017-06-07 18:12:40,3880.62,3880.61999999997
"567",2017-06-07 18:15:25,-3880.62,-2.91038304567337e-11
"568",2017-06-07 19:37:28,15757.27,15757.27
"569",2017-06-07 19:50:26,-15757.27,-2.91038304567337e-11
"570",2017-06-07 21:04:31,18558.44,18558.44
"571",2017-06-07 21:07:42,-18558.44,-2.91038304567337e-11
"572",2017-06-07 22:32:40,81874.92,81874.92
"573",2017-06-07 22:56:07,73392.43,155267.35
"574",2017-06-07 22:56:07,-81874.92,73392.43
"575",2017-06-07 23:01:54,-73392.43,-1.45519152283669e-11
"576",2017-06-07 23:03:09,55241.39,55241.39
"577",2017-06-07 23:18:17,100819.32,156060.71
"578",2017-06-07 23:18:17,-55241.39,100819.32
"579",2017-06-07 23:24:40,-100819.32,-1.45519152283669e-11
"580",2017-06-08 00:04:34,64516.82,64516.82
"581",2017-06-08 00:12:18,-64516.82,-1.45519152283669e-11
"582",2017-06-08 00:21:48,13984.01,13984.01
"583",2017-06-08 00:29:25,-13984.01,-1.45519152283669e-11
"584",2017-06-08 00:32:17,73704.93,73704.93
"585",2017-06-08 00:34:06,-73704.93,-1.45519152283669e-11
"586",2017-06-08 01:21:06,75337.06,75337.06
"587",2017-06-08 01:33:48,-75337.06,-1.45519152283669e-11
"588",2017-06-08 01:48:16,56690.43,56690.43
"589",2017-06-08 02:01:45,-56690.43,-1.45519152283669e-11
"590",2017-06-08 09:43:58,60286.74,60286.74
"591",2017-06-08 09:43:58,61910.21,122196.95
"592",2017-06-08 09:45:31,63348.76,185545.71
"593",2017-06-08 22:16:01,-185545.71,0
"594",2017-06-09 01:24:04,23196.07,23196.07
"595",2017-06-09 01:31:00,-23196.07,0
"596",2017-06-09 03:04:08,66505.9,66505.9
"597",2017-06-09 03:20:25,-66505.9,0
"598",2017-06-09 06:43:29,12047.02,12047.02
"599",2017-06-09 06:48:41,-12047.02,0
"600",2017-06-09 07:11:45,64090.9,64090.9
"601",2017-06-09 07:25:20,-64090.9,0
"602",2017-06-09 09:28:29,69366.87,69366.87
"603",2017-06-09 09:32:34,-69366.87,0
"604",2017-06-09 10:17:16,58671.71,58671.71
"605",2017-06-09 10:31:36,-58671.71,0
"606",2017-06-09 11:43:15,56909.42,56909.42
"607",2017-06-09 11:46:28,-56909.42,0
"608",2017-06-09 14:00:05,76177.19,76177.19
"609",2017-06-09 14:10:01,-76177.19,0
"610",2017-06-09 14:21:47,66509.63,66509.63
"611",2017-06-09 14:34:56,-66509.63,0
"612",2017-06-09 15:29:42,16378.78,16378.78
"613",2017-06-09 15:33:23,-16378.78,0
"614",2017-06-09 15:40:51,70830.96,70830.96
"615",2017-06-09 15:43:33,-70830.96,0
"616",2017-06-09 17:15:34,69762.59,69762.59
"617",2017-06-09 17:26:25,-69762.59,0
"618",2017-06-09 19:11:59,70958.89,70958.89
"619",2017-06-09 19:33:41,-70958.89,0
"620",2017-06-09 21:12:30,84324.33,84324.33
"621",2017-06-09 21:24:11,-84324.33,0
"622",2017-06-09 22:14:32,65404.24,65404.24
"623",2017-06-09 22:26:33,-65404.24,0
"624",2017-06-09 23:18:43,63313.97,63313.97
"625",2017-06-09 23:26:32,-63313.97,0
"626",2017-06-09 23:50:54,18534.19,18534.19
"627",2017-06-09 23:57:00,-18534.19,0
"628",2017-06-09 23:57:00,57558.34,57558.34
"629",2017-06-10 00:17:43,-57558.34,0
"630",2017-06-10 01:53:50,58389.03,58389.03
"631",2017-06-10 02:09:09,-58389.03,0
"632",2017-06-10 02:53:43,66174.76,66174.76
"633",2017-06-10 02:58:03,-66174.76,0
"634",2017-06-10 03:41:41,75983.17,75983.17
"635",2017-06-10 04:13:33,-75983.17,0
"636",2017-06-10 05:12:23,58746.17,58746.17
"637",2017-06-10 05:16:01,-58746.17,0
"638",2017-06-10 06:18:41,84665.31,84665.31
"639",2017-06-10 06:51:24,-84665.31,0
"640",2017-06-10 07:13:07,58335.6,58335.6
"641",2017-06-10 08:22:54,-58335.6,0
"642",2017-06-10 08:47:00,23957.95,23957.95
"643",2017-06-10 09:00:49,-23957.95,0
"644",2017-06-10 11:02:25,70655.05,70655.05
"645",2017-06-10 11:09:21,-70655.05,0
"646",2017-06-10 11:48:23,77456.63,77456.63
"647",2017-06-10 11:50:28,-77456.63,0
"648",2017-06-10 12:28:16,70950.18,70950.18
"649",2017-06-10 13:07:19,-70950.18,0
"650",2017-06-10 13:41:54,71229.78,71229.78
"651",2017-06-10 13:41:54,86954.01,158183.79
"652",2017-06-10 13:53:49,-158183.79,-2.91038304567337e-11
"653",2017-06-10 14:35:26,67735.14,67735.14
"654",2017-06-10 14:42:07,-67735.14,-2.91038304567337e-11
"655",2017-06-10 17:42:48,123459.56,123459.56
"656",2017-06-10 17:48:13,-123459.56,-2.91038304567337e-11
"657",2017-06-10 20:22:01,7617.55,7617.54999999997
"658",2017-06-10 20:22:01,7921.07,15538.62
"659",2017-06-10 20:29:58,-15538.62,-3.09228198602796e-11
"660",2017-06-10 20:42:22,60442.83,60442.83
"661",2017-06-10 20:54:56,-60442.83,-2.91038304567337e-11
"662",2017-06-10 21:29:06,70255.33,70255.33
"663",2017-06-10 21:58:34,-70255.33,-2.91038304567337e-11
"664",2017-06-10 23:10:12,102553.76,102553.76
"665",2017-06-10 23:19:54,-102553.76,-2.91038304567337e-11
"666",2017-06-10 23:46:54,81525.36,81525.36
"667",2017-06-10 23:52:46,-81525.36,-2.91038304567337e-11
"668",2017-06-11 00:20:18,14948.35,14948.35
"669",2017-06-11 00:33:22,-14948.35,-2.91038304567337e-11
"670",2017-06-11 01:21:56,58400.6,58400.6
"671",2017-06-11 01:43:09,-58400.6,-2.91038304567337e-11
"672",2017-06-11 04:42:20,71658.47,71658.47
"673",2017-06-11 06:35:28,-71658.47,-2.91038304567337e-11
"674",2017-06-11 07:28:23,77196.57,77196.57
"675",2017-06-11 07:41:22,-77196.57,-2.91038304567337e-11
"676",2017-06-11 08:31:28,65740.82,65740.82
"677",2017-06-11 08:35:38,-65740.82,-2.91038304567337e-11
"678",2017-06-11 09:18:04,15022.44,15022.44
"679",2017-06-11 09:26:42,-15022.44,-2.91038304567337e-11
"680",2017-06-11 09:36:30,83820.93,83820.93
"681",2017-06-11 09:52:20,-83820.93,-2.91038304567337e-11
"682",2017-06-11 10:51:46,129019.16,129019.16
"683",2017-06-11 10:56:04,-129019.16,-2.91038304567337e-11
"684",2017-06-11 11:18:50,65110.44,65110.44
"685",2017-06-11 11:21:04,-65110.44,-2.91038304567337e-11
"686",2017-06-11 11:43:40,17927.47,17927.47
"687",2017-06-11 11:56:21,-17927.47,-2.91038304567337e-11
"688",2017-06-11 14:18:28,83276.96,83276.96
"689",2017-06-11 14:23:51,-83276.96,-2.91038304567337e-11
"690",2017-06-11 15:38:02,91166.68,91166.68
"691",2017-06-11 15:41:37,67846.59,159013.27
"692",2017-06-11 15:41:37,-91166.68,67846.59
"693",2017-06-11 16:03:04,65619.47,133466.06
"694",2017-06-11 16:03:04,75823.17,209289.23
"695",2017-06-11 16:03:04,-67846.59,141442.64
"696",2017-06-11 16:09:13,-141442.64,-2.91038304567337e-11
"697",2017-06-11 16:30:03,97467.03,97467.03
"698",2017-06-11 16:45:45,75398.32,172865.35
"699",2017-06-11 16:45:45,-97467.03,75398.32
"700",2017-06-11 16:56:43,-75398.32,-2.91038304567337e-11
"701",2017-06-11 18:22:00,70059.33,70059.33
"702",2017-06-11 18:34:49,9057.14,79116.47
"703",2017-06-11 18:34:49,-70059.33,9057.13999999997
"704",2017-06-11 18:38:37,-9057.14,-2.91038304567337e-11
"705",2017-06-11 21:20:40,93839.9,93839.9
"706",2017-06-11 21:25:30,-93839.9,-2.91038304567337e-11
"707",2017-06-11 21:30:07,80473.94,80473.94
"708",2017-06-11 21:42:59,-80473.94,-2.91038304567337e-11
"709",2017-06-11 21:58:57,12925.8,12925.8
"710",2017-06-11 22:25:36,-12925.8,-2.91038304567337e-11
"711",2017-06-12 07:03:01,127428.86,127428.86
"712",2017-06-12 07:10:21,-127428.86,-2.91038304567337e-11
"713",2017-06-12 07:31:31,122486.16,122486.16
"714",2017-06-12 07:51:44,-122486.16,-2.91038304567337e-11
"715",2017-06-12 09:08:18,60742.29,60742.29
"716",2017-06-12 09:25:15,-60742.29,-2.91038304567337e-11
"717",2017-06-12 10:14:01,12463.31,12463.31
"718",2017-06-12 10:15:55,-12463.31,-2.91038304567337e-11
"719",2017-06-12 10:36:38,4813.49,4813.48999999997
"720",2017-06-12 10:40:33,-4813.49,-2.91038304567337e-11
"721",2017-06-12 11:16:24,67926.65,67926.65
"722",2017-06-12 11:16:24,22268.57,90195.22
"723",2017-06-12 11:30:05,-90195.22,-2.91038304567337e-11
"724",2017-06-12 11:39:17,84278.04,84278.04
"725",2017-06-12 11:54:36,91194.79,175472.83
"726",2017-06-12 11:54:36,-84278.04,91194.79
"727",2017-06-12 12:06:46,-91194.79,-2.91038304567337e-11
"728",2017-06-12 12:20:21,93249.85,93249.85
"729",2017-06-12 12:31:18,-93249.85,-2.91038304567337e-11
"730",2017-06-12 12:51:45,61861.71,61861.71
"731",2017-06-12 12:56:50,-61861.71,-2.91038304567337e-11
"732",2017-06-12 13:11:21,5889.77,5889.76999999997
"733",2017-06-12 13:22:45,-5889.77,-2.91038304567337e-11
"734",2017-06-12 13:38:43,10815.43,10815.43
"735",2017-06-12 13:55:18,-10815.43,-2.91038304567337e-11
"736",2017-06-12 14:36:00,63111.46,63111.46
"737",2017-06-12 14:54:26,-63111.46,-2.91038304567337e-11
"738",2017-06-12 15:26:44,9128.62,9128.61999999997
"739",2017-06-12 15:41:16,59873.55,69002.17
"740",2017-06-12 15:41:16,-9128.62,59873.55
"741",2017-06-12 15:50:16,6279.65,66153.2
"742",2017-06-12 15:50:16,-59873.55,6279.64999999997
"743",2017-06-12 15:54:27,-6279.65,-3.45607986673713e-11
"744",2017-06-12 17:07:33,129762.07,129762.07
"745",2017-06-12 17:18:51,70088.02,199850.09
"746",2017-06-12 17:18:51,-129762.07,70088.02
"747",2017-06-12 17:34:04,-70088.02,-4.36557456851006e-11
"748",2017-06-12 18:16:12,93410.6,93410.6
"749",2017-06-12 18:16:12,82718.69,176129.29
"750",2017-06-12 18:24:05,-176129.29,-2.91038304567337e-11
"751",2017-06-12 19:38:21,100049.2,100049.2
"752",2017-06-12 19:43:55,-100049.2,-2.91038304567337e-11
"753",2017-06-12 20:22:41,60152.59,60152.59
"754",2017-06-12 20:22:41,67086.17,127238.76
"755",2017-06-12 20:43:56,-127238.76,-2.91038304567337e-11
"756",2017-06-12 20:43:56,21010.22,21010.22
"757",2017-06-12 21:00:03,-21010.22,-2.91038304567337e-11
"758",2017-06-12 22:42:29,95142.46,95142.46
"759",2017-06-12 22:46:09,-95142.46,-2.91038304567337e-11
"760",2017-06-12 23:11:18,50292.52,50292.52
"761",2017-06-12 23:24:14,-50292.52,-2.91038304567337e-11
"762",2017-06-13 00:25:15,59399.13,59399.13
"763",2017-06-13 00:36:54,-59399.13,-2.91038304567337e-11
"764",2017-06-13 01:46:24,77094.94,77094.94
"765",2017-06-13 01:48:08,-77094.94,-2.91038304567337e-11
"766",2017-06-13 08:07:14,51626.92,51626.92
"767",2017-06-13 08:07:14,68548.12,120175.04
"768",2017-06-13 08:20:59,-120175.04,-2.91038304567337e-11
"769",2017-06-13 08:20:59,63564.19,63564.19
"770",2017-06-13 08:28:36,-63564.19,-2.91038304567337e-11
"771",2017-06-13 10:41:01,71519.79,71519.79
"772",2017-06-13 10:41:01,26974.63,98494.42
"773",2017-06-13 11:00:01,-98494.42,-2.91038304567337e-11
"774",2017-06-13 12:09:31,71783.43,71783.43
"775",2017-06-13 12:23:09,-71783.43,-2.91038304567337e-11
"776",2017-06-13 13:31:41,3732.17,3732.16999999997
"777",2017-06-13 13:47:39,-3732.17,-2.91038304567337e-11
"778",2017-06-13 18:23:10,62133.21,62133.21
"779",2017-06-13 18:25:47,-62133.21,-2.91038304567337e-11
"780",2017-06-14 03:50:03,77822.09,77822.09
"781",2017-06-14 04:24:13,-77822.09,-2.91038304567337e-11
"782",2017-06-14 06:23:50,77822.18,77822.18
"783",2017-06-14 06:39:13,-77822.18,-2.91038304567337e-11
"784",2017-06-14 08:22:26,125210.61,125210.61
"785",2017-06-14 08:34:31,-125210.61,-2.91038304567337e-11
"786",2017-06-14 08:55:19,86067.27,86067.27
"787",2017-06-14 09:32:40,-86067.27,-2.91038304567337e-11
"788",2017-06-14 10:48:36,67468.75,67468.75
"789",2017-06-14 10:55:38,-67468.75,-2.91038304567337e-11
"790",2017-06-14 12:37:26,97782.75,97782.75
"791",2017-06-14 12:53:06,-97782.75,-2.91038304567337e-11
"792",2017-06-14 14:24:35,62685.56,62685.56
"793",2017-06-14 14:31:48,-62685.56,-2.91038304567337e-11
"794",2017-06-14 15:40:52,76600.72,76600.72
"795",2017-06-14 15:51:40,-76600.72,-2.91038304567337e-11
"796",2017-06-14 16:52:21,89759.05,89759.05
"797",2017-06-14 16:59:35,-89759.05,-2.91038304567337e-11
"798",2017-06-14 16:59:35,10848.69,10848.69
"799",2017-06-14 17:03:51,-10848.69,-2.91038304567337e-11
"800",2017-06-14 17:10:25,70045.69,70045.69
"801",2017-06-14 17:10:25,77674.08,147719.77
"802",2017-06-14 17:13:54,77695.84,225415.61
"803",2017-06-14 17:13:54,-147719.77,77695.84
"804",2017-06-14 17:41:24,-77695.84,-2.91038304567337e-11
"805",2017-06-14 17:59:13,61685.36,61685.36
"806",2017-06-14 18:11:57,-61685.36,-2.91038304567337e-11
"807",2017-06-14 18:38:42,4050.23,4050.22999999997
"808",2017-06-14 18:49:10,95297.92,99348.15
"809",2017-06-14 18:49:10,-4050.23,95297.92
"810",2017-06-14 18:54:27,-95297.92,-2.91038304567337e-11
"811",2017-06-14 19:11:31,74167.29,74167.29
"812",2017-06-14 19:22:36,-74167.29,-2.91038304567337e-11
"813",2017-06-14 20:22:31,60318.41,60318.41
"814",2017-06-14 20:32:02,57181.57,117499.98
"815",2017-06-14 20:32:02,-60318.41,57181.57
"816",2017-06-14 20:40:07,-57181.57,-2.18278728425503e-11
"817",2017-06-14 21:13:15,13296.43,13296.43
"818",2017-06-14 21:25:18,-13296.43,-2.18278728425503e-11
"819",2017-06-14 22:09:57,7998.17,7998.16999999998
"820",2017-06-14 22:12:33,-7998.17,-2.18278728425503e-11
"821",2017-06-14 22:12:33,56190.38,56190.38
"822",2017-06-14 22:32:51,106055.33,162245.71
"823",2017-06-14 22:32:51,-56190.38,106055.33
"824",2017-06-14 22:45:46,-106055.33,-4.36557456851006e-11
"825",2017-06-14 22:56:08,69630.7,69630.7
"826",2017-06-14 23:22:12,187670.84,257301.54
"827",2017-06-14 23:22:12,-69630.7,187670.84
"828",2017-06-14 23:46:01,-187670.84,-2.91038304567337e-11
"829",2017-06-15 00:18:40,50649.44,50649.44
"830",2017-06-15 00:24:50,-50649.44,-2.91038304567337e-11
"831",2017-06-15 01:01:08,77823.52,77823.52
"832",2017-06-15 01:01:08,80046.57,157870.09
"833",2017-06-15 01:25:46,-157870.09,-2.91038304567337e-11
"834",2017-06-15 02:12:22,60791.44,60791.44
"835",2017-06-15 02:12:22,10728.75,71520.19
"836",2017-06-15 02:16:38,57479.41,128999.6
"837",2017-06-15 02:16:38,-71520.19,57479.41
"838",2017-06-15 02:31:30,-57479.41,-2.91038304567337e-11
"839",2017-06-15 02:59:28,19522.32,19522.32
"840",2017-06-15 03:05:57,-19522.32,-2.91038304567337e-11
"841",2017-06-15 03:27:10,76848.96,76848.96
"842",2017-06-15 03:30:33,-76848.96,-2.91038304567337e-11
"843",2017-06-15 03:41:24,83103,83103
"844",2017-06-15 03:55:49,-83103,-2.91038304567337e-11
"845",2017-06-15 04:23:09,70338.67,70338.67
"846",2017-06-15 04:26:36,-70338.67,-2.91038304567337e-11
"847",2017-06-15 04:54:07,22092.17,22092.17
"848",2017-06-15 04:57:22,-22092.17,-2.91038304567337e-11
"849",2017-06-15 05:34:00,60095.32,60095.32
"850",2017-06-15 05:34:00,6338.38,66433.7
"851",2017-06-15 06:02:57,-66433.7,-2.91038304567337e-11
"852",2017-06-15 06:13:27,115822.89,115822.89
"853",2017-06-15 06:15:24,-115822.89,-2.91038304567337e-11
"854",2017-06-15 06:34:14,5658.04,5658.03999999997
"855",2017-06-15 06:46:17,-5658.04,-2.91038304567337e-11
"856",2017-06-15 07:30:40,77759.34,77759.34
"857",2017-06-15 07:31:45,-77759.34,-2.91038304567337e-11
"858",2017-06-15 08:16:45,166650.2,166650.2
"859",2017-06-15 08:23:27,-166650.2,-2.91038304567337e-11
"860",2017-06-15 09:06:37,61558.85,61558.85
"861",2017-06-15 09:23:52,66311.99,127870.84
"862",2017-06-15 09:23:52,-61558.85,66311.99
"863",2017-06-15 09:30:19,-66311.99,-4.36557456851006e-11
"864",2017-06-15 09:39:21,75083.24,75083.24
"865",2017-06-15 10:07:08,-75083.24,-4.36557456851006e-11
"866",2017-06-15 10:49:14,56909.83,56909.83
"867",2017-06-15 10:53:39,-56909.83,-4.36557456851006e-11
"868",2017-06-15 11:25:52,62243.55,62243.55
"869",2017-06-15 11:25:52,77824.56,140068.11
"870",2017-06-15 11:25:52,67513.4,207581.51
"871",2017-06-15 13:19:25,88936.55,296518.06
"872",2017-06-15 13:49:04,77825.59,374343.65
"873",2017-06-15 14:38:01,-207581.51,166762.14
"874",2017-06-15 14:57:03,-166762.14,-1.16415321826935e-10
"875",2017-06-15 15:18:05,3557.38,3557.37999999988
"876",2017-06-15 15:18:05,4330.99,7888.36999999988
"877",2017-06-15 15:22:24,-7888.37,-1.16415321826935e-10
"878",2017-06-15 15:37:36,4605.46,4605.45999999988
"879",2017-06-15 15:39:29,102381.79,106987.25
"880",2017-06-15 15:39:29,-4605.46,102381.79
"881",2017-06-15 15:48:57,-102381.79,-1.16415321826935e-10
"882",2017-06-15 16:14:34,66164.45,66164.4499999999
"883",2017-06-15 16:14:34,39837.34,106001.79
"884",2017-06-15 16:21:44,-106001.79,-1.16415321826935e-10
"885",2017-06-15 16:47:38,77632.73,77632.7299999999
"886",2017-06-15 16:53:27,-77632.73,-1.16415321826935e-10
"887",2017-06-15 17:17:11,94101.81,94101.8099999999
"888",2017-06-15 17:24:18,-94101.81,-1.16415321826935e-10
"889",2017-06-15 18:42:21,110194.53,110194.53
"890",2017-06-15 18:59:14,69329.11,179523.64
"891",2017-06-15 18:59:14,-110194.53,69329.1099999999
"892",2017-06-15 19:32:24,100049.83,169378.94
"893",2017-06-15 19:32:24,-69329.11,100049.83
"894",2017-06-15 19:39:23,-100049.83,-1.16415321826935e-10
"895",2017-06-15 19:52:06,94912.74,94912.7399999999
"896",2017-06-15 19:57:08,-94912.74,-1.16415321826935e-10
"897",2017-06-15 20:41:44,102575.75,102575.75
"898",2017-06-15 20:59:33,-102575.75,-1.16415321826935e-10
"899",2017-06-15 21:43:42,86784.16,86784.1599999999
"900",2017-06-15 21:48:21,-86784.16,-1.16415321826935e-10
"901",2017-06-15 22:13:21,90076.3,90076.2999999999
"902",2017-06-15 22:20:54,-90076.3,-1.16415321826935e-10
"903",2017-06-15 23:10:27,134065.31,134065.31
"904",2017-06-15 23:13:34,-134065.31,-1.16415321826935e-10
"905",2017-06-15 23:19:09,16846.57,16846.5699999999
"906",2017-06-15 23:30:36,-16846.57,-1.16415321826935e-10
"907",2017-06-16 00:55:00,55406.46,55406.4599999999
"908",2017-06-16 01:35:46,-55406.46,-1.16415321826935e-10
"909",2017-06-16 02:36:27,67443.99,67443.9899999999
"910",2017-06-16 03:08:15,-67443.99,-1.16415321826935e-10
"911",2017-06-16 03:22:29,95841.71,95841.7099999999
"912",2017-06-16 04:41:08,-95841.71,-1.16415321826935e-10
"913",2017-06-16 05:21:41,68627.79,68627.7899999999
"914",2017-06-16 05:29:57,-68627.79,-1.16415321826935e-10
"915",2017-06-16 05:49:11,8868.1,8868.09999999988
"916",2017-06-16 05:52:06,-8868.1,-1.16415321826935e-10
"917",2017-06-16 07:54:50,89453.48,89453.4799999999
"918",2017-06-16 08:17:04,-89453.48,-1.16415321826935e-10
"919",2017-06-16 09:00:10,15404.64,15404.6399999999
"920",2017-06-16 09:04:46,72617.79,88022.4299999999
"921",2017-06-16 09:04:46,-15404.64,72617.7899999999
"922",2017-06-16 09:29:08,-72617.79,-1.16415321826935e-10
"923",2017-06-16 10:07:18,90988.45,90988.4499999999
"924",2017-06-16 10:15:25,-90988.45,-1.16415321826935e-10
"925",2017-06-16 10:33:57,69293.96,69293.9599999999
"926",2017-06-16 10:42:33,104198.14,173492.1
"927",2017-06-16 10:42:33,-69293.96,104198.14
"928",2017-06-16 11:02:37,99142.44,203340.58
"929",2017-06-16 11:02:37,-104198.14,99142.4399999999
"930",2017-06-16 11:11:35,-99142.44,-1.01863406598568e-10
"931",2017-06-16 11:45:26,74671.92,74671.9199999999
"932",2017-06-16 11:53:58,-74671.92,-1.01863406598568e-10
"933",2017-06-16 12:28:34,77652.81,77652.8099999999
"934",2017-06-16 12:34:46,-77652.81,-1.01863406598568e-10
"935",2017-06-16 12:54:32,66599.94,66599.9399999999
"936",2017-06-16 13:07:04,13921.92,80521.8599999999
"937",2017-06-16 13:07:04,-66599.94,13921.9199999999
"938",2017-06-16 13:24:25,3177.5,17099.4199999999
"939",2017-06-16 13:24:25,-13921.92,3177.4999999999
"940",2017-06-16 13:38:16,-3177.5,-1.03682396002114e-10
"941",2017-06-16 13:40:20,91241.04,91241.0399999999
"942",2017-06-16 13:54:33,-91241.04,-1.01863406598568e-10
"943",2017-06-16 14:19:48,67185.8,67185.7999999999
"944",2017-06-16 14:25:07,-67185.8,-1.01863406598568e-10
"945",2017-06-16 14:46:15,97539.01,97539.0099999999
"946",2017-06-16 14:59:43,-97539.01,-1.01863406598568e-10
"947",2017-06-16 15:46:26,8146.26,8146.2599999999
"948",2017-06-16 15:49:19,-8146.26,-1.01863406598568e-10
"949",2017-06-16 16:15:31,71796.44,71796.4399999999
"950",2017-06-16 16:18:35,-71796.44,-1.01863406598568e-10
"951",2017-06-16 18:16:50,106568.15,106568.15
"952",2017-06-16 18:20:56,-106568.15,-1.01863406598568e-10
"953",2017-06-16 18:29:08,94418.28,94418.2799999999
"954",2017-06-16 18:33:53,64393.05,158811.33
"955",2017-06-16 18:33:53,-94418.28,64393.0499999999
"956",2017-06-16 18:54:18,82335.76,146728.81
"957",2017-06-16 18:54:18,-64393.05,82335.7599999999
"958",2017-06-16 18:54:18,66311.3,148647.06
"959",2017-06-16 19:02:13,-148647.06,-1.16415321826935e-10
"960",2017-06-16 19:41:28,56858.57,56858.5699999999
"961",2017-06-16 19:41:28,69704.98,126563.55
"962",2017-06-16 19:45:08,-126563.55,-1.30967237055302e-10
"963",2017-06-16 19:50:56,117983.66,117983.66
"964",2017-06-16 19:54:48,70281.46,188265.12
"965",2017-06-16 19:54:48,-117983.66,70281.4599999999
"966",2017-06-16 20:03:36,126030.68,196312.14
"967",2017-06-16 20:03:36,-70281.46,126030.68
"968",2017-06-16 20:16:47,111360.23,237390.91
"969",2017-06-16 20:16:47,-126030.68,111360.23
"970",2017-06-16 20:24:13,90146.93,201507.16
"971",2017-06-16 20:24:13,-111360.23,90146.9299999999
"972",2017-06-16 20:34:48,102134.72,192281.65
"973",2017-06-16 20:34:48,-90146.93,102134.72
"974",2017-06-16 20:56:45,103329.8,205464.52
"975",2017-06-16 20:56:45,-102134.72,103329.8
"976",2017-06-16 21:17:08,82174.01,185503.81
"977",2017-06-16 21:17:08,-103329.8,82174.0099999998
"978",2017-06-16 21:25:04,-82174.01,-1.74622982740402e-10
"979",2017-06-16 21:29:34,74504.19,74504.1899999998
"980",2017-06-16 22:07:13,84717.79,159221.98
"981",2017-06-16 22:30:59,-74504.19,84717.7899999998
"982",2017-06-16 22:39:55,-84717.79,-1.89174897968769e-10
"983",2017-06-16 22:58:32,109964.72,109964.72
"984",2017-06-16 23:17:26,-109964.72,-1.89174897968769e-10
"985",2017-06-17 02:36:18,74601.9,74601.8999999998
"986",2017-06-17 02:44:15,-74601.9,-1.89174897968769e-10
"987",2017-06-17 02:53:39,78122.14,78122.1399999998
"988",2017-06-17 03:21:05,-78122.14,-1.89174897968769e-10
"989",2017-06-17 05:01:00,101034.79,101034.79
"990",2017-06-17 05:04:11,-101034.79,-1.89174897968769e-10
"991",2017-06-17 05:13:03,100302,100302
"992",2017-06-17 05:24:20,74851.13,175153.13
"993",2017-06-17 05:24:20,-100302,74851.1299999998
"994",2017-06-17 05:38:44,-74851.13,-1.74622982740402e-10
"995",2017-06-17 05:57:03,72524.36,72524.3599999998
"996",2017-06-17 05:57:03,12053.05,84577.4099999998
"997",2017-06-17 05:57:03,74582.65,159160.06
"998",2017-06-17 05:57:03,76119.99,235280.05
"999",2017-06-17 06:07:28,-235280.05,-1.74622982740402e-10
"1000",2017-06-17 06:21:32,61592.51,61592.5099999998
"1001",2017-06-17 06:34:46,-61592.51,-1.74622982740402e-10
"1002",2017-06-17 06:46:03,67593.37,67593.3699999998
"1003",2017-06-17 06:51:05,-67593.37,-1.74622982740402e-10
"1004",2017-06-17 11:42:27,12959.36,12959.3599999998
"1005",2017-06-17 11:44:59,-12959.36,-1.74622982740402e-10
"1006",2017-06-17 14:35:17,71202.28,71202.2799999998
"1007",2017-06-17 14:39:27,-71202.28,-1.74622982740402e-10
"1008",2017-06-17 21:19:18,68766.73,68766.7299999998
"1009",2017-06-17 21:40:20,-68766.73,-1.74622982740402e-10
"1010",2017-06-18 00:35:19,72181.79,72181.7899999998
"1011",2017-06-18 00:40:48,-72181.79,-1.74622982740402e-10
"1012",2017-06-18 06:22:52,62490.83,62490.8299999998
"1013",2017-06-18 06:40:07,-62490.83,-1.74622982740402e-10
"1014",2017-06-18 08:11:10,62988.01,62988.0099999998
"1015",2017-06-18 08:16:11,-62988.01,-1.74622982740402e-10
"1016",2017-06-18 08:48:11,163921.79,163921.79
"1017",2017-06-18 09:29:20,-163921.79,-1.74622982740402e-10
"1018",2017-06-18 12:27:26,77754.58,77754.5799999998
"1019",2017-06-18 12:27:26,71256.94,149011.52
"1020",2017-06-18 12:40:00,-149011.52,-1.45519152283669e-10
"1021",2017-06-18 12:51:12,90588.86,90588.8599999999
"1022",2017-06-18 13:05:29,-90588.86,-1.45519152283669e-10
"1023",2017-06-18 14:05:34,94219.89,94219.8899999999
"1024",2017-06-18 14:14:34,-94219.89,-1.45519152283669e-10
"1025",2017-06-18 15:44:54,10290.76,10290.7599999999
"1026",2017-06-18 16:32:44,73099.67,83390.4299999998
"1027",2017-06-18 16:32:44,-10290.76,73099.6699999999
"1028",2017-06-18 17:48:34,-73099.67,-1.45519152283669e-10
"1029",2017-06-18 19:47:26,66169.25,66169.2499999999
"1030",2017-06-18 19:50:20,-66169.25,-1.45519152283669e-10
"1031",2017-06-18 20:20:58,21771.21,21771.2099999999
"1032",2017-06-18 20:24:15,-21771.21,-1.45519152283669e-10
"1033",2017-06-18 20:35:45,62855.31,62855.3099999999
"1034",2017-06-18 20:42:22,-62855.31,-1.45519152283669e-10
"1035",2017-06-18 21:07:51,68906.37,68906.3699999998
"1036",2017-06-18 21:10:48,-68906.37,-1.45519152283669e-10
"1037",2017-06-18 22:10:50,110148.38,110148.38
"1038",2017-06-18 22:18:11,-110148.38,-1.45519152283669e-10
"1039",2017-06-18 22:59:47,12582.77,12582.7699999999
"1040",2017-06-18 23:11:49,-12582.77,-1.45519152283669e-10
"1041",2017-06-18 23:57:03,70459.5,70459.4999999999
"1042",2017-06-18 23:59:17,-70459.5,-1.45519152283669e-10
"1043",2017-06-19 00:48:33,17947.65,17947.6499999999
"1044",2017-06-19 01:10:44,-17947.65,-1.45519152283669e-10
"1045",2017-06-19 05:57:56,66846.99,66846.9899999999
"1046",2017-06-19 06:07:40,-66846.99,-1.45519152283669e-10
"1047",2017-06-19 12:36:08,70686.54,70686.5399999998
"1048",2017-06-19 13:07:11,-70686.54,-1.45519152283669e-10
"1049",2017-06-20 00:55:40,73670.63,73670.6299999999
"1050",2017-06-20 01:05:56,-73670.63,-1.45519152283669e-10
"1051",2017-06-20 03:10:48,71341.14,71341.1399999999
"1052",2017-06-20 03:12:08,-71341.14,-1.45519152283669e-10
"1053",2017-06-20 15:28:29,21331.57,21331.5699999999
"1054",2017-06-20 15:42:39,-21331.57,-1.45519152283669e-10
"1055",2017-06-20 16:17:24,87236.44,87236.4399999999
"1056",2017-06-20 17:21:59,-87236.44,-1.45519152283669e-10
"1057",2017-06-20 20:19:43,92635.89,92635.8899999999
"1058",2017-06-20 20:23:04,-92635.89,-1.45519152283669e-10
"1059",2017-06-20 22:43:04,71922.05,71922.0499999999
"1060",2017-06-20 22:46:05,-71922.05,-1.45519152283669e-10
"1061",2017-06-21 03:32:54,67113.45,67113.4499999999
"1062",2017-06-21 03:32:54,72505.51,139618.96
"1063",2017-06-21 03:38:24,-139618.96,-1.45519152283669e-10
"1064",2017-06-21 07:42:11,109503.2,109503.2
"1065",2017-06-21 07:56:09,-109503.2,-1.45519152283669e-10
"1066",2017-06-21 15:46:56,78287.59,78287.5899999999
"1067",2017-06-21 15:53:27,-78287.59,-1.45519152283669e-10
"1068",2017-06-21 22:33:22,77833.11,77833.1099999999
"1069",2017-06-21 22:44:22,-77833.11,-1.45519152283669e-10
"1070",2017-06-21 22:44:22,126528.02,126528.02
"1071",2017-06-21 22:44:22,82697.72,209225.74
"1072",2017-06-21 23:15:07,-209225.74,-1.16415321826935e-10
"1073",2017-06-21 23:16:04,87057.15,87057.1499999999
"1074",2017-06-21 23:29:27,-87057.15,-1.16415321826935e-10
"1075",2017-06-22 00:15:33,73143.21,73143.2099999999
"1076",2017-06-22 00:31:09,-73143.21,-1.16415321826935e-10
"1077",2017-06-22 02:46:07,15979.41,15979.4099999999
"1078",2017-06-22 02:48:57,-15979.41,-1.16415321826935e-10
"1079",2017-06-22 04:05:31,68911.86,68911.8599999999
"1080",2017-06-22 04:27:53,-68911.86,-1.16415321826935e-10
"1081",2017-06-22 05:53:16,5467.83,5467.82999999988
"1082",2017-06-22 05:53:16,14911.34,20379.1699999999
"1083",2017-06-22 06:04:16,-20379.17,-1.16415321826935e-10
"1084",2017-06-22 06:14:50,82559.8,82559.7999999999
"1085",2017-06-22 06:14:50,89773.26,172333.06
"1086",2017-06-22 07:04:39,101003.29,273336.35
"1087",2017-06-22 07:04:39,-172333.06,101003.29
"1088",2017-06-22 07:12:53,-101003.29,-1.30967237055302e-10
"1089",2017-06-22 10:28:44,16829.71,16829.7099999999
"1090",2017-06-22 10:31:34,-16829.71,-1.30967237055302e-10
"1091",2017-06-22 13:35:57,12836.61,12836.6099999999
"1092",2017-06-22 14:03:21,-12836.61,-1.30967237055302e-10
"1093",2017-06-22 21:35:38,81703.32,81703.3199999999
"1094",2017-06-22 21:53:38,-81703.32,-1.30967237055302e-10
"1095",2017-06-22 23:28:53,76060.2,76060.1999999999
"1096",2017-06-22 23:35:25,-76060.2,-1.30967237055302e-10
"1097",2017-06-23 02:13:03,85873.45,85873.4499999999
"1098",2017-06-23 02:26:06,88634.01,174507.46
"1099",2017-06-23 02:26:06,-85873.45,88634.0099999998
"1100",2017-06-23 02:29:51,-88634.01,-1.45519152283669e-10
"1101",2017-06-23 02:55:17,19649.31,19649.3099999999
"1102",2017-06-23 02:56:58,-19649.31,-1.45519152283669e-10
"1103",2017-06-23 03:15:48,82927.52,82927.5199999999
"1104",2017-06-23 03:21:54,-82927.52,-1.45519152283669e-10
"1105",2017-06-23 04:08:24,101988.54,101988.54
"1106",2017-06-23 04:29:40,-101988.54,-1.45519152283669e-10
"1107",2017-06-23 04:31:43,88039.52,88039.5199999999
"1108",2017-06-23 04:36:37,-88039.52,-1.45519152283669e-10
"1109",2017-06-23 05:07:46,92632.22,92632.2199999999
"1110",2017-06-23 05:15:26,-92632.22,-1.45519152283669e-10
"1111",2017-06-23 07:11:12,20374.88,20374.8799999999
"1112",2017-06-23 07:15:24,-20374.88,-1.45519152283669e-10
"1113",2017-06-23 08:26:51,104164.37,104164.37
"1114",2017-06-23 08:36:10,-104164.37,-1.45519152283669e-10
"1115",2017-06-23 10:02:37,15166.98,15166.9799999999
"1116",2017-06-23 10:24:38,-15166.98,-1.45519152283669e-10
"1117",2017-06-23 11:26:56,92026.4,92026.3999999998
"1118",2017-06-23 11:47:18,-92026.4,-1.45519152283669e-10
"1119",2017-06-23 13:31:54,74593.17,74593.1699999999
"1120",2017-06-23 13:53:30,-74593.17,-1.45519152283669e-10
"1121",2017-06-23 15:01:35,98456.12,98456.1199999998
"1122",2017-06-23 15:13:52,-98456.12,-1.45519152283669e-10
"1123",2017-06-23 18:22:46,84241.98,84241.9799999999
"1124",2017-06-23 18:25:48,-84241.98,-1.45519152283669e-10
"1125",2017-06-23 19:35:07,88298.52,88298.5199999999
"1126",2017-06-23 19:37:05,-88298.52,-1.45519152283669e-10
"1127",2017-06-23 20:55:28,19889.21,19889.2099999999
"1128",2017-06-23 21:03:44,-19889.21,-1.45519152283669e-10
"1129",2017-06-23 23:18:20,81058.24,81058.2399999999
"1130",2017-06-23 23:25:49,-81058.24,-1.45519152283669e-10
"1131",2017-06-24 01:51:28,34691.36,34691.3599999999
"1132",2017-06-24 01:53:25,-34691.36,-1.45519152283669e-10
"1133",2017-06-24 07:03:55,15485.27,15485.2699999999
"1134",2017-06-24 07:07:45,-15485.27,-1.45519152283669e-10
"1135",2017-06-24 09:44:52,38752.45,38752.4499999999
"1136",2017-06-24 10:06:17,-38752.45,-1.45519152283669e-10
"1137",2017-06-24 12:29:22,84772.63,84772.6299999999
"1138",2017-06-24 12:40:00,-84772.63,-1.45519152283669e-10
"1139",2017-06-24 13:44:15,82042.81,82042.8099999999
"1140",2017-06-24 14:05:11,-82042.81,-1.45519152283669e-10
"1141",2017-06-24 14:05:11,84438.86,84438.8599999999
"1142",2017-06-24 14:33:02,94129.76,178568.62
"1143",2017-06-24 14:33:02,-84438.86,94129.7599999998
"1144",2017-06-24 14:41:20,-94129.76,-1.45519152283669e-10
"1145",2017-06-24 14:49:12,89838.84,89838.8399999999
"1146",2017-06-24 15:09:34,-89838.84,-1.45519152283669e-10
"1147",2017-06-24 15:54:22,95228.51,95228.5099999998
"1148",2017-06-24 16:03:31,-95228.51,-1.45519152283669e-10
"1149",2017-06-24 16:41:23,20292.1,20292.0999999999
"1150",2017-06-24 17:26:15,-20292.1,-1.45519152283669e-10
"1151",2017-06-24 17:38:26,111869.71,111869.71
"1152",2017-06-24 17:38:26,85763.24,197632.95
"1153",2017-06-24 17:38:26,92532.44,290165.39
"1154",2017-06-24 17:41:23,-290165.39,-1.16415321826935e-10
"1155",2017-06-24 18:23:52,94060.27,94060.2699999999
"1156",2017-06-24 18:32:29,217201.01,311261.28
"1157",2017-06-24 18:32:29,-94060.27,217201.01
"1158",2017-06-24 18:58:57,78646.36,295847.37
"1159",2017-06-24 18:58:57,-217201.01,78646.3599999999
"1160",2017-06-24 19:06:07,-78646.36,-1.30967237055302e-10
"1161",2017-06-24 19:11:28,99447.13,99447.1299999999
"1162",2017-06-24 19:30:32,-99447.13,-1.30967237055302e-10
"1163",2017-06-24 22:33:27,285243.28,285243.28
"1164",2017-06-24 22:42:02,-285243.28,-1.16415321826935e-10
"1165",2017-06-24 23:26:18,105024.86,105024.86
"1166",2017-06-24 23:28:50,-105024.86,-1.16415321826935e-10
"1167",2017-06-25 00:02:09,79680.89,79680.8899999999
"1168",2017-06-25 00:06:59,-79680.89,-1.16415321826935e-10
"1169",2017-06-25 02:20:35,75830.31,75830.3099999999
"1170",2017-06-25 02:24:35,24301.48,100131.79
"1171",2017-06-25 02:24:35,-75830.31,24301.4799999999
"1172",2017-06-25 02:43:11,21340.61,45642.0899999999
"1173",2017-06-25 02:43:11,-24301.48,21340.6099999999
"1174",2017-06-25 03:15:43,-21340.61,-1.20053300634027e-10
"1175",2017-06-25 04:17:09,14647.23,14647.2299999999
"1176",2017-06-25 04:20:18,-14647.23,-1.20053300634027e-10
"1177",2017-06-25 04:46:31,75434.3,75434.2999999999
"1178",2017-06-25 05:11:16,-75434.3,-1.16415321826935e-10
"1179",2017-06-25 07:57:09,30027.71,30027.7099999999
"1180",2017-06-25 08:08:21,-30027.71,-1.16415321826935e-10
"1181",2017-06-25 08:51:04,23217.58,23217.5799999999
"1182",2017-06-25 09:20:00,-23217.58,-1.16415321826935e-10
"1183",2017-06-25 09:33:09,105973.72,105973.72
"1184",2017-06-25 09:35:24,-105973.72,-1.16415321826935e-10
"1185",2017-06-25 10:18:56,83960.89,83960.8899999999
"1186",2017-06-25 10:24:28,-83960.89,-1.16415321826935e-10
"1187",2017-06-25 10:46:49,103099.11,103099.11
"1188",2017-06-25 10:50:39,-103099.11,-1.16415321826935e-10
"1189",2017-06-25 11:21:37,93645.18,93645.1799999999
"1190",2017-06-25 18:26:02,-93645.18,-1.16415321826935e-10
"1191",2017-06-25 19:54:43,90333.25,90333.2499999999
"1192",2017-06-25 20:03:33,-90333.25,-1.16415321826935e-10
"1193",2017-06-25 20:11:16,96535.61,96535.6099999999
"1194",2017-06-25 20:19:21,-96535.61,-1.16415321826935e-10
"1195",2017-06-25 21:00:54,97282.97,97282.9699999999
"1196",2017-06-25 21:32:03,22781.8,120064.77
"1197",2017-06-25 21:50:31,-97282.97,22781.7999999999
"1198",2017-06-25 22:06:23,109410.29,132192.09
"1199",2017-06-25 22:06:23,-22781.8,109410.29
"1200",2017-06-25 22:16:59,97256.12,206666.41
"1201",2017-06-25 22:16:59,-109410.29,97256.1199999999
"1202",2017-06-25 22:21:03,-97256.12,-1.30967237055302e-10
"1203",2017-06-25 22:42:27,123548.66,123548.66
"1204",2017-06-25 22:42:27,99203.63,222752.29
"1205",2017-06-25 22:59:01,-222752.29,-1.45519152283669e-10
"1206",2017-06-25 23:56:13,22517.86,22517.8599999999
"1207",2017-06-26 00:12:01,-22517.86,-1.45519152283669e-10
"1208",2017-06-26 01:11:10,92475.09,92475.0899999999
"1209",2017-06-26 01:33:54,-92475.09,-1.45519152283669e-10
"1210",2017-06-26 01:33:54,85203.62,85203.6199999998
"1211",2017-06-26 01:48:36,-85203.62,-1.45519152283669e-10
"1212",2017-06-26 02:17:50,21671.98,21671.9799999999
"1213",2017-06-26 02:31:41,-21671.98,-1.45519152283669e-10
"1214",2017-06-26 03:13:28,83077.78,83077.7799999999
"1215",2017-06-26 03:21:09,-83077.78,-1.45519152283669e-10
"1216",2017-06-26 04:09:58,85480.5,85480.4999999999
"1217",2017-06-26 04:11:54,-85480.5,-1.45519152283669e-10
"1218",2017-06-26 08:12:49,328093.07,328093.07
"1219",2017-06-26 08:16:53,-328093.07,-1.74622982740402e-10
"1220",2017-06-26 08:24:59,143912.36,143912.36
"1221",2017-06-26 08:32:57,-143912.36,-1.74622982740402e-10
"1222",2017-06-26 08:52:59,77466.87,77466.8699999998
"1223",2017-06-26 09:38:33,-77466.87,-1.74622982740402e-10
"1224",2017-06-26 09:38:33,149743.92,149743.92
"1225",2017-06-26 09:38:33,101967.78,251711.7
"1226",2017-06-26 10:06:23,-251711.7,-1.74622982740402e-10
"1227",2017-06-26 10:06:23,79982.47,79982.4699999998
"1228",2017-06-26 10:16:59,-79982.47,-1.74622982740402e-10
"1229",2017-06-26 10:43:30,200062.52,200062.52
"1230",2017-06-26 10:43:30,113005.02,313067.54
"1231",2017-06-26 10:51:41,-313067.54,-1.74622982740402e-10
"1232",2017-06-26 11:16:41,217309.22,217309.22
"1233",2017-06-26 11:19:42,-217309.22,-1.74622982740402e-10
"1234",2017-06-26 15:59:33,331146.2,331146.2
"1235",2017-06-26 16:26:02,-331146.2,-1.74622982740402e-10
"1236",2017-06-26 17:17:44,339401.06,339401.06
"1237",2017-06-26 17:28:24,-339401.06,-1.74622982740402e-10
"1238",2017-06-26 17:39:24,177839.71,177839.71
"1239",2017-06-26 17:45:01,-177839.71,-1.74622982740402e-10
"1240",2017-06-26 20:20:14,247243.38,247243.38
"1241",2017-06-26 20:20:14,150063.06,397306.44
"1242",2017-06-26 20:45:27,-397306.44,-1.74622982740402e-10
"1243",2017-06-26 21:02:33,160154.09,160154.09
"1244",2017-06-26 21:02:33,170063.11,330217.2
"1245",2017-06-26 21:07:14,-330217.2,-1.74622982740402e-10
"1246",2017-06-26 22:22:49,164819.66,164819.66
"1247",2017-06-26 22:32:28,-164819.66,-1.74622982740402e-10
"1248",2017-06-26 22:41:20,84341.36,84341.3599999998
"1249",2017-06-26 22:46:20,-84341.36,-1.74622982740402e-10
"1250",2017-06-27 01:51:47,103015.28,103015.28
"1251",2017-06-27 01:54:55,-103015.28,-1.74622982740402e-10
"1252",2017-06-27 02:56:51,81545.36,81545.3599999998
"1253",2017-06-27 03:43:09,-81545.36,-1.74622982740402e-10
"1254",2017-06-27 05:33:03,112744.15,112744.15
"1255",2017-06-27 05:35:58,-112744.15,-1.74622982740402e-10
"1256",2017-06-27 06:58:26,160663.09,160663.09
"1257",2017-06-27 07:39:11,19600.16,180263.25
"1258",2017-06-27 07:39:11,-160663.09,19600.1599999998
"1259",2017-06-27 07:53:20,-19600.16,-1.70985003933311e-10
"1260",2017-06-27 07:55:15,134825.06,134825.06
"1261",2017-06-27 08:10:23,-134825.06,-1.74622982740402e-10
"1262",2017-06-27 08:31:17,102806.42,102806.42
"1263",2017-06-27 08:31:17,104299.29,207105.71
"1264",2017-06-27 08:33:34,-207105.71,-1.74622982740402e-10
"1265",2017-06-27 10:34:46,78942.08,78942.0799999998
"1266",2017-06-27 11:16:15,-78942.08,-1.74622982740402e-10
"1267",2017-06-27 12:40:00,309377.7,309377.7
"1268",2017-06-27 13:01:14,-309377.7,-1.74622982740402e-10
"1269",2017-06-27 13:44:20,153761.35,153761.35
"1270",2017-06-27 13:44:20,148780.24,302541.59
"1271",2017-06-27 14:01:08,-302541.59,-1.74622982740402e-10
"1272",2017-06-27 14:01:08,94340.52,94340.5199999998
"1273",2017-06-27 14:10:45,-94340.52,-1.74622982740402e-10
"1274",2017-06-27 14:24:48,115017.39,115017.39
"1275",2017-06-27 14:32:19,17359.01,132376.4
"1276",2017-06-27 14:32:19,-115017.39,17359.0099999998
"1277",2017-06-27 14:37:10,-17359.01,-1.78260961547494e-10
"1278",2017-06-27 14:54:35,144823.3,144823.3
"1279",2017-06-27 15:02:07,-144823.3,-1.74622982740402e-10
"1280",2017-06-27 15:41:35,169525.6,169525.6
"1281",2017-06-27 15:43:12,-169525.6,-1.74622982740402e-10
"1282",2017-06-27 16:05:38,16685.52,16685.5199999998
"1283",2017-06-27 16:09:15,-16685.52,-1.74622982740402e-10
"1284",2017-06-27 17:14:45,96032.38,96032.3799999998
"1285",2017-06-27 17:14:45,149885.41,245917.79
"1286",2017-06-27 17:22:47,-245917.79,-1.74622982740402e-10
"1287",2017-06-27 19:46:36,94328.34,94328.3399999998
"1288",2017-06-27 20:07:44,-94328.34,-1.74622982740402e-10
"1289",2017-06-27 21:52:43,108165.71,108165.71
"1290",2017-06-27 21:53:35,-108165.71,-1.74622982740402e-10
"1291",2017-06-27 22:37:49,93030.63,93030.6299999998
"1292",2017-06-27 22:42:56,-93030.63,-1.74622982740402e-10
"1293",2017-06-27 23:19:12,86140.06,86140.0599999998
"1294",2017-06-27 23:23:59,-86140.06,-1.74622982740402e-10
"1295",2017-06-28 00:03:22,18844.2,18844.1999999998
"1296",2017-06-28 00:10:51,84248.23,103092.43
"1297",2017-06-28 00:10:51,-18844.2,84248.2299999998
"1298",2017-06-28 00:15:45,-84248.23,-1.74622982740402e-10
"1299",2017-06-28 00:37:04,93810.13,93810.1299999998
"1300",2017-06-28 00:38:15,-93810.13,-1.74622982740402e-10
"1301",2017-06-28 01:24:16,84695.76,84695.7599999998
"1302",2017-06-28 01:24:16,99072.45,183768.21
"1303",2017-06-28 01:41:03,-183768.21,-1.74622982740402e-10
"1304",2017-06-28 01:59:59,142525.22,142525.22
"1305",2017-06-28 02:13:20,-142525.22,-1.74622982740402e-10
"1306",2017-06-28 05:45:13,90169.93,90169.9299999998
"1307",2017-06-28 05:55:37,-90169.93,-1.74622982740402e-10
"1308",2017-06-28 10:29:45,19303.66,19303.6599999998
"1309",2017-06-28 10:43:24,-19303.66,-1.74622982740402e-10
"1310",2017-06-28 10:55:45,89562.45,89562.4499999998
"1311",2017-06-28 10:57:56,-89562.45,-1.74622982740402e-10
"1312",2017-06-28 16:56:15,20397.03,20397.0299999998
"1313",2017-06-28 17:16:18,-20397.03,-1.74622982740402e-10
"1314",2017-06-28 17:16:18,105503.65,105503.65
"1315",2017-06-28 17:28:22,-105503.65,-1.74622982740402e-10
"1316",2017-06-28 20:04:47,119868.31,119868.31
"1317",2017-06-28 20:40:16,-119868.31,-1.74622982740402e-10
"1318",2017-06-28 23:06:32,20270.63,20270.6299999998
"1319",2017-06-28 23:15:32,-20270.63,-1.74622982740402e-10
"1320",2017-06-28 23:17:02,105105.15,105105.15
"1321",2017-06-28 23:24:27,-105105.15,-1.74622982740402e-10
"1322",2017-06-29 00:34:53,104813.58,104813.58
"1323",2017-06-29 00:42:53,-104813.58,-1.74622982740402e-10
"1324",2017-06-29 03:11:24,98968.71,98968.7099999998
"1325",2017-06-29 03:19:27,-98968.71,-1.74622982740402e-10
"1326",2017-06-29 04:09:38,86744.2,86744.1999999998
"1327",2017-06-29 04:54:24,-86744.2,-1.74622982740402e-10
"1328",2017-06-29 05:40:37,118314.84,118314.84
"1329",2017-06-29 05:43:59,-118314.84,-1.74622982740402e-10
"1330",2017-06-29 07:23:08,96624.59,96624.5899999998
"1331",2017-06-29 07:35:53,-96624.59,-1.74622982740402e-10
"1332",2017-06-29 08:47:11,88661.88,88661.8799999998
"1333",2017-06-29 08:58:38,-88661.88,-1.74622982740402e-10
"1334",2017-06-29 09:47:04,19154.02,19154.0199999998
"1335",2017-06-29 10:00:50,-19154.02,-1.74622982740402e-10
"1336",2017-06-29 10:00:50,119096.92,119096.92
"1337",2017-06-29 10:00:50,116355.09,235452.01
"1338",2017-06-29 10:14:37,-235452.01,-1.74622982740402e-10
"1339",2017-06-29 10:14:37,104948.43,104948.43
"1340",2017-06-29 10:21:27,-104948.43,-1.74622982740402e-10
"1341",2017-06-29 10:32:48,171170.27,171170.27
"1342",2017-06-29 10:32:48,194682.76,365853.03
"1343",2017-06-29 10:36:41,-365853.03,-2.3283064365387e-10
"1344",2017-06-29 11:45:01,315330.14,315330.14
"1345",2017-06-29 11:58:40,-315330.14,-2.3283064365387e-10
"1346",2017-06-29 12:18:04,353239.11,353239.11
"1347",2017-06-29 12:58:55,137843.36,491082.47
"1348",2017-06-29 12:58:55,-353239.11,137843.36
"1349",2017-06-29 13:12:43,-137843.36,-2.3283064365387e-10
"1350",2017-06-29 13:29:32,33156.8,33156.7999999998
"1351",2017-06-29 13:35:49,-33156.8,-2.3283064365387e-10
"1352",2017-06-29 14:47:54,90962.55,90962.5499999998
"1353",2017-06-29 15:35:58,-90962.55,-2.3283064365387e-10
"1354",2017-06-29 17:10:30,109961.43,109961.43
"1355",2017-06-29 17:12:33,-109961.43,-2.3283064365387e-10
"1356",2017-06-29 17:23:24,90982.02,90982.0199999998
"1357",2017-06-29 17:31:08,-90982.02,-2.3283064365387e-10
"1358",2017-06-29 18:46:45,25577.5,25577.4999999998
"1359",2017-06-29 18:54:10,-25577.5,-2.3283064365387e-10
"1360",2017-06-29 20:04:57,121693.69,121693.69
"1361",2017-06-29 20:45:44,-121693.69,-2.3283064365387e-10
"1362",2017-06-29 22:52:58,110502.97,110502.97
"1363",2017-06-29 23:29:30,-110502.97,-2.3283064365387e-10
"1364",2017-06-29 23:29:30,92784.03,92784.0299999998
"1365",2017-06-29 23:35:08,-92784.03,-2.3283064365387e-10
"1366",2017-06-30 00:11:53,107371.5,107371.5
"1367",2017-06-30 00:21:37,-107371.5,-2.3283064365387e-10
"1368",2017-06-30 03:42:18,90788.74,90788.7399999998
"1369",2017-06-30 03:49:37,-90788.74,-2.3283064365387e-10
"1370",2017-06-30 07:44:08,26849.56,26849.5599999998
"1371",2017-06-30 07:43:49,18217.66,45067.2199999998
"1372",2017-06-30 07:49:52,145506.28,190573.5
"1373",2017-06-30 07:49:52,-45067.22,145506.28
"1374",2017-06-30 08:10:27,108208.38,253714.66
"1375",2017-06-30 08:10:27,-145506.28,108208.38
"1376",2017-06-30 08:16:54,-108208.38,-2.3283064365387e-10
"1377",2017-06-30 10:08:38,91459.26,91459.2599999998
"1378",2017-06-30 10:12:49,-91459.26,-2.3283064365387e-10
"1379",2017-06-30 11:24:34,94222.48,94222.4799999998
"1380",2017-06-30 11:43:18,-94222.48,-2.3283064365387e-10
"1381",2017-06-30 11:43:18,146080.48,146080.48
"1382",2017-06-30 11:53:03,-146080.48,-2.3283064365387e-10
"1383",2017-06-30 14:50:58,24680.51,24680.5099999998
"1384",2017-06-30 15:07:48,-24680.51,-2.3283064365387e-10
"1385",2017-06-30 15:58:01,111429.03,111429.03
"1386",2017-06-30 16:22:14,-111429.03,-2.3283064365387e-10
"1387",2017-06-30 17:28:40,121783.78,121783.78
"1388",2017-06-30 18:09:07,-121783.78,-2.3283064365387e-10
"1389",2017-07-01 00:56:11,99424.85,99424.8499999998
"1390",2017-07-01 01:17:21,-99424.85,-2.3283064365387e-10
"1391",2017-07-01 14:54:25,17686.25,17686.2499999998
"1392",2017-07-01 15:00:16,-17686.25,-2.3283064365387e-10
"1393",2017-07-01 15:46:17,108788.04,108788.04
"1394",2017-07-01 15:52:21,94177.55,202965.59
"1395",2017-07-01 15:52:21,-108788.04,94177.5499999998
"1396",2017-07-01 16:02:49,-94177.55,-2.3283064365387e-10
"1397",2017-07-01 16:58:45,25685.49,25685.4899999998
"1398",2017-07-01 17:10:03,-25685.49,-2.3283064365387e-10
"1399",2017-07-01 17:26:02,103012.01,103012.01
"1400",2017-07-01 18:01:25,-103012.01,-2.3283064365387e-10
"1401",2017-07-01 18:29:31,95117.25,95117.2499999998
"1402",2017-07-01 18:31:05,-95117.25,-2.3283064365387e-10
"1403",2017-07-01 19:35:26,107539.94,107539.94
"1404",2017-07-01 20:16:48,124907.87,232447.81
"1405",2017-07-01 20:16:48,-107539.94,124907.87
"1406",2017-07-01 20:19:18,-124907.87,-2.3283064365387e-10
"1407",2017-07-01 20:28:20,93661.62,93661.6199999998
"1408",2017-07-01 20:36:33,-93661.62,-2.3283064365387e-10
"1409",2017-07-01 21:24:42,97804.5,97804.4999999998
"1410",2017-07-01 21:27:37,-97804.5,-2.3283064365387e-10
"1411",2017-07-01 22:41:14,98746.28,98746.2799999998
"1412",2017-07-01 22:48:49,-98746.28,-2.3283064365387e-10
"1413",2017-07-01 23:17:43,108401.13,108401.13
"1414",2017-07-01 23:28:06,-108401.13,-2.3283064365387e-10
"1415",2017-07-02 00:32:00,93382.95,93382.9499999998
"1416",2017-07-02 00:45:26,-93382.95,-2.3283064365387e-10
"1417",2017-07-02 09:15:38,254850.99,254850.99
"1418",2017-07-02 09:29:50,-254850.99,-2.3283064365387e-10
"1419",2017-07-02 11:25:38,7699.18,7699.17999999977
"1420",2017-07-02 11:31:44,-7699.18,-2.3283064365387e-10
"1421",2017-07-02 13:45:59,95727.76,95727.7599999998
"1422",2017-07-02 14:18:36,-95727.76,-2.3283064365387e-10
"1423",2017-07-02 15:14:33,93279.95,93279.9499999998
"1424",2017-07-02 15:14:33,90619.96,183899.91
"1425",2017-07-02 15:18:47,-183899.91,-2.3283064365387e-10
"1426",2017-07-02 17:14:58,97111.22,97111.2199999998
"1427",2017-07-02 17:22:36,-97111.22,-2.3283064365387e-10
"1428",2017-07-02 20:08:05,16982.9,16982.8999999998
"1429",2017-07-02 20:11:51,-16982.9,-2.3283064365387e-10
"1430",2017-07-02 21:02:01,82509,82508.9999999998
"1431",2017-07-02 21:12:00,-82509,-2.3283064365387e-10
"1432",2017-07-02 22:16:22,82647.88,82647.8799999998
"1433",2017-07-02 22:21:58,-82647.88,-2.3283064365387e-10
"1434",2017-07-03 00:53:52,18180.66,18180.6599999998
"1435",2017-07-03 00:53:52,93852.47,112033.13
"1436",2017-07-03 00:58:53,-112033.13,-2.3283064365387e-10
"1437",2017-07-03 12:47:54,17330.19,17330.1899999998
"1438",2017-07-03 13:04:32,85200.61,102530.8
"1439",2017-07-03 13:04:32,-17330.19,85200.6099999998
"1440",2017-07-03 13:23:55,-85200.61,-2.3283064365387e-10
"1441",2017-07-03 14:01:27,146753.32,146753.32
"1442",2017-07-03 14:11:57,-146753.32,-2.3283064365387e-10
"1443",2017-07-03 14:19:44,127003.54,127003.54
"1444",2017-07-03 14:45:17,-127003.54,-2.3283064365387e-10
"1445",2017-07-04 03:03:00,123257.23,123257.23
"1446",2017-07-04 03:07:49,-123257.23,-2.3283064365387e-10
"1447",2017-07-04 04:22:40,94163.28,94163.2799999998
"1448",2017-07-04 04:22:40,87625.48,181788.76
"1449",2017-07-04 04:32:26,-181788.76,-2.3283064365387e-10
"1450",2017-07-04 17:00:39,41481.71,41481.7099999998
"1451",2017-07-04 17:18:59,-41481.71,-2.3283064365387e-10
"1452",2017-07-04 17:21:40,119879.87,119879.87
"1453",2017-07-04 17:26:44,-119879.87,-2.3283064365387e-10
"1454",2017-07-05 08:31:45,107439.37,107439.37
"1455",2017-07-05 08:52:24,-107439.37,-2.3283064365387e-10
"1456",2017-07-05 09:01:46,128758.13,128758.13
"1457",2017-07-05 09:18:40,-128758.13,-2.3283064365387e-10
"1458",2017-07-05 15:17:31,86582.62,86582.6199999998
"1459",2017-07-05 15:21:21,-86582.62,-2.3283064365387e-10
"1460",2017-07-05 19:07:17,116838.11,116838.11
"1461",2017-07-05 19:15:14,-116838.11,-2.3283064365387e-10
"1462",2017-07-06 04:14:09,91019.76,91019.7599999998
"1463",2017-07-06 04:19:58,-91019.76,-2.3283064365387e-10
"1464",2017-07-06 05:58:43,30275.82,30275.8199999998
"1465",2017-07-06 06:07:02,-30275.82,-2.3283064365387e-10
"1466",2017-07-06 06:09:10,19186.11,19186.1099999998
"1467",2017-07-06 06:09:10,101170.96,120357.07
"1468",2017-07-06 06:25:16,19508.78,139865.85
"1469",2017-07-06 08:18:37,152510.95,292376.8
"1470",2017-07-06 08:28:02,-292376.8,-1.74622982740402e-10
"1471",2017-07-06 15:12:40,19372.35,19372.3499999998
"1472",2017-07-06 15:39:20,-19372.35,-1.74622982740402e-10
"1473",2017-07-06 23:49:03,17397.5,17397.4999999998
"1474",2017-07-06 23:49:03,112005.41,129402.91
"1475",2017-07-07 00:12:37,-129402.91,-1.74622982740402e-10
"1476",2017-07-07 00:55:11,105825.17,105825.17
"1477",2017-07-07 01:16:30,-105825.17,-1.74622982740402e-10
"1478",2017-07-07 04:17:14,104218.71,104218.71
"1479",2017-07-07 04:21:49,-104218.71,-1.74622982740402e-10
"1480",2017-07-07 08:05:33,91334.99,91334.9899999998
"1481",2017-07-07 08:24:17,-91334.99,-1.74622982740402e-10
"1482",2017-07-07 09:38:41,91238.87,91238.8699999998
"1483",2017-07-07 10:07:09,-91238.87,-1.74622982740402e-10
"1484",2017-07-07 11:56:39,96331.09,96331.0899999998
"1485",2017-07-07 12:13:21,-96331.09,-1.74622982740402e-10
"1486",2017-07-07 12:19:58,119891.69,119891.69
"1487",2017-07-07 12:34:41,96954.47,216846.16
"1488",2017-07-07 12:34:41,-119891.69,96954.4699999998
"1489",2017-07-07 12:56:00,99830.22,196784.69
"1490",2017-07-07 12:56:00,-96954.47,99830.2199999998
"1491",2017-07-07 13:04:54,94764.02,194594.24
"1492",2017-07-07 13:04:54,-99830.22,94764.0199999998
"1493",2017-07-07 13:15:47,-94764.02,-1.89174897968769e-10
"1494",2017-07-07 13:24:05,120178.93,120178.93
"1495",2017-07-07 13:40:32,-120178.93,-1.89174897968769e-10
"1496",2017-07-07 13:46:19,153709.46,153709.46
"1497",2017-07-07 13:49:47,-153709.46,-2.03726813197136e-10
"1498",2017-07-07 14:10:26,120335.69,120335.69
"1499",2017-07-07 14:19:39,-120335.69,-2.03726813197136e-10
"1500",2017-07-07 15:22:06,96691.01,96691.0099999998
"1501",2017-07-07 15:22:06,94551.56,191242.57
"1502",2017-07-07 15:58:20,107339.84,298582.41
"1503",2017-07-07 16:00:11,-191242.57,107339.84
"1504",2017-07-07 16:06:19,150073.6,257413.44
"1505",2017-07-07 16:06:19,95804.9,353218.34
"1506",2017-07-07 16:06:19,100073.59,453291.93
"1507",2017-07-07 16:06:19,-107339.84,345952.09
"1508",2017-07-07 16:10:14,-345952.09,-1.74622982740402e-10
"1509",2017-07-07 16:15:54,93224.32,93224.3199999998
"1510",2017-07-07 16:19:59,-93224.32,-1.74622982740402e-10
"1511",2017-07-07 19:19:24,158227.45,158227.45
"1512",2017-07-07 19:23:44,-158227.45,-1.74622982740402e-10
"1513",2017-07-07 20:02:38,19924.75,19924.7499999998
"1514",2017-07-07 20:04:45,-19924.75,-1.74622982740402e-10
"1515",2017-07-07 20:51:21,96378.96,96378.9599999998
"1516",2017-07-07 20:51:21,145732.91,242111.87
"1517",2017-07-07 20:55:36,-242111.87,-1.74622982740402e-10
"1518",2017-07-07 22:16:11,93276.21,93276.2099999998
"1519",2017-07-07 22:18:44,-93276.21,-1.74622982740402e-10
"1520",2017-07-07 22:41:53,103095.26,103095.26
"1521",2017-07-07 22:51:14,-103095.26,-1.74622982740402e-10
"1522",2017-07-07 23:05:35,134744.55,134744.55
"1523",2017-07-07 23:18:40,-134744.55,-1.74622982740402e-10
"1524",2017-07-08 01:06:43,210022.45,210022.45
"1525",2017-07-08 01:20:06,-210022.45,-1.74622982740402e-10
"1526",2017-07-08 01:54:46,96818.28,96818.2799999998
"1527",2017-07-08 02:02:05,-96818.28,-1.74622982740402e-10
"1528",2017-07-08 02:22:51,93729.4,93729.3999999998
"1529",2017-07-08 02:44:36,-93729.4,-1.74622982740402e-10
"1530",2017-07-08 06:32:53,103969.58,103969.58
"1531",2017-07-08 06:35:01,-103969.58,-1.74622982740402e-10
"1532",2017-07-08 07:42:16,18209.03,18209.0299999998
"1533",2017-07-08 07:46:11,-18209.03,-1.74622982740402e-10
"1534",2017-07-08 09:58:42,91577,91576.9999999998
"1535",2017-07-08 10:22:15,-91577,-1.74622982740402e-10
"1536",2017-07-09 10:51:04,90242.93,90242.9299999998
"1537",2017-07-09 11:21:09,-90242.93,-1.74622982740402e-10
"1538",2017-07-09 13:45:45,94545.81,94545.8099999998
"1539",2017-07-09 14:03:30,-94545.81,-1.74622982740402e-10
"1540",2017-07-09 14:17:39,133419.78,133419.78
"1541",2017-07-09 14:35:26,-133419.78,-1.74622982740402e-10
"1542",2017-07-09 17:13:25,101868.92,101868.92
"1543",2017-07-09 17:43:09,91702.03,193570.95
"1544",2017-07-09 18:47:27,100842.15,294413.1
"1545",2017-07-09 19:04:22,106401.67,400814.77
"1546",2017-07-09 19:04:22,-101868.92,298945.85
"1547",2017-07-09 19:07:34,-298945.85,-1.16415321826935e-10
"1548",2017-07-09 20:32:24,107708.23,107708.23
"1549",2017-07-09 21:03:12,-107708.23,-1.16415321826935e-10
"1550",2017-07-09 23:34:51,93034.85,93034.8499999999
"1551",2017-07-09 23:38:25,-93034.85,-1.16415321826935e-10
"1552",2017-07-09 23:56:36,17554.73,17554.7299999999
"1553",2017-07-10 00:06:19,137851.76,155406.49
"1554",2017-07-10 00:06:19,-17554.73,137851.76
"1555",2017-07-10 00:11:28,-137851.76,-1.16415321826935e-10
"1556",2017-07-10 01:20:13,90559.42,90559.4199999999
"1557",2017-07-10 01:29:03,-90559.42,-1.16415321826935e-10
"1558",2017-07-10 02:33:26,91525.29,91525.2899999999
"1559",2017-07-10 02:38:25,-91525.29,-1.16415321826935e-10
"1560",2017-07-10 05:53:39,106505.39,106505.39
"1561",2017-07-10 06:11:44,-106505.39,-1.16415321826935e-10
"1562",2017-07-10 11:11:36,18308.92,18308.9199999999
"1563",2017-07-10 11:17:39,-18308.92,-1.16415321826935e-10
"1564",2017-07-10 11:28:32,105774.62,105774.62
"1565",2017-07-10 11:31:46,-105774.62,-1.16415321826935e-10
"1566",2017-07-10 11:51:43,97982.77,97982.7699999999
"1567",2017-07-10 12:09:25,135835.89,233818.66
"1568",2017-07-10 12:09:25,-97982.77,135835.89
"1569",2017-07-10 12:16:01,142319.8,278155.69
"1570",2017-07-10 12:16:01,-135835.89,142319.8
"1571",2017-07-10 12:31:25,-142319.8,-1.16415321826935e-10
"1572",2017-07-10 12:38:04,115719.58,115719.58
"1573",2017-07-10 12:42:09,113401.85,229121.43
"1574",2017-07-10 12:42:09,-115719.58,113401.85
"1575",2017-07-10 12:46:25,133226.24,246628.09
"1576",2017-07-10 12:46:25,-113401.85,133226.24
"1577",2017-07-10 12:53:08,-133226.24,-1.45519152283669e-10
"1578",2017-07-10 14:12:32,70075.48,70075.4799999999
"1579",2017-07-10 14:20:57,-70075.48,-1.45519152283669e-10
"1580",2017-07-10 14:34:18,390557.45,390557.45
"1581",2017-07-10 14:40:08,-390557.45,-1.74622982740402e-10
"1582",2017-07-10 14:44:50,117021.15,117021.15
"1583",2017-07-10 14:47:30,-117021.15,-1.74622982740402e-10
"1584",2017-07-10 14:59:57,184566.8,184566.8
"1585",2017-07-10 15:02:56,-184566.8,-1.74622982740402e-10
"1586",2017-07-10 15:11:40,150664.43,150664.43
"1587",2017-07-10 15:11:40,146310.41,296974.84
"1588",2017-07-10 15:14:03,-296974.84,-1.74622982740402e-10
"1589",2017-07-10 15:32:38,94337.65,94337.6499999998
"1590",2017-07-10 15:37:31,-94337.65,-1.74622982740402e-10
"1591",2017-07-10 15:45:36,104520.24,104520.24
"1592",2017-07-10 16:05:53,95819.71,200339.95
"1593",2017-07-10 16:10:16,-104520.24,95819.7099999998
"1594",2017-07-10 16:55:38,77852.99,173672.7
"1595",2017-07-10 17:40:29,-95819.71,77852.9899999998
"1596",2017-07-10 17:47:36,-77852.99,-1.74622982740402e-10
"1597",2017-07-10 17:52:48,330933.28,330933.28
"1598",2017-07-10 17:58:46,-330933.28,-1.74622982740402e-10
"1599",2017-07-10 18:07:25,100076.54,100076.54
"1600",2017-07-10 18:21:53,-100076.54,-1.74622982740402e-10
"1601",2017-07-10 19:20:04,55494.99,55494.9899999998
"1602",2017-07-10 19:20:04,124648.37,180143.36
"1603",2017-07-10 19:35:26,153610.2,333753.56
"1604",2017-07-10 19:35:26,-180143.36,153610.2
"1605",2017-07-10 20:01:19,-153610.2,-1.74622982740402e-10
"1606",2017-07-10 20:35:01,97312.98,97312.9799999998
"1607",2017-07-10 20:35:01,95385.27,192698.25
"1608",2017-07-10 20:39:23,-192698.25,-1.74622982740402e-10
"1609",2017-07-10 20:57:38,128930.19,128930.19
"1610",2017-07-10 21:02:17,-128930.19,-1.74622982740402e-10
"1611",2017-07-10 21:42:26,107207.77,107207.77
"1612",2017-07-10 21:43:37,-107207.77,-1.74622982740402e-10
"1613",2017-07-10 22:00:00,121880.54,121880.54
"1614",2017-07-10 22:03:48,-121880.54,-1.74622982740402e-10
"1615",2017-07-10 22:03:48,145856.34,145856.34
"1616",2017-07-10 22:07:43,-145856.34,-1.74622982740402e-10
"1617",2017-07-10 22:15:14,219005.88,219005.88
"1618",2017-07-10 22:17:41,-219005.88,-1.74622982740402e-10
"1619",2017-07-10 22:42:53,163959.12,163959.12
"1620",2017-07-10 22:55:38,94778.71,258737.83
"1621",2017-07-10 22:55:38,-163959.12,94778.7099999998
"1622",2017-07-10 23:00:30,-94778.71,-1.60071067512035e-10
"1623",2017-07-10 23:37:21,177854.29,177854.29
"1624",2017-07-10 23:41:53,-177854.29,-1.45519152283669e-10
"1625",2017-07-11 00:07:50,351572.73,351572.73
"1626",2017-07-11 00:11:08,-351572.73,-1.16415321826935e-10
"1627",2017-07-11 00:29:32,118685.73,118685.73
"1628",2017-07-11 00:48:43,-118685.73,-1.16415321826935e-10
"1629",2017-07-11 01:13:28,171167.67,171167.67
"1630",2017-07-11 01:36:26,109730.24,280897.91
"1631",2017-07-11 01:36:26,-171167.67,109730.24
"1632",2017-07-11 01:46:46,-109730.24,-1.01863406598568e-10
"1633",2017-07-11 01:53:04,147715.9,147715.9
"1634",2017-07-11 01:58:42,-147715.9,-8.73114913702011e-11
"1635",2017-07-11 03:08:21,254197.38,254197.38
"1636",2017-07-11 03:08:21,142308.09,396505.47
"1637",2017-07-11 03:12:55,-396505.47,-5.82076609134674e-11
"1638",2017-07-11 03:20:07,110280.54,110280.54
"1639",2017-07-11 03:24:28,163560.77,273841.31
"1640",2017-07-11 03:24:28,-110280.54,163560.77
"1641",2017-07-11 03:35:44,182039.25,345600.02
"1642",2017-07-11 03:35:44,-163560.77,182039.25
"1643",2017-07-11 03:42:13,-182039.25,-2.91038304567337e-11
"1644",2017-07-11 04:03:32,104644.29,104644.29
"1645",2017-07-11 04:03:32,97639.09,202283.38
"1646",2017-07-11 04:08:03,-202283.38,-5.82076609134674e-11
"1647",2017-07-11 04:30:07,164367.04,164367.04
"1648",2017-07-11 04:43:57,163901.49,328268.53
"1649",2017-07-11 04:43:57,-164367.04,163901.49
"1650",2017-07-11 04:52:13,123019.3,286920.79
"1651",2017-07-11 04:52:13,-163901.49,123019.3
"1652",2017-07-11 05:00:53,-123019.3,-7.27595761418343e-11
"1653",2017-07-11 05:07:57,123110.74,123110.74
"1654",2017-07-11 05:07:57,196465.29,319576.03
"1655",2017-07-11 05:10:14,-319576.03,-1.16415321826935e-10
"1656",2017-07-11 07:13:26,135314.35,135314.35
"1657",2017-07-11 07:13:26,107954.77,243269.12
"1658",2017-07-11 07:13:26,157858.04,401127.16
"1659",2017-07-11 07:16:47,-401127.16,-5.82076609134674e-11
"1660",2017-07-11 07:26:56,123593.57,123593.57
"1661",2017-07-11 07:28:21,109905.68,233499.25
"1662",2017-07-11 07:39:28,-123593.57,109905.68
"1663",2017-07-11 07:47:18,152123.19,262028.87
"1664",2017-07-11 07:47:18,-109905.68,152123.19
"1665",2017-07-11 07:51:12,-152123.19,-5.82076609134674e-11
"1666",2017-07-11 08:09:54,243294.53,243294.53
"1667",2017-07-11 08:15:47,-243294.53,-5.82076609134674e-11
"1668",2017-07-11 08:29:21,96924.67,96924.6699999999
"1669",2017-07-11 08:34:00,-96924.67,-5.82076609134674e-11
"1670",2017-07-11 08:38:27,110157.91,110157.91
"1671",2017-07-11 08:42:14,-110157.91,-5.82076609134674e-11
"1672",2017-07-11 09:48:03,102766.71,102766.71
"1673",2017-07-11 09:48:03,104997.51,207764.22
"1674",2017-07-11 09:50:33,-207764.22,-5.82076609134674e-11
"1675",2017-07-11 13:32:46,27080.44,27080.4399999999
"1676",2017-07-11 13:39:17,-27080.44,-5.82076609134674e-11
"1677",2017-07-11 13:49:49,118868.44,118868.44
"1678",2017-07-11 13:58:15,100523.59,219392.03
"1679",2017-07-11 13:58:15,-118868.44,100523.59
"1680",2017-07-11 14:03:38,-100523.59,-5.82076609134674e-11
"1681",2017-07-11 14:28:07,104442.23,104442.23
"1682",2017-07-11 14:28:07,145470.05,249912.28
"1683",2017-07-11 14:32:46,-249912.28,-8.73114913702011e-11
"1684",2017-07-11 14:55:44,201683.19,201683.19
"1685",2017-07-11 15:01:01,150335.74,352018.93
"1686",2017-07-11 15:01:01,-201683.19,150335.74
"1687",2017-07-11 15:20:35,-150335.74,-5.82076609134674e-11
"1688",2017-07-11 15:21:03,247575.7,247575.7
"1689",2017-07-11 15:25:47,-247575.7,-5.82076609134674e-11
"1690",2017-07-11 15:54:47,117649.89,117649.89
"1691",2017-07-11 15:58:32,-117649.89,-5.82076609134674e-11
"1692",2017-07-11 16:25:10,223725.84,223725.84
"1693",2017-07-11 16:25:10,98142.07,321867.91
"1694",2017-07-11 16:32:06,-321867.91,-5.82076609134674e-11
"1695",2017-07-11 17:50:37,112685.62,112685.62
"1696",2017-07-11 17:54:59,-112685.62,-5.82076609134674e-11
"1697",2017-07-11 18:30:23,111139.97,111139.97
"1698",2017-07-11 18:42:25,97788.93,208928.9
"1699",2017-07-11 18:42:25,-111139.97,97788.9299999999
"1700",2017-07-11 18:55:01,-97788.93,-5.82076609134674e-11
"1701",2017-07-11 19:16:38,107839.54,107839.54
"1702",2017-07-11 19:21:59,101545.95,209385.49
"1703",2017-07-11 19:21:59,-107839.54,101545.95
"1704",2017-07-11 19:29:04,-101545.95,-5.82076609134674e-11
"1705",2017-07-11 19:51:15,18896.89,18896.8899999999
"1706",2017-07-11 19:51:15,117102.4,135999.29
"1707",2017-07-11 19:51:51,-135999.29,-8.73114913702011e-11
"1708",2017-07-11 20:14:16,99021.32,99021.3199999999
"1709",2017-07-11 20:14:16,148325.41,247346.73
"1710",2017-07-11 20:14:16,99156.46,346503.19
"1711",2017-07-11 20:29:11,-346503.19,-5.82076609134674e-11
"1712",2017-07-11 20:34:44,119552.46,119552.46
"1713",2017-07-11 20:52:09,-119552.46,-5.82076609134674e-11
"1714",2017-07-11 21:29:22,100529.35,100529.35
"1715",2017-07-11 21:40:27,-100529.35,-5.82076609134674e-11
"1716",2017-07-11 22:20:04,131709.79,131709.79
"1717",2017-07-11 22:28:20,98327.17,230036.96
"1718",2017-07-11 22:28:20,-131709.79,98327.17
"1719",2017-07-11 22:31:46,95712.12,194039.29
"1720",2017-07-11 22:31:46,-98327.17,95712.12
"1721",2017-07-11 22:41:00,-95712.12,-4.36557456851006e-11
"1722",2017-07-12 00:07:59,99357.41,99357.41
"1723",2017-07-12 00:17:57,-99357.41,-4.36557456851006e-11
"1724",2017-07-12 00:23:33,156114.97,156114.97
"1725",2017-07-12 00:42:50,-156114.97,-2.91038304567337e-11
"1726",2017-07-12 01:51:37,112190.07,112190.07
"1727",2017-07-12 01:57:13,-112190.07,-2.91038304567337e-11
"1728",2017-07-12 02:12:05,113028.33,113028.33
"1729",2017-07-12 02:27:28,-113028.33,-2.91038304567337e-11
"1730",2017-07-12 03:04:35,104579.12,104579.12
"1731",2017-07-12 03:10:56,-104579.12,-2.91038304567337e-11
"1732",2017-07-12 03:40:53,155003.64,155003.64
"1733",2017-07-12 03:46:35,-155003.64,-2.91038304567337e-11
"1734",2017-07-12 03:56:04,164720.13,164720.13
"1735",2017-07-12 04:30:05,141124.14,305844.27
"1736",2017-07-12 04:32:16,-164720.13,141124.14
"1737",2017-07-12 05:02:16,100437.91,241562.05
"1738",2017-07-12 05:02:16,-141124.14,100437.91
"1739",2017-07-12 05:08:05,-100437.91,0
"1740",2017-07-12 05:13:31,103813.37,103813.37
"1741",2017-07-12 05:19:57,-103813.37,0
"1742",2017-07-12 06:42:53,98637.09,98637.09
"1743",2017-07-12 06:45:10,-98637.09,0
"1744",2017-07-12 06:51:51,164281.83,164281.83
"1745",2017-07-12 06:54:26,-164281.83,0
"1746",2017-07-12 11:38:33,131266.97,131266.97
"1747",2017-07-12 11:38:33,253131.64,384398.61
"1748",2017-07-12 11:50:44,-384398.61,0
"1749",2017-07-12 12:50:32,141241.01,141241.01
"1750",2017-07-12 12:57:09,-141241.01,0
"1751",2017-07-12 21:54:43,322780.4,322780.4
"1752",2017-07-12 22:18:02,-322780.4,0
"1753",2017-07-12 22:42:32,92940.15,92940.15
"1754",2017-07-12 22:53:53,-92940.15,0
"1755",2017-07-12 23:19:04,143673.31,143673.31
"1756",2017-07-12 23:19:04,149734.02,293407.33
"1757",2017-07-12 23:24:40,-293407.33,-5.82076609134674e-11
"1758",2017-07-13 04:34:10,111403.46,111403.46
"1759",2017-07-13 04:35:13,-111403.46,-5.82076609134674e-11
"1760",2017-07-13 05:41:37,123528.16,123528.16
"1761",2017-07-13 05:55:18,-123528.16,-5.82076609134674e-11
"1762",2017-07-13 05:55:58,112763.73,112763.73
"1763",2017-07-13 05:55:58,102650.37,215414.1
"1764",2017-07-13 06:02:59,-215414.1,-8.73114913702011e-11
"1765",2017-07-13 06:19:17,118236.63,118236.63
"1766",2017-07-13 06:25:42,-118236.63,-8.73114913702011e-11
"1767",2017-07-13 06:52:53,112013.06,112013.06
"1768",2017-07-13 07:01:19,-112013.06,-8.73114913702011e-11
"1769",2017-07-13 07:15:36,120806.05,120806.05
"1770",2017-07-13 07:54:47,-120806.05,-8.73114913702011e-11
"1771",2017-07-13 07:54:47,106399.77,106399.77
"1772",2017-07-13 08:04:18,-106399.77,-8.73114913702011e-11
"1773",2017-07-13 08:35:02,157498.65,157498.65
"1774",2017-07-13 08:35:02,127636.67,285135.32
"1775",2017-07-13 08:37:37,-285135.32,-1.16415321826935e-10
"1776",2017-07-13 09:03:16,139634.84,139634.84
"1777",2017-07-13 09:13:11,-139634.84,-1.16415321826935e-10
"1778",2017-07-13 09:47:15,106328.26,106328.26
"1779",2017-07-13 09:51:57,-106328.26,-1.16415321826935e-10
"1780",2017-07-13 10:45:47,146946.54,146946.54
"1781",2017-07-13 10:54:58,-146946.54,-1.16415321826935e-10
"1782",2017-07-13 11:13:19,140007.39,140007.39
"1783",2017-07-13 11:19:15,-140007.39,-1.16415321826935e-10
"1784",2017-07-13 11:25:44,113228.46,113228.46
"1785",2017-07-13 11:27:16,-113228.46,-1.16415321826935e-10
"1786",2017-07-13 11:32:38,127293.69,127293.69
"1787",2017-07-13 11:37:05,-127293.69,-1.16415321826935e-10
"1788",2017-07-13 12:28:35,165841.88,165841.88
"1789",2017-07-13 12:28:35,129323.65,295165.53
"1790",2017-07-13 12:31:36,-295165.53,-1.16415321826935e-10
"1791",2017-07-13 14:38:14,119433.85,119433.85
"1792",2017-07-13 14:43:07,-119433.85,-1.16415321826935e-10
"1793",2017-07-13 14:51:20,16839.79,16839.7899999999
"1794",2017-07-13 14:51:20,140418.84,157258.63
"1795",2017-07-13 14:51:20,120594.9,277853.53
"1796",2017-07-13 15:18:07,-277853.53,-1.16415321826935e-10
"1797",2017-07-13 16:38:12,413171.93,413171.93
"1798",2017-07-13 16:50:43,-413171.93,-1.16415321826935e-10
"1799",2017-07-13 17:30:13,156881.07,156881.07
"1800",2017-07-13 17:50:53,-156881.07,-1.16415321826935e-10
"1801",2017-07-13 18:18:02,104569.79,104569.79
"1802",2017-07-13 18:18:02,104838.29,209408.08
"1803",2017-07-13 18:30:14,-209408.08,-1.16415321826935e-10
"1804",2017-07-13 18:46:52,141708.7,141708.7
"1805",2017-07-13 18:56:43,-141708.7,-1.16415321826935e-10
"1806",2017-07-13 22:10:34,200083.5,200083.5
"1807",2017-07-13 22:14:19,-200083.5,-1.16415321826935e-10
"1808",2017-07-13 22:46:10,113987.19,113987.19
"1809",2017-07-13 22:46:10,182321.46,296308.65
"1810",2017-07-13 22:46:10,214167.04,510475.69
"1811",2017-07-13 22:49:58,-510475.69,-5.82076609134674e-11
"1812",2017-07-14 00:48:27,118587.68,118587.68
"1813",2017-07-14 00:57:15,-118587.68,-5.82076609134674e-11
"1814",2017-07-14 05:51:50,111204.11,111204.11
"1815",2017-07-14 06:02:28,-111204.11,-5.82076609134674e-11
"1816",2017-07-14 07:21:08,8744.67,8744.66999999994
"1817",2017-07-14 07:23:29,-8744.67,-5.82076609134674e-11
"1818",2017-07-14 07:35:00,134449.16,134449.16
"1819",2017-07-14 07:43:07,-134449.16,-5.82076609134674e-11
"1820",2017-07-14 09:46:39,111824.48,111824.48
"1821",2017-07-14 10:14:33,-111824.48,-5.82076609134674e-11
"1822",2017-07-14 13:30:11,105823.31,105823.31
"1823",2017-07-14 13:38:53,-105823.31,-5.82076609134674e-11
"1824",2017-07-14 14:24:59,22359.89,22359.8899999999
"1825",2017-07-14 14:58:38,-22359.89,-5.82076609134674e-11
"1826",2017-07-14 14:58:38,110224.19,110224.19
"1827",2017-07-14 14:58:38,117770.58,227994.77
"1828",2017-07-14 15:29:59,109561.07,337555.84
"1829",2017-07-14 15:29:59,-227994.77,109561.07
"1830",2017-07-14 15:33:17,-109561.07,-2.91038304567337e-11
"1831",2017-07-14 17:53:55,109028.39,109028.39
"1832",2017-07-14 17:55:45,-109028.39,-2.91038304567337e-11
"1833",2017-07-14 18:17:43,115884.89,115884.89
"1834",2017-07-14 18:33:49,-115884.89,-2.91038304567337e-11
"1835",2017-07-14 19:14:19,166817.02,166817.02
"1836",2017-07-14 19:31:39,-166817.02,-2.91038304567337e-11
"1837",2017-07-14 20:38:21,111268.23,111268.23
"1838",2017-07-14 20:45:05,-111268.23,-2.91038304567337e-11
"1839",2017-07-14 20:51:16,187927.43,187927.43
"1840",2017-07-14 21:20:41,-187927.43,-2.91038304567337e-11
"1841",2017-07-14 22:42:10,287798.68,287798.68
"1842",2017-07-14 22:52:02,-287798.68,-5.82076609134674e-11
"1843",2017-07-14 23:28:29,210768.32,210768.32
"1844",2017-07-14 23:55:03,-210768.32,-5.82076609134674e-11
"1845",2017-07-15 05:28:21,113251.58,113251.58
"1846",2017-07-15 05:28:21,110604.23,223855.81
"1847",2017-07-15 05:42:00,-223855.81,-5.82076609134674e-11
"1848",2017-07-15 05:42:00,120365.11,120365.11
"1849",2017-07-15 05:58:17,-120365.11,-5.82076609134674e-11
"1850",2017-07-15 06:57:46,106937.7,106937.7
"1851",2017-07-15 07:05:30,-106937.7,-5.82076609134674e-11
"1852",2017-07-15 08:20:47,141945.23,141945.23
"1853",2017-07-15 08:33:47,-141945.23,-5.82076609134674e-11
"1854",2017-07-15 09:00:52,131188.46,131188.46
"1855",2017-07-15 09:09:26,-131188.46,-5.82076609134674e-11
"1856",2017-07-15 09:18:39,178432.94,178432.94
"1857",2017-07-15 10:21:08,108188.99,286621.93
"1858",2017-07-15 10:21:08,-178432.94,108188.99
"1859",2017-07-15 10:56:27,-108188.99,-7.27595761418343e-11
"1860",2017-07-15 13:42:30,135782.48,135782.48
"1861",2017-07-15 13:42:30,120535.08,256317.56
"1862",2017-07-15 13:57:51,-256317.56,-5.82076609134674e-11
"1863",2017-07-15 14:01:41,260041.11,260041.11
"1864",2017-07-15 14:03:13,-260041.11,-5.82076609134674e-11
"1865",2017-07-15 14:46:50,111325.1,111325.1
"1866",2017-07-15 14:46:50,187002.59,298327.69
"1867",2017-07-15 14:49:12,-298327.69,-5.82076609134674e-11
"1868",2017-07-15 15:00:28,114577.47,114577.47
"1869",2017-07-15 15:06:19,-114577.47,-5.82076609134674e-11
"1870",2017-07-15 16:13:01,137816.58,137816.58
"1871",2017-07-15 16:13:01,112207.79,250024.37
"1872",2017-07-15 16:13:01,141252.34,391276.71
"1873",2017-07-15 16:22:13,-391276.71,-5.82076609134674e-11
"1874",2017-07-15 17:38:32,109656.79,109656.79
"1875",2017-07-15 17:59:28,-109656.79,-5.82076609134674e-11
"1876",2017-07-15 22:35:46,108190.79,108190.79
"1877",2017-07-15 22:54:30,-108190.79,-5.82076609134674e-11
"1878",2017-07-16 00:12:00,112586,112586
"1879",2017-07-16 00:19:03,-112586,-5.82076609134674e-11
"1880",2017-07-16 01:43:04,115158.02,115158.02
"1881",2017-07-16 01:53:00,-115158.02,-5.82076609134674e-11
"1882",2017-07-16 02:14:56,109057.6,109057.6
"1883",2017-07-16 02:16:32,-109057.6,-5.82076609134674e-11
"1884",2017-07-16 07:35:46,109700.94,109700.94
"1885",2017-07-16 07:40:17,-109700.94,-5.82076609134674e-11
"1886",2017-07-16 08:13:27,134084.49,134084.49
"1887",2017-07-16 08:16:28,-134084.49,-5.82076609134674e-11
"1888",2017-07-16 09:00:19,166000.1,166000.1
"1889",2017-07-16 09:12:02,-166000.1,-5.82076609134674e-11
"1890",2017-07-16 09:36:09,134711.01,134711.01
"1891",2017-07-16 09:43:30,-134711.01,-5.82076609134674e-11
"1892",2017-07-16 10:13:10,115105,115105
"1893",2017-07-16 10:23:13,-115105,-5.82076609134674e-11
"1894",2017-07-16 11:15:11,116681.29,116681.29
"1895",2017-07-16 11:23:46,-116681.29,-5.82076609134674e-11
"1896",2017-07-16 11:38:45,114164.68,114164.68
"1897",2017-07-16 12:11:46,121676.38,235841.06
"1898",2017-07-16 12:11:46,120526.47,356367.53
"1899",2017-07-16 12:11:46,-114164.68,242202.85
"1900",2017-07-16 12:44:06,124249.7,366452.55
"1901",2017-07-16 12:44:06,117065.46,483518.01
"1902",2017-07-16 12:45:38,-242202.85,241315.16
"1903",2017-07-16 12:51:35,-241315.16,-5.82076609134674e-11
"1904",2017-07-16 13:42:29,147798.99,147798.99
"1905",2017-07-16 14:11:47,-147798.99,-5.82076609134674e-11
"1906",2017-07-16 14:58:43,288252.55,288252.55
"1907",2017-07-16 14:58:43,155173.67,443426.22
"1908",2017-07-16 15:20:34,137861.96,581288.18
"1909",2017-07-16 15:20:34,-443426.22,137861.96
"1910",2017-07-16 15:30:44,-137861.96,-2.91038304567337e-11
"1911",2017-07-16 16:07:10,142655.91,142655.91
"1912",2017-07-16 16:27:31,157209.98,299865.89
"1913",2017-07-16 16:27:31,-142655.91,157209.98
"1914",2017-07-16 16:33:30,-157209.98,0
"1915",2017-07-16 16:59:11,139728.08,139728.08
"1916",2017-07-16 17:07:49,-139728.08,0
"1917",2017-07-16 19:02:08,192794.98,192794.98
"1918",2017-07-16 19:07:21,-192794.98,0
"1919",2017-07-16 19:26:16,128965.81,128965.81
"1920",2017-07-16 19:39:06,119223.33,248189.14
"1921",2017-07-16 19:39:06,-128965.81,119223.33
"1922",2017-07-16 19:51:23,-119223.33,1.45519152283669e-11
"1923",2017-07-16 20:41:12,148780.57,148780.57
"1924",2017-07-16 20:47:15,-148780.57,0
"1925",2017-07-16 21:24:57,143282.75,143282.75
"1926",2017-07-16 21:36:26,-143282.75,0
"1927",2017-07-16 23:03:50,138520.87,138520.87
"1928",2017-07-16 23:15:09,111529.52,250050.39
"1929",2017-07-16 23:15:09,-138520.87,111529.52
"1930",2017-07-16 23:21:10,123116.35,234645.87
"1931",2017-07-16 23:44:44,-111529.52,123116.35
"1932",2017-07-17 00:15:48,-123116.35,1.45519152283669e-11
"1933",2017-07-17 04:38:37,17683.37,17683.37
"1934",2017-07-17 04:44:41,-17683.37,1.45519152283669e-11
"1935",2017-07-17 10:40:28,142313.52,142313.52
"1936",2017-07-17 10:40:28,139494.15,281807.67
"1937",2017-07-17 10:52:47,-281807.67,5.82076609134674e-11
"1938",2017-07-17 11:26:56,123020.13,123020.13
"1939",2017-07-17 11:32:22,-123020.13,5.82076609134674e-11
"1940",2017-07-17 12:11:04,115165.82,115165.82
"1941",2017-07-17 12:24:36,142528.96,257694.78
"1942",2017-07-17 12:24:36,-115165.82,142528.96
"1943",2017-07-17 12:45:28,117963.45,260492.41
"1944",2017-07-17 12:45:28,-142528.96,117963.45
"1945",2017-07-17 13:10:18,-117963.45,4.36557456851006e-11
"1946",2017-07-17 17:21:07,189886.91,189886.91
"1947",2017-07-17 17:55:00,-189886.91,2.91038304567337e-11
"1948",2017-07-17 17:55:00,255554.14,255554.14
"1949",2017-07-17 18:00:28,-255554.14,2.91038304567337e-11
"1950",2017-07-17 18:07:59,290695.23,290695.23
"1951",2017-07-17 18:10:16,-290695.23,0
"1952",2017-07-17 18:23:59,159376.12,159376.12
"1953",2017-07-17 18:39:27,-159376.12,0
"1954",2017-07-17 18:47:54,179656.14,179656.14
"1955",2017-07-17 19:07:31,-179656.14,0
"1956",2017-07-17 19:20:30,145606.79,145606.79
"1957",2017-07-17 19:27:08,-145606.79,0
"1958",2017-07-18 03:32:04,502407.63,502407.63
"1959",2017-07-18 03:43:01,-502407.63,0
"1960",2017-07-18 05:41:17,121024.11,121024.11
"1961",2017-07-18 05:52:46,-121024.11,0
"1962",2017-07-18 06:44:21,135689.22,135689.22
"1963",2017-07-18 06:59:49,-135689.22,0
"1964",2017-07-18 09:55:10,119302.99,119302.99
"1965",2017-07-18 10:05:40,-119302.99,0
"1966",2017-07-18 15:55:01,12262.68,12262.68
"1967",2017-07-18 15:58:02,-12262.68,0
"1968",2017-07-18 16:31:09,143636.67,143636.67
"1969",2017-07-18 16:46:49,-143636.67,0
"1970",2017-07-18 17:15:40,132916.16,132916.16
"1971",2017-07-18 17:15:40,114379.96,247296.12
"1972",2017-07-18 17:15:40,149242.68,396538.8
"1973",2017-07-18 18:13:15,-396538.8,0
"1974",2017-07-18 21:48:48,111189.86,111189.86
"1975",2017-07-18 22:04:27,-111189.86,0
"1976",2017-07-18 22:04:27,130651.77,130651.77
"1977",2017-07-18 22:09:34,-130651.77,0
"1978",2017-07-18 22:47:00,138714.62,138714.62
"1979",2017-07-18 22:50:37,-138714.62,0
"1980",2017-07-18 23:02:25,118657.64,118657.64
"1981",2017-07-18 23:02:25,150398.71,269056.35
"1982",2017-07-18 23:02:25,126059.36,395115.71
"1983",2017-07-18 23:06:08,-395115.71,-5.82076609134674e-11
"1984",2017-07-18 23:30:26,216557.88,216557.88
"1985",2017-07-18 23:37:10,-216557.88,-5.82076609134674e-11
"1986",2017-07-18 23:59:35,130691.11,130691.11
"1987",2017-07-19 00:01:32,-130691.11,-5.82076609134674e-11
"1988",2017-07-19 00:50:27,129723.03,129723.03
"1989",2017-07-19 00:50:27,126732.67,256455.7
"1990",2017-07-19 00:51:44,-256455.7,-5.82076609134674e-11
"1991",2017-07-19 01:49:58,154789.76,154789.76
"1992",2017-07-19 01:53:44,-154789.76,-5.82076609134674e-11
"1993",2017-07-19 02:09:15,187399.2,187399.2
"1994",2017-07-19 02:27:35,-187399.2,-5.82076609134674e-11
"1995",2017-07-19 06:13:21,155940.75,155940.75
"1996",2017-07-19 06:18:12,-155940.75,-5.82076609134674e-11
"1997",2017-07-19 06:59:07,141697,141697
"1998",2017-07-19 07:02:09,-141697,-5.82076609134674e-11
"1999",2017-07-19 09:57:24,121408.69,121408.69
"2000",2017-07-19 09:57:24,124964.16,246372.85
"2001",2017-07-19 10:07:38,-246372.85,-5.82076609134674e-11
"2002",2017-07-19 10:43:12,158975.45,158975.45
"2003",2017-07-19 10:43:12,135202.53,294177.98
"2004",2017-07-19 10:45:33,-294177.98,0
"2005",2017-07-19 11:43:41,127639.52,127639.52
"2006",2017-07-19 11:45:30,-127639.52,0
"2007",2017-07-19 13:19:38,134086.28,134086.28
"2008",2017-07-19 13:22:07,-134086.28,0
"2009",2017-07-19 13:53:21,145333.31,145333.31
"2010",2017-07-19 13:53:21,169316.69,314650
"2011",2017-07-19 13:53:21,206882,521532
"2012",2017-07-19 14:10:15,-521532,0
"2013",2017-07-19 14:19:35,156675.98,156675.98
"2014",2017-07-19 14:23:04,144259.88,300935.86
"2015",2017-07-19 14:23:04,-156675.98,144259.88
"2016",2017-07-19 14:34:26,-144259.88,-2.91038304567337e-11
"2017",2017-07-19 14:56:24,153688.37,153688.37
"2018",2017-07-19 15:04:15,-153688.37,-2.91038304567337e-11
"2019",2017-07-19 15:35:46,142667.94,142667.94
"2020",2017-07-19 15:41:46,-142667.94,-2.91038304567337e-11
"2021",2017-07-19 15:49:24,120058.63,120058.63
"2022",2017-07-19 15:54:01,-120058.63,-2.91038304567337e-11
"2023",2017-07-19 16:05:08,128534.75,128534.75
"2024",2017-07-19 16:08:04,-128534.75,-2.91038304567337e-11
"2025",2017-07-19 17:58:43,148028.86,148028.86
"2026",2017-07-19 18:26:25,130538.12,278566.98
"2027",2017-07-19 18:49:24,135551.68,414118.66
"2028",2017-07-19 18:50:14,-148028.86,266089.8
"2029",2017-07-19 19:00:31,-266089.8,0
"2030",2017-07-19 19:44:38,125562.94,125562.94
"2031",2017-07-19 19:44:38,134695.9,260258.84
"2032",2017-07-19 19:44:38,283509.75,543768.59
"2033",2017-07-19 19:51:24,-543768.59,0
"2034",2017-07-19 20:04:53,228044.51,228044.51
"2035",2017-07-19 20:10:57,9866.34,237910.85
"2036",2017-07-19 20:10:57,224300.58,462211.43
"2037",2017-07-19 20:10:57,-228044.51,234166.92
"2038",2017-07-19 20:15:47,-234166.92,-2.91038304567337e-11
"2039",2017-07-19 20:38:10,260914.85,260914.85
"2040",2017-07-19 20:38:10,129552.43,390467.28
"2041",2017-07-19 20:54:56,133329.37,523796.65
"2042",2017-07-19 20:54:56,-390467.28,133329.37
"2043",2017-07-19 21:09:05,171481.55,304810.92
"2044",2017-07-19 21:09:05,-133329.37,171481.55
"2045",2017-07-19 21:23:59,-171481.55,-5.82076609134674e-11
"2046",2017-07-19 22:10:19,137537.13,137537.13
"2047",2017-07-19 22:17:19,128783.83,266320.96
"2048",2017-07-19 22:17:19,-137537.13,128783.83
"2049",2017-07-19 22:33:59,-128783.83,-4.36557456851006e-11
"2050",2017-07-19 23:45:43,150990.17,150990.17
"2051",2017-07-19 23:45:43,121498.71,272488.88
"2052",2017-07-19 23:50:13,-272488.88,0
"2053",2017-07-20 03:01:57,377870.91,377870.91
"2054",2017-07-20 03:05:05,-377870.91,0
"2055",2017-07-20 07:18:01,438989.44,438989.44
"2056",2017-07-20 07:25:08,-438989.44,0
"2057",2017-07-20 12:13:37,143380.08,143380.08
"2058",2017-07-20 12:13:37,13560.93,156941.01
"2059",2017-07-20 12:13:37,216813.62,373754.63
"2060",2017-07-20 12:23:59,-373754.63,0
"2061",2017-07-20 13:43:24,169911,169911
"2062",2017-07-20 13:47:12,-169911,0
"2063",2017-07-20 18:33:04,155810.84,155810.84
"2064",2017-07-20 18:53:33,135005.97,290816.81
"2065",2017-07-20 18:53:33,-155810.84,135005.97
"2066",2017-07-20 19:15:20,-135005.97,0
"2067",2017-07-20 19:20:16,189771.61,189771.61
"2068",2017-07-20 19:30:01,-189771.61,0
"2069",2017-07-20 20:52:02,175932.09,175932.09
"2070",2017-07-20 21:10:15,-175932.09,0
"2071",2017-07-20 23:28:20,206220.28,206220.28
"2072",2017-07-20 23:32:09,-206220.28,0
"2073",2017-07-21 00:03:06,122850.25,122850.25
"2074",2017-07-21 00:06:48,-122850.25,0
"2075",2017-07-21 00:18:07,157641.98,157641.98
"2076",2017-07-21 00:31:21,-157641.98,0
"2077",2017-07-21 01:33:57,154824.02,154824.02
"2078",2017-07-21 01:33:57,126238.4,281062.42
"2079",2017-07-21 01:33:57,136185.41,417247.83
"2080",2017-07-21 01:38:43,-417247.83,-5.82076609134674e-11
"2081",2017-07-21 06:52:17,184087.92,184087.92
"2082",2017-07-21 07:05:07,-184087.92,-5.82076609134674e-11
"2083",2017-07-21 07:45:09,10919.43,10919.4299999999
"2084",2017-07-21 07:50:45,-10919.43,-5.82076609134674e-11
"2085",2017-07-21 17:13:15,237346.42,237346.42
"2086",2017-07-21 17:23:36,-237346.42,-5.82076609134674e-11
"2087",2017-07-21 17:47:57,168596.87,168596.87
"2088",2017-07-21 17:52:36,-168596.87,-5.82076609134674e-11
"2089",2017-07-21 21:08:13,164074.51,164074.51
"2090",2017-07-21 21:12:10,-164074.51,-5.82076609134674e-11
"2091",2017-07-21 21:58:46,168698.66,168698.66
"2092",2017-07-21 22:03:49,-168698.66,-5.82076609134674e-11
"2093",2017-07-21 23:16:21,11560.21,11560.2099999999
"2094",2017-07-21 23:16:21,152378.59,163938.8
"2095",2017-07-21 23:18:55,-163938.8,-5.82076609134674e-11
"2096",2017-07-22 10:41:59,216844.27,216844.27
"2097",2017-07-22 11:36:44,-216844.27,-5.82076609134674e-11
"2098",2017-07-22 11:36:44,175248.3,175248.3
"2099",2017-07-22 11:44:04,-175248.3,-5.82076609134674e-11
"2100",2017-07-23 20:50:01,25871.11,25871.1099999999
"2101",2017-07-23 20:55:25,-25871.11,-5.82076609134674e-11
"2102",2017-07-24 01:02:19,142069.34,142069.34
"2103",2017-07-24 01:14:29,-142069.34,-5.82076609134674e-11
"2104",2017-07-24 13:43:20,29266.75,29266.7499999999
"2105",2017-07-24 13:43:20,135241.18,164507.93
"2106",2017-07-24 13:48:45,-164507.93,-5.82076609134674e-11
"2107",2017-07-24 14:08:57,149177.96,149177.96
"2108",2017-07-24 14:12:45,-149177.96,-5.82076609134674e-11
"2109",2017-07-24 14:24:30,144999.24,144999.24
"2110",2017-07-24 14:26:51,-144999.24,-5.82076609134674e-11
"2111",2017-07-25 06:59:50,21347.89,21347.8899999999
"2112",2017-07-25 06:59:50,177261.25,198609.14
"2113",2017-07-25 07:03:34,-198609.14,-5.82076609134674e-11
"2114",2017-07-25 07:21:21,9488.27,9488.26999999994
"2115",2017-07-25 07:21:21,232597.12,242085.39
"2116",2017-07-25 07:24:20,-242085.39,-8.73114913702011e-11
"2117",2017-07-25 07:34:01,149113.05,149113.05
"2118",2017-07-25 07:41:40,-149113.05,-8.73114913702011e-11
"2119",2017-07-25 07:50:29,169071.87,169071.87
"2120",2017-07-25 08:07:57,-169071.87,-8.73114913702011e-11
"2121",2017-07-25 08:58:20,164119.67,164119.67
"2122",2017-07-25 09:01:22,-164119.67,-8.73114913702011e-11
"2123",2017-07-25 09:17:59,169533.46,169533.46
"2124",2017-07-25 09:23:00,-169533.46,-8.73114913702011e-11
"2125",2017-07-25 10:14:46,187538.57,187538.57
"2126",2017-07-25 10:28:37,219199.66,406738.23
"2127",2017-07-25 10:28:37,-187538.57,219199.66
"2128",2017-07-25 10:33:01,151833.65,371033.31
"2129",2017-07-25 10:33:01,-219199.66,151833.65
"2130",2017-07-25 11:05:56,-151833.65,-5.82076609134674e-11
"2131",2017-07-25 11:33:51,193326.35,193326.35
"2132",2017-07-25 11:36:43,184607.39,377933.74
"2133",2017-07-25 11:42:36,-193326.35,184607.39
"2134",2017-07-25 12:00:33,133592.03,318199.42
"2135",2017-07-25 12:00:33,-184607.39,133592.03
"2136",2017-07-25 12:24:39,-133592.03,-2.91038304567337e-11
"2137",2017-07-25 12:54:03,9386.36,9386.35999999997
"2138",2017-07-25 13:17:49,367081.85,376468.21
"2139",2017-07-25 13:17:49,-9386.36,367081.85
"2140",2017-07-25 13:27:34,214761.2,581843.05
"2141",2017-07-25 13:27:34,-367081.85,214761.2
"2142",2017-07-25 13:41:29,-214761.2,5.82076609134674e-11
"2143",2017-07-25 14:13:13,166176.24,166176.24
"2144",2017-07-25 14:13:13,143662.48,309838.72
"2145",2017-07-25 14:21:09,-309838.72,1.16415321826935e-10
"2146",2017-07-25 16:26:00,185339.05,185339.05
"2147",2017-07-25 16:43:21,157299.9,342638.95
"2148",2017-07-25 16:43:21,-185339.05,157299.9
"2149",2017-07-25 17:03:13,176957.75,334257.65
"2150",2017-07-25 17:19:28,170101.35,504359
"2151",2017-07-25 17:19:28,-334257.65,170101.35
"2152",2017-07-25 17:34:10,-170101.35,8.73114913702011e-11
"2153",2017-07-25 18:54:08,180515.56,180515.56
"2154",2017-07-25 18:58:42,-180515.56,8.73114913702011e-11
"2155",2017-07-25 19:24:10,173023.04,173023.04
"2156",2017-07-25 19:24:10,136764.9,309787.94
"2157",2017-07-25 19:31:31,-309787.94,5.82076609134674e-11
"2158",2017-07-25 20:15:44,177878.44,177878.44
"2159",2017-07-25 20:25:36,-177878.44,5.82076609134674e-11
"2160",2017-07-25 20:58:05,17757.03,17757.0300000001
"2161",2017-07-25 20:58:05,142038.39,159795.42
"2162",2017-07-25 21:12:08,135480.8,295276.22
"2163",2017-07-25 21:12:08,-159795.42,135480.8
"2164",2017-07-25 21:16:51,200623.49,336104.29
"2165",2017-07-25 21:16:51,-135480.8,200623.49
"2166",2017-07-25 21:38:09,-200623.49,5.82076609134674e-11
"2167",2017-07-26 05:35:30,148872.73,148872.73
"2168",2017-07-26 05:40:03,-148872.73,5.82076609134674e-11
"2169",2017-07-26 06:31:53,152048.36,152048.36
"2170",2017-07-26 06:43:31,-152048.36,5.82076609134674e-11
"2171",2017-07-26 07:08:57,156631.2,156631.2
"2172",2017-07-26 07:19:17,-156631.2,5.82076609134674e-11
"2173",2017-07-26 08:43:19,168806.08,168806.08
"2174",2017-07-26 08:58:32,-168806.08,5.82076609134674e-11
"2175",2017-07-26 17:01:57,189073.43,189073.43
"2176",2017-07-26 17:19:35,-189073.43,5.82076609134674e-11
"2177",2017-07-26 17:51:24,222495.1,222495.1
"2178",2017-07-26 18:21:39,-222495.1,5.82076609134674e-11
"2179",2017-07-26 21:13:11,140674.48,140674.48
"2180",2017-07-26 21:22:01,-140674.48,5.82076609134674e-11
"2181",2017-07-26 23:16:41,185458.36,185458.36
"2182",2017-07-26 23:26:41,-185458.36,5.82076609134674e-11
"2183",2017-07-26 23:40:41,141776.2,141776.2
"2184",2017-07-26 23:45:16,-141776.2,5.82076609134674e-11
"2185",2017-07-27 01:02:25,141593.64,141593.64
"2186",2017-07-27 01:05:31,-141593.64,5.82076609134674e-11
"2187",2017-07-27 17:19:28,58345.93,58345.9300000001
"2188",2017-07-27 17:23:10,-58345.93,5.82076609134674e-11
"2189",2017-07-27 22:04:43,117001.13,117001.13
"2190",2017-07-27 22:04:43,125876.86,242877.99
"2191",2017-07-27 22:15:43,-242877.99,5.82076609134674e-11
"2192",2017-07-27 22:49:00,19297.17,19297.1700000001
"2193",2017-07-27 22:59:22,128838.27,148135.44
"2194",2017-07-27 22:59:22,-19297.17,128838.27
"2195",2017-07-27 23:03:43,-128838.27,5.82076609134674e-11
"2196",2017-07-28 16:55:14,182930.43,182930.43
"2197",2017-07-28 16:57:50,-182930.43,5.82076609134674e-11
"2198",2017-07-28 19:53:51,21673.81,21673.8100000001
"2199",2017-07-28 20:17:21,-21673.81,5.82076609134674e-11
"2200",2017-07-29 00:15:10,130352.78,130352.78
"2201",2017-07-29 00:30:07,-130352.78,5.82076609134674e-11
"2202",2017-07-29 03:47:04,129149.27,129149.27
"2203",2017-07-29 03:55:33,-129149.27,5.82076609134674e-11
"2204",2017-07-29 08:30:58,124014.62,124014.62
"2205",2017-07-29 08:51:06,-124014.62,5.82076609134674e-11
"2206",2017-07-29 12:36:45,32477.41,32477.4100000001
"2207",2017-07-29 12:47:56,-32477.41,5.82076609134674e-11
"2208",2017-07-29 12:56:55,102763.92,102763.92
"2209",2017-07-29 13:14:06,-102763.92,5.82076609134674e-11
"2210",2017-07-29 17:28:34,13884.69,13884.6900000001
"2211",2017-07-29 18:18:00,137598.69,151483.38
"2212",2017-07-29 18:18:00,-13884.69,137598.69
"2213",2017-07-29 18:25:09,-137598.69,5.82076609134674e-11
"2214",2017-07-29 20:41:35,136042.66,136042.66
"2215",2017-07-29 20:53:04,-136042.66,5.82076609134674e-11
"2216",2017-07-29 23:37:24,145894.21,145894.21
"2217",2017-07-29 23:48:40,-145894.21,5.82076609134674e-11
"2218",2017-07-30 01:55:39,174208.44,174208.44
"2219",2017-07-30 02:03:30,-174208.44,5.82076609134674e-11
"2220",2017-07-30 05:17:07,18909.48,18909.4800000001
"2221",2017-07-30 05:17:07,161497.05,180406.53
"2222",2017-07-30 05:42:01,-180406.53,5.82076609134674e-11
"2223",2017-07-30 08:11:47,22309.23,22309.2300000001
"2224",2017-07-30 08:16:45,-22309.23,5.82076609134674e-11
"2225",2017-07-30 10:44:46,122710.01,122710.01
"2226",2017-07-30 11:08:12,-122710.01,5.82076609134674e-11
"2227",2017-07-30 13:36:43,13436.22,13436.2200000001
"2228",2017-07-30 13:47:09,-13436.22,5.82076609134674e-11
"2229",2017-07-30 18:06:35,100057.01,100057.01
"2230",2017-07-30 19:24:50,-100057.01,5.82076609134674e-11
"2231",2017-07-30 20:06:13,84828.43,84828.4300000001
"2232",2017-07-30 20:09:25,-84828.43,5.82076609134674e-11
"2233",2017-07-30 20:18:35,17743.22,17743.2200000001
"2234",2017-07-30 20:23:04,-17743.22,5.82076609134674e-11
"2235",2017-07-30 23:45:44,98139.59,98139.5900000001
"2236",2017-07-31 00:11:01,-98139.59,5.82076609134674e-11
"2237",2017-07-31 04:49:43,15131.65,15131.6500000001
"2238",2017-07-31 05:16:07,-15131.65,5.82076609134674e-11
"2239",2017-07-31 06:56:18,93147.16,93147.1600000001
"2240",2017-07-31 07:26:35,-93147.16,5.82076609134674e-11
"2241",2017-07-31 18:32:32,122782.28,122782.28
"2242",2017-07-31 18:37:43,-122782.28,5.82076609134674e-11
"2243",2017-07-31 21:17:16,108974.57,108974.57
"2244",2017-07-31 21:25:55,-108974.57,5.82076609134674e-11
"2245",2017-08-01 00:27:31,97621.68,97621.6800000001
"2246",2017-08-01 00:32:09,-97621.68,5.82076609134674e-11
"2247",2017-08-01 00:38:35,119487.68,119487.68
"2248",2017-08-01 00:40:54,-119487.68,5.82076609134674e-11
"2249",2017-08-01 00:49:33,116349.46,116349.46
"2250",2017-08-01 00:58:38,-116349.46,5.82076609134674e-11
"2251",2017-08-01 01:13:47,145967.47,145967.47
"2252",2017-08-01 01:16:04,-145967.47,5.82076609134674e-11
"2253",2017-08-01 18:58:57,24011.21,24011.2100000001
"2254",2017-08-01 19:00:44,-24011.21,5.82076609134674e-11
"2255",2017-08-01 19:54:53,121549.64,121549.64
"2256",2017-08-01 20:01:09,-121549.64,5.82076609134674e-11
"2257",2017-08-01 20:24:01,187515.36,187515.36
"2258",2017-08-01 20:24:01,224943.07,412458.43
"2259",2017-08-01 20:26:28,-412458.43,5.82076609134674e-11
"2260",2017-08-02 05:34:28,155464.44,155464.44
"2261",2017-08-02 05:40:08,-155464.44,5.82076609134674e-11
"2262",2017-08-02 06:17:52,162766.95,162766.95
"2263",2017-08-02 06:19:49,154498.17,317265.12
"2264",2017-08-02 06:19:49,357418.31,674683.43
"2265",2017-08-02 06:23:37,-162766.95,511916.48
"2266",2017-08-02 06:29:09,-511916.48,1.74622982740402e-10
"2267",2017-08-02 07:44:12,146573.7,146573.7
"2268",2017-08-02 07:57:04,-146573.7,1.74622982740402e-10
"2269",2017-08-02 12:11:18,170861.4,170861.4
"2270",2017-08-02 12:24:51,-170861.4,1.74622982740402e-10
"2271",2017-08-02 12:59:25,178693.61,178693.61
"2272",2017-08-02 13:06:15,-178693.61,1.74622982740402e-10
"2273",2017-08-02 15:25:26,19340.03,19340.0300000002
"2274",2017-08-02 15:32:15,-19340.03,1.74622982740402e-10
"2275",2017-08-02 15:48:23,10147.83,10147.8300000002
"2276",2017-08-02 15:51:36,-10147.83,1.74622982740402e-10
"2277",2017-08-02 15:53:03,134567.25,134567.25
"2278",2017-08-02 15:59:03,-134567.25,1.74622982740402e-10
"2279",2017-08-03 03:39:15,139818.65,139818.65
"2280",2017-08-03 03:39:15,9357.21,149175.86
"2281",2017-08-03 03:39:15,141574.68,290750.54
"2282",2017-08-03 03:39:15,88994.5,379745.04
"2283",2017-08-03 04:22:14,121592.55,501337.59
"2284",2017-08-03 04:46:54,-379745.04,121592.55
"2285",2017-08-03 04:55:16,-121592.55,1.60071067512035e-10
"2286",2017-08-03 06:09:18,90158.15,90158.1500000002
"2287",2017-08-03 06:09:18,18753.97,108912.12
"2288",2017-08-03 06:23:49,-108912.12,1.60071067512035e-10
"2289",2017-08-04 12:21:57,55488.6,55488.6000000002
"2290",2017-08-04 12:29:11,-55488.6,1.60071067512035e-10
"2291",2017-08-04 13:58:31,122509.19,122509.19
"2292",2017-08-04 14:09:01,-122509.19,1.60071067512035e-10
"2293",2017-08-04 14:35:00,13625.79,13625.7900000002
"2294",2017-08-04 14:35:00,131228.8,144854.59
"2295",2017-08-04 14:42:32,-144854.59,1.45519152283669e-10
"2296",2017-08-04 14:53:28,12084.85,12084.8500000001
"2297",2017-08-04 14:53:28,123425.82,135510.67
"2298",2017-08-04 14:56:24,-135510.67,1.45519152283669e-10
"2299",2017-08-04 15:25:37,108059.91,108059.91
"2300",2017-08-04 15:28:52,-108059.91,1.45519152283669e-10
"2301",2017-08-04 16:13:23,137254.43,137254.43
"2302",2017-08-04 16:18:24,-137254.43,1.45519152283669e-10
"2303",2017-08-04 17:27:43,103496.16,103496.16
"2304",2017-08-04 17:31:15,-103496.16,1.45519152283669e-10
"2305",2017-08-05 01:40:17,128940.71,128940.71
"2306",2017-08-05 01:45:09,-128940.71,1.45519152283669e-10
"2307",2017-08-05 02:40:21,298952.01,298952.01
"2308",2017-08-05 02:46:40,153526.06,452478.07
"2309",2017-08-05 02:46:40,-298952.01,153526.06
"2310",2017-08-05 02:52:36,-153526.06,1.16415321826935e-10
"2311",2017-08-05 03:06:48,377884.12,377884.12
"2312",2017-08-05 03:20:05,-377884.12,1.16415321826935e-10
"2313",2017-08-05 04:03:47,182830.04,182830.04
"2314",2017-08-05 04:11:56,147066.76,329896.8
"2315",2017-08-05 04:11:56,149263.9,479160.7
"2316",2017-08-05 04:11:56,-182830.04,296330.66
"2317",2017-08-05 04:35:29,-296330.66,1.74622982740402e-10
"2318",2017-08-05 04:38:49,300107.23,300107.23
"2319",2017-08-05 04:43:25,-300107.23,1.74622982740402e-10
"2320",2017-08-05 06:08:54,88995.31,88995.3100000002
"2321",2017-08-05 06:32:36,77884.24,166879.55
"2322",2017-08-05 06:32:36,264684.18,431563.73
"2323",2017-08-05 06:32:36,198992.68,630556.41
"2324",2017-08-05 07:06:53,-88995.31,541561.1
"2325",2017-08-05 07:13:55,-541561.1,1.16415321826935e-10
"2326",2017-08-05 08:27:34,441254.16,441254.16
"2327",2017-08-05 08:37:35,-441254.16,1.16415321826935e-10
"2328",2017-08-05 09:54:46,141140.49,141140.49
"2329",2017-08-05 09:59:31,-141140.49,1.16415321826935e-10
"2330",2017-08-05 10:02:01,143566.49,143566.49
"2331",2017-08-05 10:14:12,-143566.49,1.16415321826935e-10
"2332",2017-08-05 11:56:45,153459.92,153459.92
"2333",2017-08-05 12:03:05,-153459.92,1.16415321826935e-10
"2334",2017-08-05 17:49:33,14973.36,14973.3600000001
"2335",2017-08-05 17:49:33,182096,197069.36
"2336",2017-08-05 18:11:35,-197069.36,1.16415321826935e-10
"2337",2017-08-05 18:28:04,194697.03,194697.03
"2338",2017-08-05 19:23:10,-194697.03,1.16415321826935e-10
"2339",2017-08-05 21:33:29,224329.79,224329.79
"2340",2017-08-05 21:44:33,-224329.79,1.16415321826935e-10
"2341",2017-08-06 00:17:21,36093.69,36093.6900000001
"2342",2017-08-06 00:20:12,-36093.69,1.16415321826935e-10
"2343",2017-08-06 01:21:50,179531.81,179531.81
"2344",2017-08-06 01:36:45,186831.45,366363.26
"2345",2017-08-06 01:36:45,-179531.81,186831.45
"2346",2017-08-06 01:42:47,-186831.45,1.16415321826935e-10
"2347",2017-08-06 03:26:55,276063.86,276063.86
"2348",2017-08-06 03:26:55,12978.58,289042.44
"2349",2017-08-06 03:26:55,144462.88,433505.32
"2350",2017-08-06 03:41:59,183579.9,617085.22
"2351",2017-08-06 03:41:59,300107.66,917192.88
"2352",2017-08-06 03:41:59,-433505.32,483687.56
"2353",2017-08-06 04:02:44,426813.9,910501.46
"2354",2017-08-06 04:02:44,-483687.56,426813.9
"2355",2017-08-06 04:23:43,-426813.9,1.74622982740402e-10
"2356",2017-08-06 04:51:54,263612.82,263612.82
"2357",2017-08-06 05:19:24,-263612.82,1.74622982740402e-10
"2358",2017-08-06 07:06:06,342073.4,342073.4
"2359",2017-08-06 07:29:11,-342073.4,1.74622982740402e-10
"2360",2017-08-07 02:40:14,295039.62,295039.62
"2361",2017-08-07 02:51:05,-295039.62,1.74622982740402e-10
"2362",2017-08-07 12:12:47,460331.17,460331.17
"2363",2017-08-07 12:33:43,-460331.17,1.74622982740402e-10
"2364",2017-08-07 14:40:57,255465.17,255465.17
"2365",2017-08-07 14:50:48,-255465.17,1.74622982740402e-10
"2366",2017-08-07 15:12:18,408109.37,408109.37
"2367",2017-08-07 15:23:40,-408109.37,1.74622982740402e-10
"2368",2017-08-07 23:21:11,13705.39,13705.3900000002
"2369",2017-08-08 01:06:05,-13705.39,1.74622982740402e-10
"2370",2017-08-08 06:43:10,127011.73,127011.73
"2371",2017-08-08 06:46:38,-127011.73,1.74622982740402e-10
"2372",2017-08-08 10:12:47,269701.81,269701.81
"2373",2017-08-08 10:18:39,-269701.81,1.74622982740402e-10
"2374",2017-08-08 11:29:36,191572.12,191572.12
"2375",2017-08-08 11:57:36,-191572.12,1.74622982740402e-10
"2376",2017-08-08 15:08:40,284256.51,284256.51
"2377",2017-08-08 15:13:04,-284256.51,1.74622982740402e-10
"2378",2017-08-08 17:55:34,196987.58,196987.58
"2379",2017-08-08 18:03:03,-196987.58,1.74622982740402e-10
"2380",2017-08-09 08:58:43,106075.09,106075.09
"2381",2017-08-09 09:49:47,281726.13,387801.22
"2382",2017-08-09 09:49:47,-106075.09,281726.13
"2383",2017-08-09 10:04:28,-281726.13,2.3283064365387e-10
"2384",2017-08-09 10:45:56,334960.61,334960.61
"2385",2017-08-09 10:55:57,184758.61,519719.22
"2386",2017-08-09 10:55:57,-334960.61,184758.61
"2387",2017-08-09 11:10:21,-184758.61,2.3283064365387e-10
"2388",2017-08-09 12:50:58,375024.74,375024.74
"2389",2017-08-09 13:08:34,-375024.74,2.3283064365387e-10
"2390",2017-08-09 14:40:14,408282.46,408282.46
"2391",2017-08-09 14:47:10,-408282.46,2.3283064365387e-10
"2392",2017-08-09 15:17:14,322048.43,322048.43
"2393",2017-08-09 15:52:07,-322048.43,2.3283064365387e-10
"2394",2017-08-10 09:22:06,120793.45,120793.45
"2395",2017-08-10 09:36:10,-120793.45,2.3283064365387e-10
"2396",2017-08-11 00:38:29,96116.76,96116.7600000002
"2397",2017-08-11 00:38:29,206532.98,302649.74
"2398",2017-08-11 00:38:51,127687.36,430337.1
"2399",2017-08-11 01:52:00,412568.92,842906.02
"2400",2017-08-11 01:55:00,-430337.1,412568.92
"2401",2017-08-11 02:13:24,-412568.92,2.91038304567337e-10
"2402",2017-08-11 04:10:50,157169.92,157169.92
"2403",2017-08-11 04:21:33,-157169.92,2.91038304567337e-10
"2404",2017-08-11 05:54:13,391152.25,391152.25
"2405",2017-08-11 05:58:33,-391152.25,2.91038304567337e-10
"2406",2017-08-11 08:06:22,163620.22,163620.22
"2407",2017-08-11 08:22:10,-163620.22,2.91038304567337e-10
"2408",2017-08-11 12:30:52,188270.25,188270.25
"2409",2017-08-11 13:03:06,-188270.25,2.91038304567337e-10
"2410",2017-08-11 18:10:35,332305.07,332305.07
"2411",2017-08-11 18:16:42,-332305.07,2.91038304567337e-10
"2412",2017-08-11 19:24:08,192472.42,192472.42
"2413",2017-08-11 19:26:29,-192472.42,2.91038304567337e-10
"2414",2017-08-11 21:52:30,259632.64,259632.64
"2415",2017-08-11 22:07:12,38437.09,298069.73
"2416",2017-08-11 22:07:12,112804.39,410874.12
"2417",2017-08-11 22:07:12,-259632.64,151241.48
"2418",2017-08-11 22:14:17,-151241.48,3.20142135024071e-10
"2419",2017-08-11 22:17:10,191606.62,191606.62
"2420",2017-08-11 22:48:32,-191606.62,3.20142135024071e-10
"2421",2017-08-11 22:48:32,340204.63,340204.63
"2422",2017-08-11 23:10:32,-340204.63,3.49245965480804e-10
"2423",2017-08-11 23:22:18,182617.66,182617.66
"2424",2017-08-11 23:25:45,-182617.66,3.49245965480804e-10
"2425",2017-08-11 23:57:50,13961.08,13961.0800000003
"2426",2017-08-11 23:57:50,90704.99,104666.07
"2427",2017-08-11 23:57:50,191574.47,296240.54
"2428",2017-08-11 23:57:50,103149.44,399389.98
"2429",2017-08-12 00:03:29,-399389.98,4.07453626394272e-10
"2430",2017-08-12 00:17:15,265691.68,265691.68
"2431",2017-08-12 00:25:36,-265691.68,4.07453626394272e-10
"2432",2017-08-12 01:02:05,284402.87,284402.87
"2433",2017-08-12 02:00:32,-284402.87,4.07453626394272e-10
"2434",2017-08-12 05:22:16,137737.58,137737.58
"2435",2017-08-12 05:22:16,101498.48,239236.06
"2436",2017-08-12 05:39:21,-239236.06,4.07453626394272e-10
"2437",2017-08-12 07:20:29,9833.07,9833.07000000041
"2438",2017-08-12 07:20:29,93550.41,103383.48
"2439",2017-08-12 07:39:25,-103383.48,4.22005541622639e-10
"2440",2017-08-12 11:01:37,135203.65,135203.65
"2441",2017-08-12 11:06:35,-135203.65,4.36557456851006e-10
"2442",2017-08-12 11:06:35,129014.97,129014.97
"2443",2017-08-12 11:14:43,-129014.97,4.36557456851006e-10
"2444",2017-08-12 13:12:58,100060.97,100060.97
"2445",2017-08-12 13:18:37,-100060.97,4.36557456851006e-10
"2446",2017-08-12 13:51:58,231008.55,231008.55
"2447",2017-08-12 14:53:07,247347.79,478356.34
"2448",2017-08-12 15:01:14,-231008.55,247347.79
"2449",2017-08-12 15:14:45,202830.9,450178.69
"2450",2017-08-12 15:40:14,144692.8,594871.49
"2451",2017-08-12 15:40:14,-247347.79,347523.7
"2452",2017-08-12 16:05:56,-347523.7,4.07453626394272e-10
"2453",2017-08-12 16:54:50,10685.16,10685.1600000004
"2454",2017-08-12 16:54:50,127532.86,138218.02
"2455",2017-08-12 16:54:50,130378.43,268596.45
"2456",2017-08-12 16:54:50,160853.97,429450.42
"2457",2017-08-12 17:12:21,-429450.42,4.07453626394272e-10
"2458",2017-08-12 18:38:14,473385.74,473385.74
"2459",2017-08-12 18:45:08,-473385.74,4.07453626394272e-10
"2460",2017-08-12 19:38:07,100267.63,100267.63
"2461",2017-08-12 19:50:21,-100267.63,4.07453626394272e-10
"2462",2017-08-12 20:17:04,207901.9,207901.9
"2463",2017-08-12 20:22:07,-207901.9,4.07453626394272e-10
"2464",2017-08-12 20:36:19,152732.09,152732.09
"2465",2017-08-12 20:36:19,159395.93,312128.02
"2466",2017-08-12 20:36:19,210949.55,523077.57
"2467",2017-08-12 20:52:01,390688.29,913765.86
"2468",2017-08-12 20:52:01,-523077.57,390688.29
"2469",2017-08-12 21:13:54,300111.3,690799.59
"2470",2017-08-12 21:13:54,175150.43,865950.02
"2471",2017-08-12 21:13:54,-390688.29,475261.73
"2472",2017-08-12 21:22:56,-475261.73,2.91038304567337e-10
"2473",2017-08-12 23:32:39,344297.09,344297.09
"2474",2017-08-12 23:49:26,-344297.09,2.91038304567337e-10
"2475",2017-08-13 00:12:21,149103.8,149103.8
"2476",2017-08-13 00:34:36,-149103.8,2.91038304567337e-10
"2477",2017-08-13 02:11:50,145235,145235
"2478",2017-08-13 02:19:54,-145235,2.91038304567337e-10
"2479",2017-08-13 02:39:42,153830.95,153830.95
"2480",2017-08-13 02:39:42,189508.99,343339.94
"2481",2017-08-13 02:54:37,-343339.94,2.91038304567337e-10
"2482",2017-08-13 03:07:53,309929.94,309929.94
"2483",2017-08-13 03:16:25,-309929.94,2.91038304567337e-10
"2484",2017-08-13 04:03:25,253245.53,253245.53
"2485",2017-08-13 04:07:34,-253245.53,2.91038304567337e-10
"2486",2017-08-13 04:33:04,289212.42,289212.42
"2487",2017-08-13 05:19:58,245126.38,534338.8
"2488",2017-08-13 05:19:58,-289212.42,245126.38
"2489",2017-08-13 05:30:33,-245126.38,2.91038304567337e-10
"2490",2017-08-13 07:09:18,269823.85,269823.85
"2491",2017-08-13 07:23:20,-269823.85,2.91038304567337e-10
"2492",2017-08-13 08:03:00,201440.26,201440.26
"2493",2017-08-13 08:13:11,-201440.26,2.91038304567337e-10
"2494",2017-08-13 08:28:18,170330.54,170330.54
"2495",2017-08-13 08:39:24,163156.04,333486.58
"2496",2017-08-13 08:39:24,168977.4,502463.98
"2497",2017-08-13 08:52:58,-170330.54,332133.44
"2498",2017-08-13 09:13:09,-332133.44,2.91038304567337e-10
"2499",2017-08-13 12:00:48,148105.48,148105.48
"2500",2017-08-13 12:09:28,-148105.48,2.91038304567337e-10
"2501",2017-08-13 12:26:18,39216.94,39216.9400000003
"2502",2017-08-13 12:34:49,-39216.94,2.91038304567337e-10
"2503",2017-08-13 12:37:44,234798.19,234798.19
"2504",2017-08-13 12:40:07,-234798.19,2.91038304567337e-10
"2505",2017-08-13 12:48:47,214489.48,214489.48
"2506",2017-08-13 12:55:45,-214489.48,2.91038304567337e-10
"2507",2017-08-13 13:38:02,310407.12,310407.12
"2508",2017-08-13 13:43:28,-310407.12,2.91038304567337e-10
"2509",2017-08-13 14:46:45,171836.48,171836.48
"2510",2017-08-13 15:00:07,-171836.48,2.91038304567337e-10
"2511",2017-08-13 15:28:36,250131.13,250131.13
"2512",2017-08-13 15:46:38,-250131.13,2.91038304567337e-10
"2513",2017-08-13 16:05:09,168900.16,168900.16
"2514",2017-08-13 16:14:02,-168900.16,2.91038304567337e-10
"2515",2017-08-13 16:16:00,224476.86,224476.86
"2516",2017-08-13 16:38:29,236796.53,461273.39
"2517",2017-08-13 16:38:29,-224476.86,236796.53
"2518",2017-08-13 17:03:30,-236796.53,2.61934474110603e-10
"2519",2017-08-13 18:20:55,269388.63,269388.63
"2520",2017-08-13 18:33:15,-269388.63,2.3283064365387e-10
"2521",2017-08-13 18:48:10,323390.57,323390.57
"2522",2017-08-13 18:55:30,-323390.57,2.3283064365387e-10
"2523",2017-08-13 20:15:48,172550.3,172550.3
"2524",2017-08-13 20:15:48,162524.49,335074.79
"2525",2017-08-13 20:29:47,-335074.79,2.3283064365387e-10
"2526",2017-08-13 20:58:23,178371.33,178371.33
"2527",2017-08-13 21:02:10,-178371.33,2.3283064365387e-10
"2528",2017-08-13 21:37:12,488037.58,488037.58
"2529",2017-08-13 21:41:40,-488037.58,2.3283064365387e-10
"2530",2017-08-13 22:11:07,256436.13,256436.13
"2531",2017-08-13 22:14:57,-256436.13,2.3283064365387e-10
"2532",2017-08-14 10:13:53,344515.34,344515.34
"2533",2017-08-14 10:58:11,-344515.34,2.3283064365387e-10
"2534",2017-08-14 12:21:46,436080.23,436080.23
"2535",2017-08-14 13:02:48,-436080.23,2.3283064365387e-10
"2536",2017-08-15 03:09:01,172179.49,172179.49
"2537",2017-08-15 03:15:48,-172179.49,2.3283064365387e-10
"2538",2017-08-15 04:49:13,239791.23,239791.23
"2539",2017-08-15 04:56:57,123296.79,363088.02
"2540",2017-08-15 04:56:57,-239791.23,123296.79
"2541",2017-08-15 05:08:20,-123296.79,2.47382558882236e-10
"2542",2017-08-15 06:34:35,173465.16,173465.16
"2543",2017-08-15 06:34:35,195568.73,369033.89
"2544",2017-08-15 06:46:53,178773.71,547807.6
"2545",2017-08-15 06:46:53,165129.41,712937.01
"2546",2017-08-15 06:46:53,-369033.89,343903.12
"2547",2017-08-15 06:53:30,147255.12,491158.24
"2548",2017-08-15 06:53:30,-343903.12,147255.12
"2549",2017-08-15 07:03:53,133027.51,280282.63
"2550",2017-08-15 07:03:53,-147255.12,133027.51
"2551",2017-08-15 07:13:12,-133027.51,2.3283064365387e-10
"2552",2017-08-15 07:53:44,84935.42,84935.4200000002
"2553",2017-08-15 08:14:42,-84935.42,2.3283064365387e-10
"2554",2017-08-15 08:14:42,159518.04,159518.04
"2555",2017-08-15 08:21:19,-159518.04,2.3283064365387e-10
"2556",2017-08-15 08:24:18,175202.88,175202.88
"2557",2017-08-15 08:41:42,-175202.88,2.3283064365387e-10
"2558",2017-08-15 08:59:39,95504.67,95504.6700000002
"2559",2017-08-15 09:15:28,260784.56,356289.23
"2560",2017-08-15 09:15:28,132581.19,488870.42
"2561",2017-08-15 09:15:28,116705.65,605576.07
"2562",2017-08-15 09:15:28,-95504.67,510071.4
"2563",2017-08-15 09:24:06,-510071.4,1.74622982740402e-10
"2564",2017-08-15 09:31:27,82537.75,82537.7500000002
"2565",2017-08-15 09:53:58,90563.08,173100.83
"2566",2017-08-15 09:53:58,280929.09,454029.92
"2567",2017-08-15 09:53:58,111814.34,565844.26
"2568",2017-08-15 09:53:58,316635.62,882479.88
"2569",2017-08-15 09:53:58,-82537.75,799942.13
"2570",2017-08-15 10:04:59,-799942.13,2.3283064365387e-10
"2571",2017-08-15 10:33:16,14945.09,14945.0900000002
"2572",2017-08-15 10:33:16,204654.01,219599.1
"2573",2017-08-15 10:33:16,162879.01,382478.11
"2574",2017-08-15 10:33:16,327063.07,709541.18
"2575",2017-08-15 10:49:04,-709541.18,1.16415321826935e-10
"2576",2017-08-15 11:42:39,220293.59,220293.59
"2577",2017-08-15 11:49:02,-220293.59,1.16415321826935e-10
"2578",2017-08-15 12:44:20,222514.19,222514.19
"2579",2017-08-15 12:44:20,287331.07,509845.26
"2580",2017-08-15 12:44:20,255524.59,765369.85
"2581",2017-08-15 12:48:03,-765369.85,1.16415321826935e-10
"2582",2017-08-15 12:56:13,269242.86,269242.86
"2583",2017-08-15 13:02:56,-269242.86,1.16415321826935e-10
"2584",2017-08-15 13:02:56,216812.23,216812.23
"2585",2017-08-15 13:02:56,117478.25,334290.48
"2586",2017-08-15 13:14:08,68351.5,402641.98
"2587",2017-08-15 13:14:08,133176.93,535818.91
"2588",2017-08-15 13:14:08,-334290.48,201528.43
"2589",2017-08-15 13:29:14,121919.6,323448.03
"2590",2017-08-15 13:29:14,-201528.43,121919.6
"2591",2017-08-15 13:44:52,-121919.6,1.45519152283669e-10
"2592",2017-08-15 13:44:52,211570.66,211570.66
"2593",2017-08-15 13:51:06,106037.74,317608.4
"2594",2017-08-15 13:51:06,126500.95,444109.35
"2595",2017-08-15 14:13:19,211592.97,655702.32
"2596",2017-08-15 14:13:19,71194.68,726897
"2597",2017-08-15 14:13:19,-211570.66,515326.34
"2598",2017-08-15 14:24:53,124215.58,639541.92
"2599",2017-08-15 14:24:53,-515326.34,124215.58
"2600",2017-08-15 14:41:45,-124215.58,1.30967237055302e-10
"2601",2017-08-15 15:07:57,293645.6,293645.6
"2602",2017-08-15 15:07:57,360947.6,654593.2
"2603",2017-08-15 15:07:57,262472.98,917066.18
"2604",2017-08-15 15:07:57,162486.05,1079552.23
"2605",2017-08-15 15:23:52,362528.93,1442081.16
"2606",2017-08-15 15:23:52,-1079552.23,362528.93
"2607",2017-08-15 15:39:09,-362528.93,-5.82076609134674e-11
"2608",2017-08-15 16:12:53,15090.4,15090.3999999999
"2609",2017-08-15 16:12:53,275530.88,290621.28
"2610",2017-08-15 16:22:57,-290621.28,-5.82076609134674e-11
"2611",2017-08-15 16:42:33,177439.65,177439.65
"2612",2017-08-15 16:58:27,-177439.65,-5.82076609134674e-11
"2613",2017-08-15 16:58:27,94495.02,94495.0199999999
"2614",2017-08-15 16:58:27,88700.92,183195.94
"2615",2017-08-15 17:11:47,96785.19,279981.13
"2616",2017-08-15 17:11:47,-183195.94,96785.1899999999
"2617",2017-08-15 17:47:40,262993.44,359778.63
"2618",2017-08-15 17:55:56,-96785.19,262993.44
"2619",2017-08-15 18:12:50,202947.06,465940.5
"2620",2017-08-15 18:12:50,-262993.44,202947.06
"2621",2017-08-15 18:17:20,-202947.06,-5.82076609134674e-11
"2622",2017-08-15 18:33:32,12019.38,12019.3799999999
"2623",2017-08-15 18:51:48,-12019.38,-5.82076609134674e-11
"2624",2017-08-15 20:33:02,230485.61,230485.61
"2625",2017-08-15 20:36:56,163408.9,393894.51
"2626",2017-08-15 20:41:01,-230485.61,163408.9
"2627",2017-08-15 21:00:30,-163408.9,-8.73114913702011e-11
"2628",2017-08-15 23:24:36,126516.51,126516.51
"2629",2017-08-15 23:40:11,104411.07,230927.58
"2630",2017-08-15 23:40:11,-126516.51,104411.07
"2631",2017-08-15 23:47:43,-104411.07,-1.01863406598568e-10
"2632",2017-08-16 01:49:33,105247.32,105247.32
"2633",2017-08-16 01:58:05,-105247.32,-1.01863406598568e-10
"2634",2017-08-16 03:33:05,140221.05,140221.05
"2635",2017-08-16 03:40:50,-140221.05,-1.16415321826935e-10
"2636",2017-08-16 06:35:13,221019.11,221019.11
"2637",2017-08-16 06:35:13,88515.62,309534.73
"2638",2017-08-16 06:53:20,156048.21,465582.94
"2639",2017-08-16 07:15:39,-309534.73,156048.21
"2640",2017-08-16 08:15:22,196825.82,352874.03
"2641",2017-08-16 08:18:23,-156048.21,196825.82
"2642",2017-08-16 09:30:56,-196825.82,-1.45519152283669e-10
"2643",2017-08-16 09:30:56,306847.89,306847.89
"2644",2017-08-16 09:30:56,263470.66,570318.55
"2645",2017-08-16 09:52:22,-570318.55,-2.3283064365387e-10
"2646",2017-08-16 15:38:09,250146.89,250146.89
"2647",2017-08-16 15:41:12,-250146.89,-2.3283064365387e-10
"2648",2017-08-16 17:24:47,147738.99,147738.99
"2649",2017-08-16 17:24:47,154378.56,302117.55
"2650",2017-08-16 17:24:47,315445.92,617563.47
"2651",2017-08-16 17:24:47,134015.59,751579.06
"2652",2017-08-16 17:58:12,-751579.06,-3.49245965480804e-10
"2653",2017-08-16 18:24:42,150499.86,150499.86
"2654",2017-08-16 18:50:47,-150499.86,-3.49245965480804e-10
"2655",2017-08-16 18:50:47,155412.61,155412.61
"2656",2017-08-16 18:50:47,138421,293833.61
"2657",2017-08-16 18:50:47,149209.56,443043.17
"2658",2017-08-16 18:50:47,117616.59,560659.76
"2659",2017-08-16 19:07:47,-560659.76,-3.49245965480804e-10
"2660",2017-08-16 19:07:47,130488.73,130488.73
"2661",2017-08-16 19:07:47,198613.1,329101.83
"2662",2017-08-16 19:30:34,-329101.83,-3.49245965480804e-10
"2663",2017-08-17 00:48:58,251513.74,251513.74
"2664",2017-08-17 00:58:29,-251513.74,-3.49245965480804e-10
"2665",2017-08-17 03:51:48,173239.62,173239.62
"2666",2017-08-17 03:51:48,251298.79,424538.41
"2667",2017-08-17 07:07:08,-424538.41,-2.91038304567337e-10
"2668",2017-08-17 16:47:08,217139.88,217139.88
"2669",2017-08-17 16:53:54,-217139.88,-2.91038304567337e-10
"2670",2017-08-17 20:23:00,137824.92,137824.92
"2671",2017-08-17 20:23:00,71061.16,208886.08
"2672",2017-08-17 20:30:05,68855.38,277741.46
"2673",2017-08-17 20:30:05,-208886.08,68855.3799999997
"2674",2017-08-17 20:35:33,66385.74,135241.12
"2675",2017-08-17 20:41:38,106251.95,241493.07
"2676",2017-08-17 20:41:38,87050.31,328543.38
"2677",2017-08-17 20:41:38,-68855.38,259688
"2678",2017-08-17 20:58:51,-259688,-2.3283064365387e-10
"2679",2017-08-17 21:37:36,140891.79,140891.79
"2680",2017-08-17 21:39:55,-140891.79,-2.3283064365387e-10
"2681",2017-08-17 23:48:00,62596.26,62596.2599999998
"2682",2017-08-17 23:48:00,15612.22,78208.4799999998
"2683",2017-08-17 23:52:48,-78208.48,-2.3283064365387e-10
"2684",2017-08-18 00:32:06,6189.63,6189.62999999977
"2685",2017-08-18 00:32:06,73153.28,79342.9099999998
"2686",2017-08-18 00:32:06,36504.87,115847.78
"2687",2017-08-18 00:43:27,-115847.78,-2.3283064365387e-10
"2688",2017-08-18 00:50:34,5238.58,5238.57999999977
"2689",2017-08-18 01:09:52,127004.62,132243.2
"2690",2017-08-18 01:09:52,-5238.58,127004.62
"2691",2017-08-18 01:21:33,-127004.62,-2.47382558882236e-10
"2692",2017-08-18 02:03:20,84228.62,84228.6199999997
"2693",2017-08-18 02:03:20,63821.15,148049.77
"2694",2017-08-18 02:03:20,69503.84,217553.61
"2695",2017-08-18 02:03:20,48878.49,266432.1
"2696",2017-08-18 02:06:44,67097.58,333529.68
"2697",2017-08-18 02:16:58,52161.41,385691.09
"2698",2017-08-18 02:16:58,-266432.1,119258.99
"2699",2017-08-18 02:26:01,-119258.99,-2.47382558882236e-10
"2700",2017-08-18 04:38:06,54794.72,54794.7199999998
"2701",2017-08-18 04:42:12,-54794.72,-2.47382558882236e-10
"2702",2017-08-18 07:05:36,76490,76489.9999999998
"2703",2017-08-18 07:21:05,-76490,-2.47382558882236e-10
"2704",2017-08-18 07:55:31,55164.13,55164.1299999997
"2705",2017-08-18 08:17:01,-55164.13,-2.47382558882236e-10
"2706",2017-08-18 09:10:27,71308.44,71308.4399999998
"2707",2017-08-18 10:28:24,62229.84,133538.28
"2708",2017-08-18 10:28:24,-71308.44,62229.8399999997
"2709",2017-08-18 10:37:27,-62229.84,-2.61934474110603e-10
"2710",2017-08-18 11:04:08,135665.51,135665.51
"2711",2017-08-18 11:04:08,80401.56,216067.07
"2712",2017-08-18 11:08:56,-216067.07,-2.61934474110603e-10
"2713",2017-08-18 12:38:32,109946.65,109946.65
"2714",2017-08-18 12:43:30,-109946.65,-2.61934474110603e-10
"2715",2017-08-18 13:21:47,87044.41,87044.4099999997
"2716",2017-08-18 13:40:59,-87044.41,-2.61934474110603e-10
"2717",2017-08-18 14:46:07,85979.16,85979.1599999997
"2718",2017-08-18 15:00:53,-85979.16,-2.61934474110603e-10
"2719",2017-08-18 15:00:53,98856.12,98856.1199999997
"2720",2017-08-18 15:25:32,-98856.12,-2.61934474110603e-10
"2721",2017-08-18 15:39:35,108978.25,108978.25
"2722",2017-08-18 15:39:35,92809.2,201787.45
"2723",2017-08-18 15:53:41,-201787.45,-2.91038304567337e-10
"2724",2017-08-18 16:42:59,60632.34,60632.3399999997
"2725",2017-08-18 16:55:37,67735.47,128367.81
"2726",2017-08-18 16:55:37,48538.7,176906.51
"2727",2017-08-18 16:55:37,-60632.34,116274.17
"2728",2017-08-18 17:01:58,-116274.17,-2.7648638933897e-10
"2729",2017-08-18 18:02:25,173268.12,173268.12
"2730",2017-08-18 18:02:25,138943.03,312211.15
"2731",2017-08-18 18:02:25,62838.32,375049.47
"2732",2017-08-18 18:09:51,-375049.47,-2.91038304567337e-10
"2733",2017-08-18 18:09:51,59977.57,59977.5699999997
"2734",2017-08-18 18:19:32,-59977.57,-2.91038304567337e-10
"2735",2017-08-18 18:45:47,19910.6,19910.5999999997
"2736",2017-08-18 18:45:47,56445.6,76356.1999999997
"2737",2017-08-18 18:49:06,-76356.2,-2.91038304567337e-10
"2738",2017-08-18 18:58:34,373447.3,373447.3
"2739",2017-08-18 19:04:06,-373447.3,-2.91038304567337e-10
"2740",2017-08-18 19:13:25,156097.39,156097.39
"2741",2017-08-18 19:21:00,-156097.39,-2.91038304567337e-10
"2742",2017-08-18 19:21:00,134025.33,134025.33
"2743",2017-08-18 19:35:03,137893.95,271919.28
"2744",2017-08-18 19:35:03,49695.44,321614.72
"2745",2017-08-18 19:35:03,-134025.33,187589.39
"2746",2017-08-18 19:47:32,-187589.39,-3.20142135024071e-10
"2747",2017-08-18 19:52:59,105050.4,105050.4
"2748",2017-08-18 20:02:42,-105050.4,-3.20142135024071e-10
"2749",2017-08-18 20:02:42,95872.36,95872.3599999997
"2750",2017-08-18 20:02:42,147472.14,243344.5
"2751",2017-08-18 20:02:42,127428.69,370773.19
"2752",2017-08-18 20:02:42,62123.84,432897.03
"2753",2017-08-18 20:15:03,-432897.03,-3.49245965480804e-10
"2754",2017-08-18 20:33:28,132853.42,132853.42
"2755",2017-08-18 20:39:14,-132853.42,-3.49245965480804e-10
"2756",2017-08-18 20:39:14,288724.88,288724.88
"2757",2017-08-18 20:53:52,17282.54,306007.42
"2758",2017-08-18 20:53:52,151741.05,457748.47
"2759",2017-08-18 20:53:52,-288724.88,169023.59
"2760",2017-08-18 21:08:33,-169023.59,-3.78349795937538e-10
"2761",2017-08-18 21:14:56,140541.77,140541.77
"2762",2017-08-18 21:23:00,-140541.77,-3.78349795937538e-10
"2763",2017-08-18 21:36:13,95503.41,95503.4099999996
"2764",2017-08-18 21:36:13,164497.14,260000.55
"2765",2017-08-18 22:07:51,-260000.55,-3.49245965480804e-10
"2766",2017-08-18 23:02:40,104130.58,104130.58
"2767",2017-08-18 23:02:40,99112.94,203243.52
"2768",2017-08-18 23:02:40,102758.1,306001.62
"2769",2017-08-18 23:02:40,129001.07,435002.69
"2770",2017-08-18 23:22:50,-435002.69,-3.49245965480804e-10
"2771",2017-08-19 00:15:58,183471.41,183471.41
"2772",2017-08-19 00:45:06,-183471.41,-3.49245965480804e-10
"2773",2017-08-19 01:46:01,128837.11,128837.11
"2774",2017-08-19 01:52:06,-128837.11,-3.49245965480804e-10
"2775",2017-08-19 02:22:07,110111.11,110111.11
"2776",2017-08-19 02:50:44,159639.66,269750.77
"2777",2017-08-19 02:50:44,-110111.11,159639.66
"2778",2017-08-19 03:04:36,-159639.66,-3.20142135024071e-10
"2779",2017-08-19 05:51:13,177712.34,177712.34
"2780",2017-08-19 05:52:58,196620.79,374333.13
"2781",2017-08-19 05:52:58,-177712.34,196620.79
"2782",2017-08-19 06:06:11,-196620.79,-3.49245965480804e-10
"2783",2017-08-19 06:59:07,186048.7,186048.7
"2784",2017-08-19 07:01:44,-186048.7,-3.49245965480804e-10
"2785",2017-08-19 09:21:13,155150.73,155150.73
"2786",2017-08-19 09:35:00,-155150.73,-3.49245965480804e-10
"2787",2017-08-19 09:58:44,235885.74,235885.74
"2788",2017-08-19 10:09:40,-235885.74,-3.49245965480804e-10
"2789",2017-08-19 10:39:59,16472.49,16472.4899999997
"2790",2017-08-19 11:02:30,-16472.49,-3.49245965480804e-10
"2791",2017-08-19 13:08:57,156529.96,156529.96
"2792",2017-08-19 13:24:00,363292.29,519822.25
"2793",2017-08-19 13:24:00,203424.9,723247.15
"2794",2017-08-19 13:24:00,-156529.96,566717.19
"2795",2017-08-19 13:31:16,-566717.19,-2.3283064365387e-10
"2796",2017-08-19 13:49:17,213922.4,213922.4
"2797",2017-08-19 14:21:20,24445.29,238367.69
"2798",2017-08-19 14:21:20,208282.62,446650.31
"2799",2017-08-19 14:21:20,-213922.4,232727.91
"2800",2017-08-19 14:39:05,-232727.91,-2.3283064365387e-10
"2801",2017-08-19 14:39:05,211601.76,211601.76
"2802",2017-08-19 14:52:01,-211601.76,-2.3283064365387e-10
"2803",2017-08-19 15:07:54,234553.75,234553.75
"2804",2017-08-19 15:10:02,-234553.75,-2.3283064365387e-10
"2805",2017-08-20 00:52:44,212593.34,212593.34
"2806",2017-08-20 00:56:54,-212593.34,-2.3283064365387e-10
"2807",2017-08-20 01:57:49,202254.51,202254.51
"2808",2017-08-20 02:11:57,-202254.51,-2.3283064365387e-10
"2809",2017-08-20 04:05:48,189895.22,189895.22
"2810",2017-08-20 04:49:15,-189895.22,-2.3283064365387e-10
"2811",2017-08-21 08:57:35,367651.65,367651.65
"2812",2017-08-21 09:36:44,-367651.65,-2.3283064365387e-10
"2813",2017-08-22 02:20:34,318837.84,318837.84
"2814",2017-08-22 02:20:34,428415.73,747253.57
"2815",2017-08-22 02:28:45,-747253.57,-1.16415321826935e-10
"2816",2017-08-22 04:35:50,480235.75,480235.75
"2817",2017-08-22 05:04:46,-480235.75,-1.16415321826935e-10
"2818",2017-08-22 05:04:46,385675.82,385675.82
"2819",2017-08-22 05:46:12,-385675.82,-1.16415321826935e-10
"2820",2017-08-22 06:22:03,179588.42,179588.42
"2821",2017-08-22 06:43:00,-179588.42,-1.16415321826935e-10
"2822",2017-08-22 07:00:31,84956.37,84956.3699999999
"2823",2017-08-22 07:17:53,-84956.37,-1.16415321826935e-10
"2824",2017-08-22 10:22:20,186787.93,186787.93
"2825",2017-08-22 10:45:18,-186787.93,-1.16415321826935e-10
"2826",2017-08-22 23:51:14,140736.92,140736.92
"2827",2017-08-23 00:23:56,183944.86,324681.78
"2828",2017-08-23 00:23:56,137600.61,462282.39
"2829",2017-08-23 00:42:46,-140736.92,321545.47
"2830",2017-08-23 00:56:57,-321545.47,-1.16415321826935e-10
"2831",2017-08-23 09:31:08,511547.53,511547.53
"2832",2017-08-23 10:01:05,-511547.53,-1.16415321826935e-10
"2833",2017-08-23 13:00:24,28788.88,28788.8799999999
"2834",2017-08-23 13:06:04,-28788.88,-1.16415321826935e-10
"2835",2017-08-23 13:16:07,333061.14,333061.14
"2836",2017-08-23 13:20:59,-333061.14,-1.16415321826935e-10
"2837",2017-08-23 13:38:25,264110.34,264110.34
"2838",2017-08-23 13:41:50,-264110.34,-1.16415321826935e-10
"2839",2017-08-23 13:55:52,443592.9,443592.9
"2840",2017-08-23 14:16:47,-443592.9,-1.16415321826935e-10
"2841",2017-08-24 15:26:45,479510.85,479510.85
"2842",2017-08-24 15:45:40,-479510.85,-1.16415321826935e-10
"2843",2017-08-24 23:20:54,327771.43,327771.43
"2844",2017-08-24 23:46:06,555630.86,883402.29
"2845",2017-08-24 23:46:06,-327771.43,555630.86
"2846",2017-08-24 23:52:29,-555630.86,-1.16415321826935e-10
"2847",2017-08-25 00:49:31,508806.19,508806.19
"2848",2017-08-25 00:52:33,-508806.19,-1.16415321826935e-10
"2849",2017-08-25 06:09:21,438445.14,438445.14
"2850",2017-08-25 06:18:24,-438445.14,-1.16415321826935e-10
"2851",2017-08-25 16:14:20,287857.6,287857.6
"2852",2017-08-25 16:14:20,364261.48,652119.08
"2853",2017-08-25 16:42:11,-652119.08,-1.16415321826935e-10
"2854",2017-08-25 20:12:04,322902.58,322902.58
"2855",2017-08-25 20:25:09,-322902.58,-1.16415321826935e-10
"2856",2017-08-25 20:34:51,248239.52,248239.52
"2857",2017-08-25 20:48:43,-248239.52,-1.16415321826935e-10
"2858",2017-08-27 03:01:20,417185.97,417185.97
"2859",2017-08-27 03:04:37,-417185.97,-1.16415321826935e-10
"2860",2017-08-27 18:08:41,265148.08,265148.08
"2861",2017-08-27 18:15:05,-265148.08,-1.16415321826935e-10
"2862",2017-08-28 00:32:03,281961.01,281961.01
"2863",2017-08-28 00:34:41,-281961.01,-1.16415321826935e-10
"2864",2017-08-28 04:56:01,495639.22,495639.22
"2865",2017-08-28 05:14:05,-495639.22,-1.16415321826935e-10
"2866",2017-08-28 05:34:34,324490.77,324490.77
"2867",2017-08-28 05:37:47,-324490.77,-1.16415321826935e-10
"2868",2017-08-29 14:02:13,282472.77,282472.77
"2869",2017-08-29 14:13:05,-282472.77,-1.16415321826935e-10
"2870",2017-08-29 14:37:54,193225.44,193225.44
"2871",2017-08-29 14:47:52,-193225.44,-1.16415321826935e-10
"2872",2017-08-29 14:52:41,193798.63,193798.63
"2873",2017-08-29 15:03:14,-193798.63,-1.16415321826935e-10
"2874",2017-08-29 15:23:25,219426.39,219426.39
"2875",2017-08-29 15:43:09,-219426.39,-1.16415321826935e-10
"2876",2017-08-29 16:05:25,245933.96,245933.96
"2877",2017-08-29 16:08:25,-245933.96,-1.16415321826935e-10
"2878",2017-08-29 16:37:25,18813.17,18813.1699999999
"2879",2017-08-29 17:09:21,432987.1,451800.27
"2880",2017-08-29 21:18:35,677580.58,1129380.85
"2881",2017-08-30 06:12:13,-1129380.85,-2.3283064365387e-10
"2882",2017-08-30 07:29:48,194573.31,194573.31
"2883",2017-08-30 07:31:35,-194573.31,-2.3283064365387e-10
"2884",2017-08-30 07:44:15,227694.77,227694.77
"2885",2017-08-30 08:46:39,-227694.77,-2.3283064365387e-10
"2886",2017-08-30 09:52:02,245795.96,245795.96
"2887",2017-08-30 10:00:22,-245795.96,-2.3283064365387e-10
"2888",2017-08-30 10:17:08,177297.9,177297.9
"2889",2017-08-30 10:35:37,275984.77,453282.67
"2890",2017-08-30 10:35:37,-177297.9,275984.77
"2891",2017-08-30 10:42:50,279721.55,555706.32
"2892",2017-08-30 10:42:50,-275984.77,279721.55
"2893",2017-08-30 10:50:03,-279721.55,-1.74622982740402e-10
"2894",2017-08-30 11:16:16,220223.71,220223.71
"2895",2017-08-30 11:26:44,-220223.71,-1.74622982740402e-10
"2896",2017-08-30 12:19:47,239567.23,239567.23
"2897",2017-08-30 12:22:07,-239567.23,-1.74622982740402e-10
"2898",2017-08-30 12:43:49,376637.85,376637.85
"2899",2017-08-30 12:54:11,-376637.85,-1.74622982740402e-10
"2900",2017-08-30 17:01:12,293212.64,293212.64
"2901",2017-08-30 17:50:05,375946.81,669159.45
"2902",2017-08-30 20:11:07,-669159.45,-1.16415321826935e-10
"2903",2017-08-30 23:02:30,201487.21,201487.21
"2904",2017-08-30 23:08:29,-201487.21,-1.16415321826935e-10
"2905",2017-08-31 01:51:59,161718.33,161718.33
"2906",2017-08-31 01:59:11,-161718.33,-1.16415321826935e-10
"2907",2017-08-31 03:21:08,157281.69,157281.69
"2908",2017-08-31 03:27:36,-157281.69,-1.16415321826935e-10
"2909",2017-08-31 06:14:33,129360.81,129360.81
"2910",2017-08-31 06:25:17,-129360.81,-1.16415321826935e-10
"2911",2017-08-31 07:19:10,127733.96,127733.96
"2912",2017-08-31 07:27:09,-127733.96,-1.16415321826935e-10
"2913",2017-08-31 10:22:19,156398.37,156398.37
"2914",2017-08-31 10:32:34,-156398.37,-1.16415321826935e-10
"2915",2017-08-31 10:52:43,167077.85,167077.85
"2916",2017-08-31 11:20:02,156053.97,323131.82
"2917",2017-08-31 11:36:57,-167077.85,156053.97
"2918",2017-08-31 11:48:00,-156053.97,-1.16415321826935e-10
"2919",2017-08-31 13:53:55,148676.1,148676.1
"2920",2017-08-31 13:53:55,287554.98,436231.08
"2921",2017-08-31 13:53:55,212099.25,648330.33
"2922",2017-08-31 14:06:19,-648330.33,-1.16415321826935e-10
"2923",2017-08-31 14:14:00,285328.19,285328.19
"2924",2017-08-31 14:21:09,-285328.19,-1.16415321826935e-10
"2925",2017-08-31 15:54:14,187076.11,187076.11
"2926",2017-08-31 16:12:16,239579.23,426655.34
"2927",2017-08-31 16:12:16,-187076.11,239579.23
"2928",2017-08-31 16:19:15,-239579.23,-1.45519152283669e-10
"2929",2017-08-31 16:25:17,120360.02,120360.02
"2930",2017-08-31 16:28:21,-120360.02,-1.45519152283669e-10
"2931",2017-08-31 18:04:56,124612.07,124612.07
"2932",2017-08-31 18:07:58,147129.04,271741.11
"2933",2017-08-31 19:22:15,135293.2,407034.31
"2934",2017-08-31 19:22:15,89028.32,496062.63
"2935",2017-08-31 19:22:15,130140.35,626202.98
"2936",2017-08-31 19:38:52,-124612.07,501590.91
"2937",2017-08-31 20:05:15,-501590.91,-1.16415321826935e-10
"2938",2017-08-31 21:26:57,105374.8,105374.8
"2939",2017-08-31 21:26:57,126077.01,231451.81
"2940",2017-08-31 21:26:57,105862.76,337314.57
"2941",2017-08-31 21:34:08,-337314.57,-1.16415321826935e-10
"2942",2017-08-31 21:52:09,161277.33,161277.33
"2943",2017-08-31 22:33:04,107097.47,268374.8
"2944",2017-08-31 22:33:04,146057.94,414432.74
"2945",2017-08-31 22:33:04,-161277.33,253155.41
"2946",2017-08-31 22:38:09,-253155.41,-1.16415321826935e-10
"2947",2017-08-31 22:53:06,111482,111482
"2948",2017-08-31 23:01:51,-111482,-1.16415321826935e-10
"2949",2017-08-31 23:41:52,122974.12,122974.12
"2950",2017-08-31 23:41:52,126842.85,249816.97
"2951",2017-08-31 23:44:56,-249816.97,-1.16415321826935e-10
"2952",2017-09-01 00:31:08,106965.48,106965.48
"2953",2017-09-01 00:39:27,196486.54,303452.02
"2954",2017-09-01 00:39:27,-106965.48,196486.54
"2955",2017-09-01 00:45:04,-196486.54,-8.73114913702011e-11
"2956",2017-09-01 01:18:09,104208.73,104208.73
"2957",2017-09-01 01:22:30,-104208.73,-8.73114913702011e-11
"2958",2017-09-01 01:55:04,113667.24,113667.24
"2959",2017-09-01 02:01:44,-113667.24,-8.73114913702011e-11
"2960",2017-09-01 02:33:30,112124.4,112124.4
"2961",2017-09-01 02:42:05,-112124.4,-8.73114913702011e-11
"2962",2017-09-01 02:55:06,156820.33,156820.33
"2963",2017-09-01 03:05:12,-156820.33,-8.73114913702011e-11
"2964",2017-09-01 06:25:58,146989.89,146989.89
"2965",2017-09-01 06:49:46,-146989.89,-8.73114913702011e-11
"2966",2017-09-01 08:49:36,145760.39,145760.39
"2967",2017-09-01 08:49:36,159383.65,305144.04
"2968",2017-09-01 08:54:20,131047.26,436191.3
"2969",2017-09-01 08:54:20,-305144.04,131047.26
"2970",2017-09-01 09:18:24,-131047.26,-4.36557456851006e-11
"2971",2017-09-01 09:30:17,170885.55,170885.55
"2972",2017-09-01 09:41:06,-170885.55,-5.82076609134674e-11
"2973",2017-09-01 10:29:44,165479.3,165479.3
"2974",2017-09-01 10:34:10,-165479.3,-5.82076609134674e-11
"2975",2017-09-01 11:38:16,145430.26,145430.26
"2976",2017-09-01 11:39:51,-145430.26,-5.82076609134674e-11
"2977",2017-09-01 12:22:54,189782.84,189782.84
"2978",2017-09-01 12:33:37,-189782.84,-5.82076609134674e-11
"2979",2017-09-01 12:52:02,176966.89,176966.89
"2980",2017-09-01 12:52:02,116509.55,293476.44
"2981",2017-09-01 13:04:12,140010.37,433486.81
"2982",2017-09-01 13:04:12,-293476.44,140010.37
"2983",2017-09-01 13:29:52,159864.29,299874.66
"2984",2017-09-01 13:29:52,-140010.37,159864.29
"2985",2017-09-01 13:40:49,-159864.29,-8.73114913702011e-11
"2986",2017-09-01 13:52:23,114356.72,114356.72
"2987",2017-09-01 14:11:44,183879.24,298235.96
"2988",2017-09-01 14:11:44,137419.24,435655.2
"2989",2017-09-01 14:11:44,-114356.72,321298.48
"2990",2017-09-01 14:19:16,-321298.48,-1.16415321826935e-10
"2991",2017-09-01 14:39:14,189029.14,189029.14
"2992",2017-09-01 14:44:43,-189029.14,-1.16415321826935e-10
"2993",2017-09-01 14:59:21,168019.71,168019.71
"2994",2017-09-01 15:05:28,-168019.71,-1.16415321826935e-10
"2995",2017-09-01 15:19:52,159181.79,159181.79
"2996",2017-09-01 15:23:27,177603.63,336785.42
"2997",2017-09-01 15:23:27,-159181.79,177603.63
"2998",2017-09-01 15:34:06,-177603.63,-8.73114913702011e-11
"2999",2017-09-01 15:46:43,143076.68,143076.68
"3000",2017-09-01 15:54:12,-143076.68,-8.73114913702011e-11
"3001",2017-09-01 16:47:08,189029.34,189029.34
"3002",2017-09-01 16:47:08,221266.34,410295.68
"3003",2017-09-01 16:52:13,-410295.68,-5.82076609134674e-11
"3004",2017-09-01 17:12:45,189029.38,189029.38
"3005",2017-09-01 17:12:45,14615.8,203645.18
"3006",2017-09-01 17:14:41,-203645.18,-5.82076609134674e-11
"3007",2017-09-01 18:18:14,150008.03,150008.03
"3008",2017-09-01 18:18:14,137820.74,287828.77
"3009",2017-09-01 18:18:14,253468.93,541297.7
"3010",2017-09-01 18:28:47,-541297.7,0
"3011",2017-09-01 18:36:49,300141.53,300141.53
"3012",2017-09-01 18:48:24,-300141.53,0
"3013",2017-09-01 19:43:38,175445.23,175445.23
"3014",2017-09-01 19:43:38,135006.11,310451.34
"3015",2017-09-01 20:06:08,132135.17,442586.51
"3016",2017-09-01 20:06:08,189029.72,631616.23
"3017",2017-09-01 20:06:08,-310451.34,321164.89
"3018",2017-09-01 20:21:15,-321164.89,-5.82076609134674e-11
"3019",2017-09-01 20:26:31,200141.73,200141.73
"3020",2017-09-01 20:30:01,-200141.73,-5.82076609134674e-11
"3021",2017-09-01 20:42:00,169981.78,169981.78
"3022",2017-09-01 20:49:23,-169981.78,-5.82076609134674e-11
"3023",2017-09-01 20:51:38,132381.17,132381.17
"3024",2017-09-01 20:55:44,-132381.17,-5.82076609134674e-11
"3025",2017-09-01 22:06:21,110273.19,110273.19
"3026",2017-09-01 22:10:58,-110273.19,-5.82076609134674e-11
"3027",2017-09-01 23:36:36,152402.3,152402.3
"3028",2017-09-01 23:41:15,-152402.3,-5.82076609134674e-11
"3029",2017-09-01 23:56:33,116655.2,116655.2
"3030",2017-09-02 00:02:18,-116655.2,-5.82076609134674e-11
"3031",2017-09-02 00:14:40,110035.25,110035.25
"3032",2017-09-02 00:22:31,-110035.25,-5.82076609134674e-11
"3033",2017-09-02 01:06:23,130543.97,130543.97
"3034",2017-09-02 01:09:40,-130543.97,-5.82076609134674e-11
"3035",2017-09-02 02:16:47,150142.08,150142.08
"3036",2017-09-02 02:16:47,186968.87,337110.95
"3037",2017-09-02 02:16:47,272495.78,609606.73
"3038",2017-09-02 02:19:03,174587.52,784194.25
"3039",2017-09-02 02:27:35,-609606.73,174587.52
"3040",2017-09-02 02:33:35,-174587.52,2.91038304567337e-11
"3041",2017-09-02 02:53:29,193189.03,193189.03
"3042",2017-09-02 03:01:50,317302.54,510491.57
"3043",2017-09-02 03:01:50,-193189.03,317302.54
"3044",2017-09-02 03:13:38,-317302.54,5.82076609134674e-11
"3045",2017-09-02 03:26:46,267399.72,267399.72
"3046",2017-09-02 03:34:24,271054.63,538454.35
"3047",2017-09-02 03:34:24,-267399.72,271054.63
"3048",2017-09-02 03:40:27,-271054.63,1.16415321826935e-10
"3049",2017-09-02 07:25:00,319724.26,319724.26
"3050",2017-09-02 07:25:00,230001.81,549726.07
"3051",2017-09-02 07:33:42,-549726.07,1.16415321826935e-10
"3052",2017-09-02 07:58:51,206947.89,206947.89
"3053",2017-09-02 08:45:45,-206947.89,1.16415321826935e-10
"3054",2017-09-02 09:14:27,158009.92,158009.92
"3055",2017-09-02 09:14:27,188967.93,346977.85
"3056",2017-09-02 09:23:39,-346977.85,1.16415321826935e-10
"3057",2017-09-02 10:39:01,98521.53,98521.5300000001
"3058",2017-09-02 10:50:05,298459.85,396981.38
"3059",2017-09-02 10:50:05,-98521.53,298459.85
"3060",2017-09-02 11:00:08,-298459.85,1.16415321826935e-10
"3061",2017-09-02 12:07:24,143314.75,143314.75
"3062",2017-09-02 12:42:00,206769.76,350084.51
"3063",2017-09-02 12:42:00,166247.28,516331.79
"3064",2017-09-02 13:07:09,-143314.75,373017.04
"3065",2017-09-02 13:11:20,-373017.04,1.74622982740402e-10
"3066",2017-09-02 13:30:32,281938.97,281938.97
"3067",2017-09-02 13:56:40,-281938.97,1.74622982740402e-10
"3068",2017-09-02 14:32:37,146472.15,146472.15
"3069",2017-09-02 14:46:05,-146472.15,1.74622982740402e-10
"3070",2017-09-02 14:54:27,282951.72,282951.72
"3071",2017-09-02 15:03:29,161022.65,443974.37
"3072",2017-09-02 15:03:29,-282951.72,161022.65
"3073",2017-09-02 15:24:10,-161022.65,1.45519152283669e-10
"3074",2017-09-02 16:17:00,558544.83,558544.83
"3075",2017-09-02 16:34:50,-558544.83,1.16415321826935e-10
"3076",2017-09-02 16:41:02,177921.99,177921.99
"3077",2017-09-02 17:08:49,263429.99,441351.98
"3078",2017-09-02 17:08:49,-177921.99,263429.99
"3079",2017-09-02 17:13:49,-263429.99,1.16415321826935e-10
"3080",2017-09-02 17:29:51,140191.34,140191.34
"3081",2017-09-02 17:38:15,-140191.34,1.16415321826935e-10
"3082",2017-09-02 17:55:19,188730.21,188730.21
"3083",2017-09-02 18:00:18,-188730.21,1.16415321826935e-10
"3084",2017-09-02 18:04:47,287698.44,287698.44
"3085",2017-09-02 18:13:42,-287698.44,1.16415321826935e-10
"3086",2017-09-02 18:55:48,210737.97,210737.97
"3087",2017-09-02 18:55:48,100145.14,310883.11
"3088",2017-09-02 19:01:51,-310883.11,1.16415321826935e-10
"3089",2017-09-02 19:18:59,232696.81,232696.81
"3090",2017-09-02 19:27:29,122623.92,355320.73
"3091",2017-09-02 19:27:29,-232696.81,122623.92
"3092",2017-09-02 19:37:26,170145.21,292769.13
"3093",2017-09-02 19:37:26,-122623.92,170145.21
"3094",2017-09-02 19:41:28,-170145.21,1.45519152283669e-10
"3095",2017-09-02 20:33:40,300145.24,300145.24
"3096",2017-09-02 20:48:23,-300145.24,1.16415321826935e-10
"3097",2017-09-02 21:06:14,373687.48,373687.48
"3098",2017-09-02 21:11:12,-373687.48,1.16415321826935e-10
"3099",2017-09-02 21:19:30,177922.26,177922.26
"3100",2017-09-02 21:25:40,149098.58,327020.84
"3101",2017-09-02 21:25:40,-177922.26,149098.58
"3102",2017-09-02 21:42:36,177922.29,327020.87
"3103",2017-09-02 21:42:36,214440.71,541461.58
"3104",2017-09-02 21:42:36,-149098.58,392363
"3105",2017-09-02 22:11:33,300145.3,692508.3
"3106",2017-09-02 22:11:33,-392363,300145.3
"3107",2017-09-02 22:28:03,265486.29,565631.59
"3108",2017-09-02 22:28:03,-300145.3,265486.29
"3109",2017-09-02 22:44:35,389033.34,654519.63
"3110",2017-09-02 22:44:35,-265486.29,389033.34
"3111",2017-09-02 22:50:01,300145.36,689178.7
"3112",2017-09-02 22:50:01,-389033.34,300145.36
"3113",2017-09-02 23:02:35,-300145.36,1.74622982740402e-10
"3114",2017-09-02 23:39:17,167557.32,167557.32
"3115",2017-09-02 23:39:17,177922.4,345479.72
"3116",2017-09-02 23:41:53,181250.6,526730.32
"3117",2017-09-02 23:41:53,-345479.72,181250.6
"3118",2017-09-03 00:02:31,-181250.6,2.03726813197136e-10
"3119",2017-09-03 00:15:31,193995.71,193995.71
"3120",2017-09-03 00:25:31,-193995.71,2.03726813197136e-10
"3121",2017-09-03 00:48:11,177043.72,177043.72
"3122",2017-09-03 01:02:28,131114.75,308158.47
"3123",2017-09-03 01:02:28,121104.78,429263.25
"3124",2017-09-03 01:02:28,-177043.72,252219.53
"3125",2017-09-03 01:24:40,-252219.53,2.3283064365387e-10
"3126",2017-09-03 01:48:38,263744.84,263744.84
"3127",2017-09-03 01:57:58,-263744.84,2.3283064365387e-10
"3128",2017-09-03 02:42:42,197255.11,197255.11
"3129",2017-09-03 02:48:36,-197255.11,2.3283064365387e-10
"3130",2017-09-03 03:11:07,183145.56,183145.56
"3131",2017-09-03 03:20:01,-183145.56,2.3283064365387e-10
"3132",2017-09-03 06:00:19,217720.44,217720.44
"3133",2017-09-03 06:14:37,-217720.44,2.3283064365387e-10
"3134",2017-09-03 06:25:52,300145.99,300145.99
"3135",2017-09-03 06:33:17,-300145.99,2.3283064365387e-10
"3136",2017-09-03 06:47:52,89034,89034.0000000002
"3137",2017-09-03 06:59:28,-89034,2.3283064365387e-10
"3138",2017-09-03 07:07:45,377923.06,377923.06
"3139",2017-09-03 07:07:45,290673.14,668596.2
"3140",2017-09-03 07:14:33,-668596.2,2.3283064365387e-10
"3141",2017-09-03 07:18:19,233890.97,233890.97
"3142",2017-09-03 07:28:26,-233890.97,2.3283064365387e-10
"3143",2017-09-03 08:06:25,205145.55,205145.55
"3144",2017-09-03 08:21:31,-205145.55,2.3283064365387e-10
"3145",2017-09-03 08:47:42,149349.15,149349.15
"3146",2017-09-03 09:11:43,150099.2,299448.35
"3147",2017-09-03 09:11:43,-149349.15,150099.2
"3148",2017-09-03 09:17:30,-150099.2,2.03726813197136e-10
"3149",2017-09-03 10:19:37,300146.18,300146.18
"3150",2017-09-03 10:25:16,138420.6,438566.78
"3151",2017-09-03 10:25:16,-300146.18,138420.6
"3152",2017-09-03 10:31:15,-138420.6,1.45519152283669e-10
"3153",2017-09-03 10:52:27,138765,138765
"3154",2017-09-03 10:52:27,166120.53,304885.53
"3155",2017-09-03 10:52:27,200146.22,505031.75
"3156",2017-09-03 11:04:45,100146.23,605177.98
"3157",2017-09-03 11:04:45,-505031.75,100146.23
"3158",2017-09-03 11:19:05,-100146.23,1.01863406598568e-10
"3159",2017-09-03 11:57:43,121513.73,121513.73
"3160",2017-09-03 12:04:41,-121513.73,1.01863406598568e-10
"3161",2017-09-03 12:15:25,138201.36,138201.36
"3162",2017-09-03 12:21:18,309943.52,448144.88
"3163",2017-09-03 12:21:18,-138201.36,309943.52
"3164",2017-09-03 12:34:31,125257.73,435201.25
"3165",2017-09-03 12:34:31,-309943.52,125257.73
"3166",2017-09-03 12:55:27,-125257.73,1.01863406598568e-10
"3167",2017-09-03 14:40:21,189034.42,189034.42
"3168",2017-09-03 14:40:21,77517.43,266551.85
"3169",2017-09-03 14:40:21,153511.19,420063.04
"3170",2017-09-03 14:40:21,128983.9,549046.94
"3171",2017-09-03 14:52:49,177923.41,726970.35
"3172",2017-09-03 15:10:51,37923.44,764893.79
"3173",2017-09-03 18:59:13,-764893.79,0
"3174",2017-09-04 02:31:46,254530.47,254530.47
"3175",2017-09-04 02:36:36,-254530.47,0
"3176",2017-09-04 03:12:57,153322.67,153322.67
"3177",2017-09-04 03:21:36,-153322.67,0
"3178",2017-09-04 03:49:53,179601.52,179601.52
"3179",2017-09-04 08:21:25,-179601.52,0
"3180",2017-09-04 10:21:18,200148.65,200148.65
"3181",2017-09-04 10:33:45,-200148.65,0
"3182",2017-09-04 11:27:54,75677.52,75677.52
"3183",2017-09-04 11:29:01,100148.69,175826.21
"3184",2017-09-04 11:43:52,300148.7,475974.91
"3185",2017-09-04 11:43:52,-175826.21,300148.7
"3186",2017-09-04 11:51:04,-300148.7,5.82076609134674e-11
"3187",2017-09-04 12:07:25,112680.06,112680.06
"3188",2017-09-04 12:38:07,107454.51,220134.57
"3189",2017-09-04 12:38:07,200148.74,420283.31
"3190",2017-09-04 12:38:07,107905.93,528189.24
"3191",2017-09-04 12:50:54,300148.75,828337.99
"3192",2017-09-04 13:03:22,-112680.06,715657.93
"3193",2017-09-04 13:33:06,-715657.93,-1.16415321826935e-10
"3194",2017-09-04 13:53:35,209111.56,209111.56
"3195",2017-09-04 13:53:35,115489.09,324600.65
"3196",2017-09-04 13:56:10,130544.01,455144.66
"3197",2017-09-04 14:15:29,146992.15,602136.81
"3198",2017-09-04 14:15:29,-324600.65,277536.16
"3199",2017-09-04 14:19:59,150148.82,427684.98
"3200",2017-09-04 14:24:35,-277536.16,150148.82
"3201",2017-09-04 14:29:00,300148.83,450297.65
"3202",2017-09-04 14:44:44,300148.84,750446.49
"3203",2017-09-04 14:44:44,-150148.82,600297.67
"3204",2017-09-04 15:04:31,-600297.67,-1.16415321826935e-10
"3205",2017-09-04 15:46:18,300148.87,300148.87
"3206",2017-09-04 15:46:18,377925.88,678074.75
"3207",2017-09-04 15:52:39,199121.77,877196.52
"3208",2017-09-04 15:55:25,-678074.75,199121.77
"3209",2017-09-04 16:09:22,295968.46,495090.23
"3210",2017-09-04 16:09:22,-199121.77,295968.46
"3211",2017-09-04 16:26:15,700148.91,996117.37
"3212",2017-09-04 16:26:15,-295968.46,700148.91
"3213",2017-09-04 16:55:16,377925.95,1078074.86
"3214",2017-09-04 17:05:22,-700148.91,377925.95
"3215",2017-09-04 17:20:09,-377925.95,-1.74622982740402e-10
"3216",2017-09-04 17:34:26,492220.41,492220.41
"3217",2017-09-04 17:34:26,700148.98,1192369.39
"3218",2017-09-04 17:45:16,-1192369.39,-2.3283064365387e-10
"3219",2017-09-04 18:02:11,500149.02,500149.02
"3220",2017-09-04 18:28:24,250479.12,750628.14
"3221",2017-09-04 18:28:24,247182.3,997810.44
"3222",2017-09-04 18:28:24,77926.07,1075736.51
"3223",2017-09-04 18:31:37,-500149.02,575587.49
"3224",2017-09-04 18:37:20,-575587.49,-2.3283064365387e-10
"3225",2017-09-04 18:52:14,180856.13,180856.13
"3226",2017-09-04 19:01:58,252359.33,433215.46
"3227",2017-09-04 19:01:58,-180856.13,252359.33
"3228",2017-09-04 19:16:44,286569.23,538928.56
"3229",2017-09-04 19:16:44,258051.83,796980.39
"3230",2017-09-04 19:16:44,-252359.33,544621.06
"3231",2017-09-04 19:25:31,200149.11,744770.17
"3232",2017-09-04 19:25:31,-544621.06,200149.11
"3233",2017-09-04 19:32:32,-200149.11,-3.49245965480804e-10
"3234",2017-09-04 20:19:05,777926.24,777926.24
"3235",2017-09-04 20:19:05,434045.87,1211972.11
"3236",2017-09-04 20:23:27,-1211972.11,-4.65661287307739e-10
"3237",2017-09-04 21:00:23,351114.55,351114.55
"3238",2017-09-04 21:02:24,-351114.55,-4.65661287307739e-10
"3239",2017-09-04 21:48:37,293559.84,293559.84
"3240",2017-09-04 21:54:32,-293559.84,-4.65661287307739e-10
"3241",2017-09-04 22:41:12,166617.23,166617.23
"3242",2017-09-04 22:41:12,153166.05,319783.28
"3243",2017-09-04 23:03:41,-319783.28,-4.65661287307739e-10
"3244",2017-09-04 23:27:46,232493.63,232493.63
"3245",2017-09-04 23:34:29,188612.38,421106.01
"3246",2017-09-04 23:34:29,-232493.63,188612.38
"3247",2017-09-04 23:59:30,153150.43,341762.81
"3248",2017-09-04 23:59:30,-188612.38,153150.43
"3249",2017-09-05 00:15:59,184646.65,337797.079999999
"3250",2017-09-05 00:15:59,-153150.43,184646.649999999
"3251",2017-09-05 00:39:06,256154.39,440801.04
"3252",2017-09-05 00:39:06,-184646.65,256154.39
"3253",2017-09-05 00:43:57,-256154.39,-4.94765117764473e-10
"3254",2017-09-05 01:07:41,187243.55,187243.549999999
"3255",2017-09-05 01:21:59,-187243.55,-4.94765117764473e-10
"3256",2017-09-05 01:40:56,288137.85,288137.85
"3257",2017-09-05 01:46:24,-288137.85,-4.65661287307739e-10
"3258",2017-09-05 01:52:16,181682.45,181682.45
"3259",2017-09-05 01:57:14,-181682.45,-4.65661287307739e-10
"3260",2017-09-05 01:59:14,170002.32,170002.32
"3261",2017-09-05 02:46:05,-170002.32,-4.65661287307739e-10
"3262",2017-09-05 03:07:52,218755.46,218755.46
"3263",2017-09-05 03:34:22,50150.28,268905.74
"3264",2017-09-05 03:34:22,-218755.46,50150.2799999995
"3265",2017-09-05 03:52:10,-50150.28,-4.65661287307739e-10
"3266",2017-09-05 07:00:46,689389.15,689389.15
"3267",2017-09-05 07:22:45,-689389.15,-4.65661287307739e-10
"3268",2017-09-05 08:18:12,151299.86,151299.86
"3269",2017-09-05 08:18:12,77927.31,229227.17
"3270",2017-09-05 08:23:18,-229227.17,-4.94765117764473e-10
"3271",2017-09-05 08:31:48,339847.61,339847.61
"3272",2017-09-05 08:39:20,-339847.61,-4.65661287307739e-10
"3273",2017-09-05 09:00:00,229566.1,229566.1
"3274",2017-09-05 09:11:14,173981.06,403547.16
"3275",2017-09-05 09:11:14,-229566.1,173981.06
"3276",2017-09-05 09:25:44,-173981.06,-4.36557456851006e-10
"3277",2017-09-05 09:40:20,335195.44,335195.44
"3278",2017-09-05 10:02:17,-335195.44,-4.07453626394272e-10
"3279",2017-09-05 10:05:20,76418,76417.9999999996
"3280",2017-09-05 10:31:20,-76418,-4.07453626394272e-10
"3281",2017-09-05 11:05:41,163419.69,163419.69
"3282",2017-09-05 11:05:41,202717.29,366136.98
"3283",2017-09-05 11:14:24,-366136.98,-3.49245965480804e-10
"3284",2017-09-05 11:40:12,175080.48,175080.48
"3285",2017-09-05 11:49:51,167784.54,342865.02
"3286",2017-09-05 11:50:37,-175080.48,167784.54
"3287",2017-09-05 11:57:01,-167784.54,-3.49245965480804e-10
"3288",2017-09-05 13:01:23,202742.42,202742.42
"3289",2017-09-05 13:07:09,374905.28,577647.7
"3290",2017-09-05 13:07:09,-202742.42,374905.28
"3291",2017-09-05 13:13:42,-374905.28,-3.49245965480804e-10
"3292",2017-09-05 14:29:59,273779.02,273779.02
"3293",2017-09-05 14:38:11,-273779.02,-3.49245965480804e-10
"3294",2017-09-05 15:28:10,188482.28,188482.28
"3295",2017-09-05 15:39:10,157423.75,345906.03
"3296",2017-09-05 15:41:33,180573.75,526479.78
"3297",2017-09-05 15:41:33,-188482.28,337997.5
"3298",2017-09-05 15:51:58,300152.9,638150.4
"3299",2017-09-05 15:51:58,-337997.5,300152.9
"3300",2017-09-05 15:57:28,-300152.9,-3.49245965480804e-10
"3301",2017-09-05 16:09:23,14437.28,14437.2799999997
"3302",2017-09-05 16:12:30,-14437.28,-3.49245965480804e-10
"3303",2017-09-05 16:31:50,575073.58,575073.58
"3304",2017-09-05 16:36:58,-575073.58,-3.49245965480804e-10
"3305",2017-09-05 17:28:01,392512.42,392512.42
"3306",2017-09-05 17:33:20,-392512.42,-3.49245965480804e-10
"3307",2017-09-05 18:12:05,212356.68,212356.68
"3308",2017-09-05 18:19:05,-212356.68,-3.49245965480804e-10
"3309",2017-09-05 21:58:23,161715.77,161715.77
"3310",2017-09-05 22:05:06,157175.9,318891.67
"3311",2017-09-05 22:05:06,-161715.77,157175.9
"3312",2017-09-05 22:07:18,272239.65,429415.55
"3313",2017-09-05 22:16:58,-429415.55,-2.91038304567337e-10
"3314",2017-09-06 01:15:29,165535.63,165535.63
"3315",2017-09-06 01:28:50,-165535.63,-2.91038304567337e-10
"3316",2017-09-06 04:50:20,196957.77,196957.77
"3317",2017-09-06 04:59:12,249400.85,446358.62
"3318",2017-09-06 04:59:12,-196957.77,249400.85
"3319",2017-09-06 05:05:06,208449.54,457850.39
"3320",2017-09-06 05:05:06,-249400.85,208449.54
"3321",2017-09-06 05:22:17,-208449.54,-2.91038304567337e-10
"3322",2017-09-06 05:45:00,187273.87,187273.87
"3323",2017-09-06 05:52:31,-187273.87,-2.91038304567337e-10
"3324",2017-09-06 10:33:06,200153.21,200153.21
"3325",2017-09-06 10:40:53,-200153.21,-2.91038304567337e-10
"3326",2017-09-06 11:39:18,307947.68,307947.68
"3327",2017-09-06 11:55:15,-307947.68,-2.91038304567337e-10
"3328",2017-09-06 13:38:50,275120.25,275120.25
"3329",2017-09-06 13:45:21,-275120.25,-2.91038304567337e-10
"3330",2017-09-06 15:23:29,212702.43,212702.43
"3331",2017-09-06 15:27:28,-212702.43,-2.91038304567337e-10
"3332",2017-09-06 16:02:40,206184.45,206184.45
"3333",2017-09-06 16:02:40,191304.15,397488.6
"3334",2017-09-06 16:06:09,-397488.6,-2.3283064365387e-10
"3335",2017-09-06 16:20:37,160359.36,160359.36
"3336",2017-09-06 16:23:23,-160359.36,-2.3283064365387e-10
"3337",2017-09-06 20:41:48,160480.54,160480.54
"3338",2017-09-06 20:53:52,17576.3,178056.84
"3339",2017-09-06 20:53:52,-160480.54,17576.2999999998
"3340",2017-09-06 21:03:30,-17576.3,-2.43744580075145e-10
"3341",2017-09-06 21:12:43,181715.64,181715.64
"3342",2017-09-06 21:27:33,-181715.64,-2.3283064365387e-10
"3343",2017-09-06 22:29:08,157375.06,157375.06
"3344",2017-09-06 22:34:12,-157375.06,-2.3283064365387e-10
"3345",2017-09-06 23:01:49,186607.32,186607.32
"3346",2017-09-06 23:56:20,-186607.32,-2.3283064365387e-10
"3347",2017-09-07 01:37:09,461196.95,461196.95
"3348",2017-09-07 01:42:52,-461196.95,-2.3283064365387e-10
"3349",2017-09-07 01:44:57,197560.03,197560.03
"3350",2017-09-07 01:55:34,318772.8,516332.83
"3351",2017-09-07 01:55:34,-197560.03,318772.8
"3352",2017-09-07 02:05:57,266953.71,585726.51
"3353",2017-09-07 02:05:57,-318772.8,266953.71
"3354",2017-09-07 02:10:59,-266953.71,-2.3283064365387e-10
"3355",2017-09-07 02:21:41,430321.81,430321.81
"3356",2017-09-07 03:13:40,-430321.81,-2.3283064365387e-10
"3357",2017-09-07 03:43:46,208394.13,208394.13
"3358",2017-09-07 03:53:07,-208394.13,-2.3283064365387e-10
"3359",2017-09-07 04:23:42,165401.16,165401.16
"3360",2017-09-07 04:51:00,-165401.16,-2.3283064365387e-10
"3361",2017-09-07 07:06:41,183259.34,183259.34
"3362",2017-09-07 07:14:21,-183259.34,-2.3283064365387e-10
"3363",2017-09-07 08:04:05,175012.09,175012.09
"3364",2017-09-07 08:16:44,-175012.09,-2.3283064365387e-10
"3365",2017-09-07 11:02:18,173543.99,173543.99
"3366",2017-09-07 11:16:50,-173543.99,-2.3283064365387e-10
"3367",2017-09-07 13:31:11,291443.47,291443.47
"3368",2017-09-07 13:36:06,-291443.47,-2.3283064365387e-10
"3369",2017-09-07 17:18:24,244358.12,244358.12
"3370",2017-09-07 17:23:50,-244358.12,-2.3283064365387e-10
"3371",2017-09-07 19:42:07,247462.05,247462.05
"3372",2017-09-07 19:50:19,-247462.05,-2.3283064365387e-10
"3373",2017-09-07 22:37:39,154758.06,154758.06
"3374",2017-09-07 23:01:58,239463.78,394221.84
"3375",2017-09-07 23:01:58,-154758.06,239463.78
"3376",2017-09-07 23:07:45,-239463.78,-2.61934474110603e-10
"3377",2017-09-07 23:46:43,179853.03,179853.03
"3378",2017-09-07 23:52:21,-179853.03,-2.61934474110603e-10
"3379",2017-09-08 07:00:23,170193.51,170193.51
"3380",2017-09-08 07:22:45,-170193.51,-2.61934474110603e-10
"3381",2017-09-08 07:46:55,145756.79,145756.79
"3382",2017-09-08 08:02:55,-145756.79,-2.61934474110603e-10
"3383",2017-09-08 09:09:08,188680.33,188680.33
"3384",2017-09-08 09:15:36,-188680.33,-2.61934474110603e-10
"3385",2017-09-08 09:32:03,164463.56,164463.56
"3386",2017-09-08 10:00:23,-164463.56,-2.61934474110603e-10
"3387",2017-09-08 13:16:21,154251.31,154251.31
"3388",2017-09-08 13:20:35,-154251.31,-2.61934474110603e-10
"3389",2017-09-08 13:58:41,260164.28,260164.28
"3390",2017-09-08 14:03:10,-260164.28,-2.61934474110603e-10
"3391",2017-09-08 14:06:30,191786.59,191786.59
"3392",2017-09-08 14:10:27,-191786.59,-2.61934474110603e-10
"3393",2017-09-08 14:13:47,216735.42,216735.42
"3394",2017-09-08 14:24:32,211809.22,428544.64
"3395",2017-09-08 14:24:32,163835.89,592380.53
"3396",2017-09-08 14:24:32,-216735.42,375645.11
"3397",2017-09-08 14:59:42,290566.93,666212.04
"3398",2017-09-08 14:59:42,-375645.11,290566.93
"3399",2017-09-08 15:11:34,-290566.93,-1.74622982740402e-10
"3400",2017-09-08 15:20:47,445092.47,445092.47
"3401",2017-09-08 15:31:39,-445092.47,-1.74622982740402e-10
"3402",2017-09-08 15:50:59,264347.64,264347.64
"3403",2017-09-08 15:56:24,-264347.64,-1.74622982740402e-10
"3404",2017-09-08 16:03:58,174298,174298
"3405",2017-09-08 16:14:04,-174298,-1.74622982740402e-10
"3406",2017-09-08 17:03:31,433520.4,433520.4
"3407",2017-09-08 17:14:55,138280.08,571800.48
"3408",2017-09-08 17:14:55,-433520.4,138280.08
"3409",2017-09-08 17:29:33,150155.69,288435.77
"3410",2017-09-08 17:29:33,-138280.08,150155.69
"3411",2017-09-08 17:44:53,141515.82,291671.51
"3412",2017-09-08 17:44:53,-150155.69,141515.82
"3413",2017-09-08 17:53:41,175793.01,317308.83
"3414",2017-09-08 17:53:41,-141515.82,175793.01
"3415",2017-09-08 18:14:01,224794.67,400587.68
"3416",2017-09-08 18:14:01,-175793.01,224794.67
"3417",2017-09-08 18:48:34,377932.79,602727.46
"3418",2017-09-08 18:48:34,139682.24,742409.7
"3419",2017-09-08 18:48:34,-224794.67,517615.03
"3420",2017-09-08 19:16:31,555710.82,1073325.85
"3421",2017-09-08 19:16:31,-517615.03,555710.82
"3422",2017-09-08 19:40:18,-555710.82,-1.16415321826935e-10
"3423",2017-09-08 19:57:07,555710.85,555710.85
"3424",2017-09-08 20:05:05,500155.86,1055866.71
"3425",2017-09-08 20:05:05,-555710.85,500155.86
"3426",2017-09-08 20:24:40,500155.89,1000311.75
"3427",2017-09-08 20:24:40,-500155.86,500155.89
"3428",2017-09-08 20:30:49,-500155.89,0
"3429",2017-09-08 20:47:28,500155.91,500155.91
"3430",2017-09-08 20:59:16,500155.92,1000311.83
"3431",2017-09-08 20:59:16,-500155.91,500155.92
"3432",2017-09-08 21:16:56,-500155.92,0
"3433",2017-09-08 21:39:14,240247.98,240247.98
"3434",2017-09-08 21:39:14,221159.78,461407.76
"3435",2017-09-08 21:39:14,140297.92,601705.68
"3436",2017-09-08 21:47:00,-601705.68,0
"3437",2017-09-08 22:00:25,216325.2,216325.2
"3438",2017-09-08 22:03:33,270475.88,486801.08
"3439",2017-09-08 22:24:40,378943.03,865744.11
"3440",2017-09-08 22:24:40,-216325.2,649418.91
"3441",2017-09-08 22:41:50,50156.05,699574.96
"3442",2017-09-08 22:41:50,300156.06,999731.02
"3443",2017-09-08 22:41:50,-649418.91,350312.11
"3444",2017-09-08 22:47:58,-350312.11,2.3283064365387e-10
"3445",2017-09-08 23:37:36,366564.74,366564.74
"3446",2017-09-08 23:44:54,-366564.74,2.3283064365387e-10
"3447",2017-09-08 23:54:10,500156.13,500156.13
"3448",2017-09-09 00:00:48,-500156.13,2.3283064365387e-10
"3449",2017-09-09 00:19:50,164280.93,164280.93
"3450",2017-09-09 00:26:20,-164280.93,2.3283064365387e-10
"3451",2017-09-09 00:57:07,500156.18,500156.18
"3452",2017-09-09 00:57:07,252298.72,752454.9
"3453",2017-09-09 01:20:01,-752454.9,2.3283064365387e-10
"3454",2017-09-09 01:57:00,319922.39,319922.39
"3455",2017-09-09 01:58:47,174441.38,494363.77
"3456",2017-09-09 02:10:12,-319922.39,174441.38
"3457",2017-09-09 02:18:23,172428.03,346869.41
"3458",2017-09-09 02:18:23,-174441.38,172428.03
"3459",2017-09-09 02:26:35,273902.56,446330.59
"3460",2017-09-09 02:26:35,-172428.03,273902.56
"3461",2017-09-09 02:43:55,-273902.56,2.91038304567337e-10
"3462",2017-09-09 03:04:10,189450.78,189450.78
"3463",2017-09-09 03:08:36,287649.17,477099.95
"3464",2017-09-09 03:24:24,-189450.78,287649.17
"3465",2017-09-09 03:40:01,-287649.17,2.91038304567337e-10
"3466",2017-09-09 04:53:51,183632.12,183632.12
"3467",2017-09-09 05:12:31,-183632.12,2.91038304567337e-10
"3468",2017-09-09 06:06:01,278204.48,278204.48
"3469",2017-09-09 06:09:56,-278204.48,2.91038304567337e-10
"3470",2017-09-09 06:28:26,146734.9,146734.9
"3471",2017-09-09 06:55:52,193163.7,339898.6
"3472",2017-09-09 06:55:52,-146734.9,193163.7
"3473",2017-09-09 07:04:56,-193163.7,3.20142135024071e-10
"3474",2017-09-09 09:37:02,170753.37,170753.37
"3475",2017-09-09 09:42:46,-170753.37,3.20142135024071e-10
"3476",2017-09-09 09:54:19,162341.97,162341.97
"3477",2017-09-09 10:16:16,189981.32,352323.29
"3478",2017-09-09 10:16:16,-162341.97,189981.32
"3479",2017-09-09 10:40:09,-189981.32,3.20142135024071e-10
"3480",2017-09-09 12:12:36,212016.29,212016.29
"3481",2017-09-09 12:17:03,-212016.29,3.20142135024071e-10
"3482",2017-09-09 13:25:12,179855.13,179855.13
"3483",2017-09-09 13:29:12,-179855.13,3.20142135024071e-10
"3484",2017-09-09 14:07:06,294584.54,294584.54
"3485",2017-09-09 14:23:08,-294584.54,2.91038304567337e-10
"3486",2017-09-09 16:42:00,184212.63,184212.63
"3487",2017-09-09 16:51:09,-184212.63,2.91038304567337e-10
"3488",2017-09-09 18:30:58,158855.63,158855.63
"3489",2017-09-09 18:35:59,-158855.63,2.91038304567337e-10
"3490",2017-09-09 18:54:32,300618.82,300618.82
"3491",2017-09-09 18:58:49,-300618.82,2.91038304567337e-10
"3492",2017-09-09 19:04:28,191480.44,191480.44
"3493",2017-09-09 19:24:21,213992.91,405473.35
"3494",2017-09-09 19:24:21,-191480.44,213992.91
"3495",2017-09-09 19:34:29,-213992.91,3.20142135024071e-10
"3496",2017-09-09 21:56:48,161579.28,161579.28
"3497",2017-09-09 22:00:12,-161579.28,3.20142135024071e-10
"3498",2017-09-09 23:12:44,151222.43,151222.43
"3499",2017-09-09 23:12:44,199295.77,350518.2
"3500",2017-09-09 23:36:30,-350518.2,2.91038304567337e-10
"3501",2017-09-09 23:43:53,175811.41,175811.41
"3502",2017-09-09 23:48:15,-175811.41,2.91038304567337e-10
"3503",2017-09-10 04:46:50,247371.95,247371.95
"3504",2017-09-10 05:00:21,-247371.95,2.91038304567337e-10
"3505",2017-09-10 05:24:23,25028.85,25028.8500000003
"3506",2017-09-10 05:24:23,168184.72,193213.57
"3507",2017-09-10 05:33:11,-193213.57,2.91038304567337e-10
"3508",2017-09-10 05:44:37,157315.32,157315.32
"3509",2017-09-10 05:53:29,-157315.32,2.91038304567337e-10
"3510",2017-09-10 06:01:58,137529.31,137529.31
"3511",2017-09-10 06:06:45,-137529.31,2.91038304567337e-10
"3512",2017-09-10 06:27:47,165224.19,165224.19
"3513",2017-09-10 06:27:47,231306.31,396530.5
"3514",2017-09-10 06:27:47,179510.35,576040.85
"3515",2017-09-10 06:37:13,300157.11,876197.96
"3516",2017-09-10 06:37:13,89045.1,965243.06
"3517",2017-09-10 06:37:13,-576040.85,389202.21
"3518",2017-09-10 06:41:28,-389202.21,2.91038304567337e-10
"3519",2017-09-10 07:25:25,397422.55,397422.55
"3520",2017-09-10 07:25:25,18146.75,415569.3
"3521",2017-09-10 07:25:25,280511.8,696081.1
"3522",2017-09-10 07:32:49,-696081.1,3.49245965480804e-10
"3523",2017-09-10 08:03:58,253208.59,253208.59
"3524",2017-09-10 08:16:31,-253208.59,3.49245965480804e-10
"3525",2017-09-10 08:39:32,304874.53,304874.53
"3526",2017-09-10 08:49:12,-304874.53,3.49245965480804e-10
"3527",2017-09-10 10:26:12,185771.5,185771.5
"3528",2017-09-10 10:26:12,148560.29,334331.79
"3529",2017-09-10 10:43:23,-334331.79,4.07453626394272e-10
"3530",2017-09-10 10:59:59,168389.36,168389.36
"3531",2017-09-10 11:43:35,315619.62,484008.98
"3532",2017-09-10 11:43:35,285374.9,769383.88
"3533",2017-09-10 11:43:35,-168389.36,600994.52
"3534",2017-09-10 11:54:34,-600994.52,3.49245965480804e-10
"3535",2017-09-10 14:11:19,348478.85,348478.85
"3536",2017-09-10 14:16:34,-348478.85,3.49245965480804e-10
"3537",2017-09-10 16:00:51,211172.29,211172.29
"3538",2017-09-10 16:00:51,327202.26,538374.55
"3539",2017-09-10 16:08:28,-538374.55,3.49245965480804e-10
"3540",2017-09-10 17:12:24,324676.66,324676.66
"3541",2017-09-10 17:12:24,300157.43,624834.09
"3542",2017-09-10 17:12:24,300157.42,924991.51
"3543",2017-09-10 18:25:20,-924991.51,2.3283064365387e-10
"3544",2017-09-10 18:49:41,300157.48,300157.48
"3545",2017-09-10 19:00:03,-300157.48,2.3283064365387e-10
"3546",2017-09-10 21:13:45,179873.88,179873.88
"3547",2017-09-10 21:16:53,189988.78,369862.66
"3548",2017-09-10 21:22:19,-179873.88,189988.78
"3549",2017-09-10 21:27:23,-189988.78,2.61934474110603e-10
"3550",2017-09-10 21:56:29,279345.47,279345.47
"3551",2017-09-10 22:15:03,-279345.47,2.3283064365387e-10
"3552",2017-09-10 23:14:35,196871.58,196871.58
"3553",2017-09-10 23:32:06,-196871.58,2.3283064365387e-10
"3554",2017-09-10 23:47:50,284977.96,284977.96
"3555",2017-09-10 23:55:45,-284977.96,2.3283064365387e-10
"3556",2017-09-11 00:13:46,208662.62,208662.62
"3557",2017-09-11 00:21:21,-208662.62,2.3283064365387e-10
"3558",2017-09-11 00:28:09,260792.2,260792.2
"3559",2017-09-11 00:46:33,-260792.2,2.3283064365387e-10
"3560",2017-09-11 01:22:55,191053.23,191053.23
"3561",2017-09-11 01:27:45,-191053.23,2.3283064365387e-10
"3562",2017-09-11 01:47:44,225925.43,225925.43
"3563",2017-09-11 01:47:44,306302.8,532228.23
"3564",2017-09-11 02:04:42,238041.52,770269.75
"3565",2017-09-11 02:04:42,-532228.23,238041.52
"3566",2017-09-11 02:23:36,-238041.52,2.61934474110603e-10
"3567",2017-09-11 03:28:48,290733.51,290733.51
"3568",2017-09-11 03:31:24,-290733.51,2.3283064365387e-10
"3569",2017-09-11 04:52:11,313768.04,313768.04
"3570",2017-09-11 04:52:11,291281.03,605049.07
"3571",2017-09-11 04:52:11,296666.98,901716.05
"3572",2017-09-11 04:58:11,456469.53,1358185.58
"3573",2017-09-11 04:58:11,-901716.05,456469.53
"3574",2017-09-11 05:01:55,-456469.53,2.3283064365387e-10
"3575",2017-09-11 06:13:05,283874,283874
"3576",2017-09-11 06:33:15,268965.46,552839.46
"3577",2017-09-11 06:33:15,-283874,268965.46
"3578",2017-09-11 06:40:38,-268965.46,1.74622982740402e-10
"3579",2017-09-11 21:18:35,10859.22,10859.2200000002
"3580",2017-09-11 21:32:14,-10859.22,1.74622982740402e-10
"3581",2017-09-12 06:29:41,355656.51,355656.51
"3582",2017-09-12 06:38:33,-355656.51,1.74622982740402e-10
"3583",2017-09-12 06:44:44,331836.81,331836.81
"3584",2017-09-12 06:59:29,-331836.81,1.74622982740402e-10
"3585",2017-09-12 19:15:02,210668.25,210668.25
"3586",2017-09-12 19:21:29,-210668.25,1.74622982740402e-10
"3587",2017-09-12 19:32:40,205124.86,205124.86
"3588",2017-09-12 19:48:05,178918.87,384043.73
"3589",2017-09-12 19:48:05,28794.41,412838.14
"3590",2017-09-12 19:48:05,-205124.86,207713.28
"3591",2017-09-12 19:54:30,163441.01,371154.29
"3592",2017-09-12 19:57:47,-371154.29,1.74622982740402e-10
"3593",2017-09-12 20:06:46,137048.2,137048.2
"3594",2017-09-12 20:13:05,178065.76,315113.96
"3595",2017-09-12 20:13:05,186508.67,501622.63
"3596",2017-09-12 20:13:05,-137048.2,364574.43
"3597",2017-09-12 20:26:16,143134.08,507708.51
"3598",2017-09-12 20:26:16,-364574.43,143134.08
"3599",2017-09-12 20:36:59,-143134.08,2.61934474110603e-10
"3600",2017-09-12 20:49:08,145668.27,145668.27
"3601",2017-09-12 20:55:15,135456.5,281124.77
"3602",2017-09-12 20:55:15,-145668.27,135456.5
"3603",2017-09-12 21:08:19,-135456.5,2.61934474110603e-10
"3604",2017-09-12 21:11:18,154499.52,154499.52
"3605",2017-09-12 21:15:57,-154499.52,2.61934474110603e-10
"3606",2017-09-12 21:43:37,140610.64,140610.64
"3607",2017-09-12 22:01:19,-140610.64,2.61934474110603e-10
"3608",2017-09-12 22:38:54,128040.54,128040.54
"3609",2017-09-12 22:44:55,-128040.54,2.61934474110603e-10
"3610",2017-09-12 22:55:50,127195.3,127195.3
"3611",2017-09-12 23:14:08,146928.99,274124.29
"3612",2017-09-12 23:14:08,134224.64,408348.93
"3613",2017-09-12 23:14:08,-127195.3,281153.63
"3614",2017-09-12 23:25:10,142179.97,423333.6
"3615",2017-09-12 23:25:10,-281153.63,142179.97
"3616",2017-09-12 23:40:59,-142179.97,3.20142135024071e-10
"3617",2017-09-13 00:14:28,129762.35,129762.35
"3618",2017-09-13 00:17:31,-129762.35,3.20142135024071e-10
"3619",2017-09-13 00:42:34,255492.88,255492.88
"3620",2017-09-13 01:00:34,186045.62,441538.5
"3621",2017-09-13 01:00:34,-255492.88,186045.62
"3622",2017-09-13 01:07:07,157593.4,343639.02
"3623",2017-09-13 01:07:07,-186045.62,157593.4
"3624",2017-09-13 01:25:16,-157593.4,3.78349795937538e-10
"3625",2017-09-13 02:15:40,128050.85,128050.85
"3626",2017-09-13 02:18:32,-128050.85,3.78349795937538e-10
"3627",2017-09-13 02:26:10,127005.12,127005.12
"3628",2017-09-13 03:11:12,207930.09,334935.21
"3629",2017-09-13 03:11:12,196328.02,531263.23
"3630",2017-09-13 03:11:12,131686.09,662949.32
"3631",2017-09-13 03:22:31,-127005.12,535944.2
"3632",2017-09-13 03:37:09,-535944.2,3.49245965480804e-10
"3633",2017-09-13 03:58:20,183355,183355
"3634",2017-09-13 03:58:20,411411.59,594766.59
"3635",2017-09-13 04:11:22,330214.74,924981.33
"3636",2017-09-13 04:39:56,377151.47,1302132.8
"3637",2017-09-13 04:39:56,-594766.59,707366.21
"3638",2017-09-13 04:53:39,-707366.21,3.49245965480804e-10
"3639",2017-09-13 05:15:12,277888.95,277888.95
"3640",2017-09-13 05:26:51,235661.18,513550.13
"3641",2017-09-13 05:26:51,-277888.95,235661.18
"3642",2017-09-13 05:36:24,-235661.18,3.49245965480804e-10
"3643",2017-09-13 05:46:44,259813.23,259813.23
"3644",2017-09-13 05:50:19,-259813.23,3.49245965480804e-10
"3645",2017-09-13 06:01:17,160907.82,160907.82
"3646",2017-09-13 06:01:17,158812.64,319720.46
"3647",2017-09-13 06:13:45,262022.12,581742.58
"3648",2017-09-13 06:13:45,-319720.46,262022.12
"3649",2017-09-13 06:28:02,-262022.12,2.91038304567337e-10
"3650",2017-09-13 06:38:06,136808.88,136808.88
"3651",2017-09-13 06:41:18,-136808.88,2.91038304567337e-10
"3652",2017-09-13 07:23:35,152824.81,152824.81
"3653",2017-09-13 07:54:20,133828.84,286653.65
"3654",2017-09-13 07:54:20,-152824.81,133828.84
"3655",2017-09-13 08:01:38,194767.05,328595.89
"3656",2017-09-13 08:01:38,-133828.84,194767.05
"3657",2017-09-13 08:15:48,-194767.05,2.61934474110603e-10
"3658",2017-09-13 09:39:01,50002.04,50002.0400000003
"3659",2017-09-13 09:45:32,457406.5,507408.54
"3660",2017-09-13 09:45:32,-50002.04,457406.5
"3661",2017-09-13 09:50:30,-457406.5,2.91038304567337e-10
"3662",2017-09-13 10:00:08,128240.45,128240.45
"3663",2017-09-13 10:00:08,139984.09,268224.54
"3664",2017-09-13 10:19:59,-268224.54,2.91038304567337e-10
"3665",2017-09-13 10:25:22,185130.35,185130.35
"3666",2017-09-13 10:45:08,188930.61,374060.96
"3667",2017-09-13 10:45:08,172051.6,546112.56
"3668",2017-09-13 10:45:08,-185130.35,360982.21
"3669",2017-09-13 10:53:32,-360982.21,2.91038304567337e-10
"3670",2017-09-13 11:19:05,198196.13,198196.13
"3671",2017-09-13 11:40:48,164708.5,362904.63
"3672",2017-09-13 11:40:48,148453.04,511357.67
"3673",2017-09-13 11:40:48,182234.45,693592.12
"3674",2017-09-13 11:40:48,-198196.13,495395.99
"3675",2017-09-13 11:57:50,-495395.99,3.49245965480804e-10
"3676",2017-09-13 12:04:35,330960.71,330960.71
"3677",2017-09-13 12:04:35,256951.38,587912.09
"3678",2017-09-13 12:11:01,-587912.09,3.49245965480804e-10
"3679",2017-09-13 12:27:39,203633.08,203633.08
"3680",2017-09-13 12:44:07,318179.75,521812.83
"3681",2017-09-13 12:44:07,-203633.08,318179.75
"3682",2017-09-13 13:01:05,-318179.75,3.49245965480804e-10
"3683",2017-09-13 13:04:13,299998,299998
"3684",2017-09-13 13:27:05,232361.72,532359.72
"3685",2017-09-13 13:27:05,-299998,232361.72
"3686",2017-09-13 13:38:11,-232361.72,3.20142135024071e-10
"3687",2017-09-13 14:39:53,206515.98,206515.98
"3688",2017-09-13 14:57:35,318447.72,524963.7
"3689",2017-09-13 14:57:35,214145.76,739109.46
"3690",2017-09-13 14:57:35,-206515.98,532593.48
"3691",2017-09-13 15:11:58,276234.68,808828.16
"3692",2017-09-13 15:11:58,-532593.48,276234.68
"3693",2017-09-13 15:23:16,524397.28,800631.96
"3694",2017-09-13 15:23:16,-276234.68,524397.28
"3695",2017-09-13 15:37:20,-524397.28,4.65661287307739e-10
"3696",2017-09-13 16:15:48,277843.4,277843.4
"3697",2017-09-13 16:20:27,-277843.4,4.65661287307739e-10
"3698",2017-09-13 16:53:48,440321.04,440321.04
"3699",2017-09-13 16:58:33,269170.98,709492.02
"3700",2017-09-13 16:58:33,-440321.04,269170.980000001
"3701",2017-09-13 17:24:30,-269170.98,5.23868948221207e-10
"3702",2017-09-13 18:19:51,173437.65,173437.650000001
"3703",2017-09-13 18:19:51,19168.87,192606.520000001
"3704",2017-09-13 18:26:32,239779.08,432385.600000001
"3705",2017-09-13 18:26:32,-192606.52,239779.080000001
"3706",2017-09-13 18:34:11,-239779.08,5.23868948221207e-10
"3707",2017-09-13 20:06:40,158725.03,158725.030000001
"3708",2017-09-13 20:10:07,170732.07,329457.100000001
"3709",2017-09-13 20:22:32,-158725.03,170732.070000001
"3710",2017-09-13 20:41:16,-170732.07,5.5297277867794e-10
"3711",2017-09-13 21:15:03,196612.07,196612.070000001
"3712",2017-09-13 21:18:38,-196612.07,5.5297277867794e-10
"3713",2017-09-13 22:18:57,216293.23,216293.230000001
"3714",2017-09-13 22:22:40,-216293.23,5.5297277867794e-10
"3715",2017-09-14 03:47:02,215444.51,215444.510000001
"3716",2017-09-14 03:47:02,29237.98,244682.490000001
"3717",2017-09-14 04:06:24,-244682.49,5.82076609134674e-10
"3718",2017-09-14 11:18:31,170494.16,170494.160000001
"3719",2017-09-14 11:18:31,425317.03,595811.190000001
"3720",2017-09-14 11:18:31,176142.01,771953.200000001
"3721",2017-09-14 11:42:05,308648.08,1080601.28
"3722",2017-09-14 11:42:05,-771953.2,308648.080000001
"3723",2017-09-14 11:54:54,-308648.08,7.56699591875076e-10
"3724",2017-09-14 12:18:07,181284.93,181284.930000001
"3725",2017-09-14 12:30:35,500003.14,681288.070000001
"3726",2017-09-14 12:30:35,-181284.93,500003.140000001
"3727",2017-09-14 12:41:01,-500003.14,7.56699591875076e-10
"3728",2017-09-14 12:59:49,339312.04,339312.040000001
"3729",2017-09-14 13:09:40,-339312.04,7.56699591875076e-10
"3730",2017-09-14 13:26:06,224605.25,224605.250000001
"3731",2017-09-14 13:32:36,500003.22,724608.470000001
"3732",2017-09-14 13:32:35,-224605.25,500003.220000001
"3733",2017-09-14 14:07:01,269886.42,769889.640000001
"3734",2017-09-14 14:07:01,375239.41,1145129.05
"3735",2017-09-14 14:07:01,300003.23,1445132.28
"3736",2017-09-14 14:08:45,-500003.22,945129.060000001
"3737",2017-09-14 14:42:31,-945129.06,4.65661287307739e-10
"3738",2017-09-14 16:14:50,288932.91,288932.91
"3739",2017-09-14 16:14:50,223588.92,512521.83
"3740",2017-09-14 16:14:50,214609.12,727130.95
"3741",2017-09-14 16:44:53,-727130.95,4.65661287307739e-10
"3742",2017-09-14 17:44:48,1026955.66,1026955.66
"3743",2017-09-14 17:51:02,300003.32,1326958.98
"3744",2017-09-14 17:51:02,-1026955.66,300003.32
"3745",2017-09-14 17:56:54,500003.51,800006.83
"3746",2017-09-14 18:04:46,-300003.32,500003.51
"3747",2017-09-14 18:14:25,589458.65,1089462.16
"3748",2017-09-14 18:14:25,-500003.51,589458.65
"3749",2017-09-14 18:27:38,636042.74,1225501.39
"3750",2017-09-14 18:27:38,573870.01,1799371.4
"3751",2017-09-14 18:27:38,-589458.65,1209912.75
"3752",2017-09-14 18:43:55,700003.58,1909916.33
"3753",2017-09-14 18:43:55,-1209912.75,700003.580000001
"3754",2017-09-14 19:01:26,-700003.58,5.82076609134674e-10
"3755",2017-09-14 21:43:52,59944.85,59944.8500000006
"3756",2017-09-14 21:53:11,-59944.85,5.82076609134674e-10
"3757",2017-09-14 22:10:03,226816.54,226816.540000001
"3758",2017-09-14 22:16:46,-226816.54,5.82076609134674e-10
"3759",2017-09-15 00:16:05,500003.76,500003.760000001
"3760",2017-09-15 00:16:05,21132.36,521136.120000001
"3761",2017-09-15 00:16:05,259884.68,781020.800000001
"3762",2017-09-15 00:16:05,230214.25,1011235.05
"3763",2017-09-15 00:36:46,-1011235.05,4.65661287307739e-10
"3764",2017-09-15 00:58:41,483277.33,483277.33
"3765",2017-09-15 01:08:05,-483277.33,4.65661287307739e-10
"3766",2017-09-15 01:11:11,280455.88,280455.88
"3767",2017-09-15 01:29:17,-280455.88,4.65661287307739e-10
"3768",2017-09-15 01:55:25,516875.8,516875.8
"3769",2017-09-15 02:10:01,-516875.8,4.65661287307739e-10
"3770",2017-09-15 06:04:29,605170.25,605170.25
"3771",2017-09-15 06:16:14,-605170.25,4.65661287307739e-10
"3772",2017-09-15 07:22:02,524608.08,524608.08
"3773",2017-09-15 07:31:34,-524608.08,4.65661287307739e-10
"3774",2017-09-15 07:42:51,549366.34,549366.34
"3775",2017-09-15 07:53:44,-549366.34,4.65661287307739e-10
"3776",2017-09-15 08:00:56,640713.32,640713.32
"3777",2017-09-15 08:13:54,-640713.32,4.65661287307739e-10
"3778",2017-09-15 08:32:08,575162.86,575162.86
"3779",2017-09-15 08:38:28,-575162.86,4.65661287307739e-10
"3780",2017-09-15 09:28:47,453520.8,453520.8
"3781",2017-09-15 09:33:12,-453520.8,4.65661287307739e-10
"3782",2017-09-15 10:20:35,700004.32,700004.32
"3783",2017-09-15 10:31:16,-700004.32,4.65661287307739e-10
"3784",2017-09-15 10:46:27,339504.99,339504.99
"3785",2017-09-15 10:46:27,536045.56,875550.550000001
"3786",2017-09-15 11:06:07,777781.36,1653331.91
"3787",2017-09-15 11:06:07,-875550.55,777781.360000001
"3788",2017-09-15 11:12:35,354320.4,1132101.76
"3789",2017-09-15 11:13:42,-777781.36,354320.400000001
"3790",2017-09-15 11:21:34,-354320.4,6.98491930961609e-10
"3791",2017-09-15 11:33:14,468766.77,468766.770000001
"3792",2017-09-15 11:47:50,700004.39,1168771.16
"3793",2017-09-15 11:47:50,-468766.77,700004.390000001
"3794",2017-09-15 11:55:08,-700004.39,5.82076609134674e-10
"3795",2017-09-15 12:29:24,700004.41,700004.410000001
"3796",2017-09-15 12:43:18,-700004.41,5.82076609134674e-10
"3797",2017-09-15 15:15:10,328411.11,328411.110000001
"3798",2017-09-15 15:15:10,475710.11,804121.220000001
"3799",2017-09-15 15:23:03,-804121.22,5.82076609134674e-10
"3800",2017-09-15 16:00:47,408217.86,408217.860000001
"3801",2017-09-15 16:17:13,-408217.86,5.82076609134674e-10
"3802",2017-09-15 17:01:33,205482.9,205482.900000001
"3803",2017-09-15 17:18:35,700004.65,905487.550000001
"3804",2017-09-15 17:18:35,-205482.9,700004.650000001
"3805",2017-09-15 17:23:35,-700004.65,5.82076609134674e-10
"3806",2017-09-15 17:47:26,325255.34,325255.340000001
"3807",2017-09-15 17:55:56,-325255.34,5.82076609134674e-10
"3808",2017-09-15 18:10:09,516261.28,516261.280000001
"3809",2017-09-15 18:18:29,-516261.28,5.82076609134674e-10
"3810",2017-09-15 18:55:10,247861.77,247861.770000001
"3811",2017-09-15 19:06:56,-247861.77,5.82076609134674e-10
"3812",2017-09-15 19:39:35,320764.77,320764.770000001
"3813",2017-09-15 19:39:35,211856.1,532620.870000001
"3814",2017-09-15 19:47:44,-532620.87,5.82076609134674e-10
"3815",2017-09-15 20:04:23,357335.89,357335.890000001
"3816",2017-09-15 20:09:46,-357335.89,5.82076609134674e-10
"3817",2017-09-15 21:21:04,295886.59,295886.590000001
"3818",2017-09-15 21:24:25,-295886.59,5.82076609134674e-10
"3819",2017-09-15 22:43:04,426801.58,426801.580000001
"3820",2017-09-15 22:43:04,427858.51,854660.090000001
"3821",2017-09-15 22:55:21,-854660.09,5.82076609134674e-10
"3822",2017-09-16 00:03:49,215176.94,215176.940000001
"3823",2017-09-16 00:14:07,-215176.94,5.82076609134674e-10
"3824",2017-09-16 04:07:38,267088.13,267088.130000001
"3825",2017-09-16 04:21:48,-267088.13,5.82076609134674e-10
"3826",2017-09-16 04:39:41,239169.97,239169.970000001
"3827",2017-09-16 04:44:56,-239169.97,5.82076609134674e-10
"3828",2017-09-16 05:17:03,251603.42,251603.420000001
"3829",2017-09-16 05:24:06,-251603.42,5.82076609134674e-10
"3830",2017-09-16 06:54:50,233445.22,233445.220000001
"3831",2017-09-16 07:08:03,-233445.22,5.82076609134674e-10
"3832",2017-09-16 07:20:59,432401.85,432401.850000001
"3833",2017-09-16 07:28:12,-432401.85,5.82076609134674e-10
"3834",2017-09-16 10:34:57,212215.06,212215.060000001
"3835",2017-09-16 10:34:57,200728.75,412943.810000001
"3836",2017-09-16 10:34:57,256510.34,669454.150000001
"3837",2017-09-16 10:34:57,402252.12,1071706.27
"3838",2017-09-16 10:44:35,-1071706.27,4.65661287307739e-10
"3839",2017-09-16 11:12:42,265650.8,265650.8
"3840",2017-09-16 11:12:42,700005.32,965656.12
"3841",2017-09-16 11:12:42,378498.3,1344154.42
"3842",2017-09-16 11:19:13,-1344154.42,4.65661287307739e-10
"3843",2017-09-16 16:16:22,464264.97,464264.97
"3844",2017-09-16 16:26:01,-464264.97,4.65661287307739e-10
"3845",2017-09-16 21:26:39,503729.78,503729.78
"3846",2017-09-16 21:26:39,532505.97,1036235.75
"3847",2017-09-16 21:34:20,-1036235.75,4.65661287307739e-10
"3848",2017-09-17 02:47:12,400955.61,400955.61
"3849",2017-09-17 02:56:02,-400955.61,4.65661287307739e-10
"3850",2017-09-17 04:07:27,466928.21,466928.21
"3851",2017-09-17 04:14:31,-466928.21,4.65661287307739e-10
"3852",2017-09-17 05:09:03,297248.74,297248.74
"3853",2017-09-17 05:11:46,-297248.74,4.65661287307739e-10
"3854",2017-09-17 05:38:29,283739.3,283739.3
"3855",2017-09-17 05:44:06,-283739.3,4.65661287307739e-10
"3856",2017-09-17 06:31:23,454475.52,454475.52
"3857",2017-09-17 06:51:36,-454475.52,4.65661287307739e-10
"3858",2017-09-17 08:23:24,320196.48,320196.48
"3859",2017-09-17 08:23:24,284611.61,604808.09
"3860",2017-09-17 08:37:44,283912.79,888720.88
"3861",2017-09-17 08:37:44,-604808.09,283912.79
"3862",2017-09-17 08:46:29,294265.43,578178.22
"3863",2017-09-17 08:46:29,-283912.79,294265.43
"3864",2017-09-17 08:56:10,-294265.43,4.65661287307739e-10
"3865",2017-09-17 09:58:18,453643.65,453643.65
"3866",2017-09-17 10:07:28,-453643.65,4.65661287307739e-10
"3867",2017-09-17 18:56:31,296246.4,296246.4
"3868",2017-09-17 18:56:31,26573.04,322819.44
"3869",2017-09-17 18:59:09,-322819.44,4.65661287307739e-10
"3870",2017-09-17 19:45:39,313369.8,313369.8
"3871",2017-09-17 20:36:58,-313369.8,4.65661287307739e-10
"3872",2017-09-17 22:19:48,272163.08,272163.08
"3873",2017-09-17 22:19:48,23338.04,295501.12
"3874",2017-09-17 22:19:48,29654.96,325156.08
"3875",2017-09-17 22:23:47,-325156.08,4.65661287307739e-10
"3876",2017-09-18 00:02:29,365704.7,365704.7
"3877",2017-09-18 00:13:12,-365704.7,4.65661287307739e-10
"3878",2017-09-18 06:09:28,44834.42,44834.4200000005
"3879",2017-09-18 06:18:45,-44834.42,4.65661287307739e-10
"3880",2017-09-18 07:06:11,318383.73,318383.73
"3881",2017-09-18 07:28:50,-318383.73,4.65661287307739e-10
"3882",2017-09-18 08:23:21,327445.54,327445.54
"3883",2017-09-18 08:43:15,-327445.54,4.65661287307739e-10
"3884",2017-09-18 09:46:46,300735.44,300735.44
"3885",2017-09-18 09:46:46,331863.74,632599.18
"3886",2017-09-18 11:19:06,415461.02,1048060.2
"3887",2017-09-18 11:53:31,-632599.18,415461.02
"3888",2017-09-18 12:04:26,-415461.02,3.49245965480804e-10
"3889",2017-09-18 15:18:19,686503.94,686503.94
"3890",2017-09-18 15:18:19,700006.42,1386510.36
"3891",2017-09-18 15:30:56,-1386510.36,2.3283064365387e-10
"3892",2017-09-18 16:23:51,235463.92,235463.92
"3893",2017-09-18 16:36:08,700006.5,935470.42
"3894",2017-09-18 16:36:08,264963,1200433.42
"3895",2017-09-18 16:36:08,261112.26,1461545.68
"3896",2017-09-18 16:36:08,37877.23,1499422.91
"3897",2017-09-18 16:36:08,-235463.92,1263958.99
"3898",2017-09-18 16:50:54,-1263958.99,4.65661287307739e-10
"3899",2017-09-18 18:23:44,213581.67,213581.67
"3900",2017-09-18 19:04:43,41612.25,255193.92
"3901",2017-09-18 19:04:43,-213581.67,41612.2500000005
"3902",2017-09-18 19:18:16,-41612.25,4.65661287307739e-10
"3903",2017-09-18 21:23:08,183833.69,183833.69
"3904",2017-09-18 21:40:52,218345.46,402179.15
"3905",2017-09-18 21:40:52,34734.98,436914.13
"3906",2017-09-18 21:40:52,9157.42,446071.55
"3907",2017-09-18 21:43:59,-183833.69,262237.86
"3908",2017-09-18 22:10:53,195385.91,457623.77
"3909",2017-09-18 22:19:46,500006.66,957630.43
"3910",2017-09-18 22:19:46,-262237.86,695392.57
"3911",2017-09-18 22:59:21,-695392.57,4.65661287307739e-10
"3912",2017-09-19 00:35:38,206267.77,206267.77
"3913",2017-09-19 00:53:27,176490.5,382758.27
"3914",2017-09-19 00:53:27,-206267.77,176490.5
"3915",2017-09-19 01:08:52,-176490.5,4.94765117764473e-10
"3916",2017-09-19 02:00:20,236407.26,236407.260000001
"3917",2017-09-19 02:09:19,-236407.26,4.94765117764473e-10
"3918",2017-09-19 04:09:37,307911.69,307911.690000001
"3919",2017-09-19 04:18:51,-307911.69,5.23868948221207e-10
"3920",2017-09-19 05:30:11,367737.14,367737.140000001
"3921",2017-09-19 05:30:11,232798.06,600535.200000001
"3922",2017-09-19 05:30:11,182681.91,783217.110000001
"3923",2017-09-19 05:48:40,-783217.11,5.82076609134674e-10
"3924",2017-09-19 06:04:38,306790.51,306790.510000001
"3925",2017-09-19 06:04:38,244348.87,551139.380000001
"3926",2017-09-19 06:15:07,186243.52,737382.900000001
"3927",2017-09-19 06:15:07,-551139.38,186243.520000001
"3928",2017-09-19 06:42:30,-186243.52,6.11180439591408e-10
"3929",2017-09-19 08:27:40,222333.66,222333.660000001
"3930",2017-09-19 08:53:34,206508.52,428842.180000001
"3931",2017-09-19 08:53:34,-222333.66,206508.520000001
"3932",2017-09-19 09:02:39,-206508.52,6.40284270048141e-10
"3933",2017-09-19 14:15:51,218413.08,218413.080000001
"3934",2017-09-19 14:20:28,-218413.08,6.40284270048141e-10
"3935",2017-09-19 16:40:11,307650.71,307650.710000001
"3936",2017-09-19 16:43:21,19293.15,326943.860000001
"3937",2017-09-19 16:43:21,-307650.71,19293.1500000007
"3938",2017-09-19 17:02:19,-19293.15,6.62112142890692e-10
"3939",2017-09-19 20:01:14,345796.94,345796.940000001
"3940",2017-09-19 20:01:14,201499.35,547296.290000001
"3941",2017-09-19 20:07:58,-547296.29,5.82076609134674e-10
"3942",2017-09-19 20:19:34,208733.01,208733.010000001
"3943",2017-09-19 20:33:16,189597.44,398330.450000001
"3944",2017-09-19 20:33:16,-208733.01,189597.440000001
"3945",2017-09-19 20:37:42,376804.62,566402.060000001
"3946",2017-09-19 20:37:42,-189597.44,376804.620000001
"3947",2017-09-19 20:53:25,-376804.62,5.23868948221207e-10
"3948",2017-09-19 22:45:13,201995.84,201995.840000001
"3949",2017-09-19 22:45:13,32387.43,234383.270000001
"3950",2017-09-19 22:59:54,-234383.27,5.23868948221207e-10
"3951",2017-09-19 23:44:18,196802.34,196802.340000001
"3952",2017-09-19 23:49:02,-196802.34,5.23868948221207e-10
"3953",2017-09-20 01:20:04,221640.3,221640.300000001
"3954",2017-09-20 01:28:24,-221640.3,5.23868948221207e-10
"3955",2017-09-20 02:33:27,411708.19,411708.190000001
"3956",2017-09-20 02:51:57,-411708.19,5.23868948221207e-10
"3957",2017-09-20 07:55:14,236721.84,236721.840000001
"3958",2017-09-20 08:23:45,-236721.84,5.23868948221207e-10
"3959",2017-09-21 02:06:13,336099.06,336099.060000001
"3960",2017-09-21 02:18:36,83428.53,419527.590000001
"3961",2017-09-21 02:18:36,-336099.06,83428.5300000006
"3962",2017-09-21 02:27:44,-83428.53,5.5297277867794e-10
"3963",2017-09-21 04:03:28,340438.31,340438.310000001
"3964",2017-09-21 04:17:22,269884.6,610322.91
"3965",2017-09-21 04:17:22,-340438.31,269884.600000001
"3966",2017-09-21 04:24:48,-269884.6,5.23868948221207e-10
"3967",2017-09-21 06:35:39,99336.4,99336.4000000005
"3968",2017-09-21 06:58:07,-99336.4,5.23868948221207e-10
"3969",2017-09-21 07:16:41,27306.53,27306.5300000005
"3970",2017-09-21 07:20:35,-27306.53,5.23868948221207e-10
"3971",2017-09-21 08:22:11,260021.9,260021.900000001
"3972",2017-09-21 08:31:15,-260021.9,5.23868948221207e-10
"3973",2017-09-21 12:47:22,38705.09,38705.0900000005
"3974",2017-09-21 12:47:22,18844.18,57549.2700000005
"3975",2017-09-21 12:51:03,-57549.27,5.23868948221207e-10
"3976",2017-09-21 15:15:36,195720.42,195720.420000001
"3977",2017-09-21 15:15:36,22624.18,218344.600000001
"3978",2017-09-21 15:31:09,348833.7,567178.300000001
"3979",2017-09-21 15:31:09,-218344.6,348833.700000001
"3980",2017-09-21 15:45:51,500008.51,848842.210000001
"3981",2017-09-21 15:45:51,380709.44,1229551.65
"3982",2017-09-21 15:45:51,-348833.7,880717.950000001
"3983",2017-09-21 16:00:01,-880717.95,6.98491930961609e-10
"3984",2017-09-21 16:26:10,347358.43,347358.430000001
"3985",2017-09-21 16:26:10,179336.91,526695.340000001
"3986",2017-09-21 16:48:25,700008.6,1226703.94
"3987",2017-09-21 16:48:25,184574.62,1411278.56
"3988",2017-09-21 16:48:25,-526695.34,884583.220000001
"3989",2017-09-21 16:56:24,-884583.22,5.82076609134674e-10
"3990",2017-09-21 17:11:19,700008.63,700008.630000001
"3991",2017-09-21 17:21:32,-700008.63,5.82076609134674e-10
"3992",2017-09-21 17:55:16,173742.58,173742.580000001
"3993",2017-09-21 18:14:07,178192.35,351934.930000001
"3994",2017-09-21 18:14:07,293133.92,645068.850000001
"3995",2017-09-21 18:14:07,-173742.58,471326.270000001
"3996",2017-09-21 18:21:09,210088.39,681414.660000001
"3997",2017-09-21 18:21:09,134272.67,815687.330000001
"3998",2017-09-21 18:21:09,-471326.27,344361.060000001
"3999",2017-09-21 18:25:54,-344361.06,6.40284270048141e-10
"4000",2017-09-21 19:01:09,454208.06,454208.060000001
"4001",2017-09-21 19:11:01,200212.2,654420.260000001
"4002",2017-09-21 19:11:01,-454208.06,200212.200000001
"4003",2017-09-21 19:22:21,-200212.2,6.98491930961609e-10
"4004",2017-09-21 19:35:04,358726.4,358726.400000001
"4005",2017-09-21 19:35:04,273565.08,632291.480000001
"4006",2017-09-21 19:35:04,20250.61,652542.090000001
"4007",2017-09-21 19:35:04,24406.18,676948.270000001
"4008",2017-09-21 19:41:05,-676948.27,6.98491930961609e-10
"4009",2017-09-21 19:48:16,307297.69,307297.690000001
"4010",2017-09-21 20:01:23,300008.82,607306.510000001
"4011",2017-09-21 20:01:23,330090.04,937396.550000001
"4012",2017-09-21 20:01:23,-307297.69,630098.860000001
"4013",2017-09-21 20:08:34,-630098.86,8.14907252788544e-10
"4014",2017-09-21 20:28:48,377785.84,377785.840000001
"4015",2017-09-21 20:28:48,319097.84,696883.680000001
"4016",2017-09-21 20:32:44,-696883.68,8.14907252788544e-10
"4017",2017-09-21 21:14:04,203442.93,203442.930000001
"4018",2017-09-21 21:25:57,279900.59,483343.520000001
"4019",2017-09-21 21:25:57,-203442.93,279900.590000001
"4020",2017-09-21 21:33:41,-279900.59,8.14907252788544e-10
"4021",2017-09-21 22:17:33,226734.69,226734.690000001
"4022",2017-09-21 22:25:39,-226734.69,8.14907252788544e-10
"4023",2017-09-21 23:05:07,193747.77,193747.770000001
"4024",2017-09-21 23:23:01,-193747.77,8.14907252788544e-10
"4025",2017-09-21 23:40:36,278098.42,278098.420000001
"4026",2017-09-21 23:40:36,91609.52,369707.940000001
"4027",2017-09-21 23:46:33,-369707.94,8.14907252788544e-10
"4028",2017-09-22 00:22:29,294864.16,294864.160000001
"4029",2017-09-22 00:28:48,-294864.16,8.14907252788544e-10
"4030",2017-09-22 00:37:16,303431.13,303431.130000001
"4031",2017-09-22 01:02:43,-303431.13,8.14907252788544e-10
"4032",2017-09-22 01:12:45,230035.31,230035.310000001
"4033",2017-09-22 01:18:21,-230035.31,8.14907252788544e-10
"4034",2017-09-22 03:46:40,395657.33,395657.330000001
"4035",2017-09-22 03:49:50,-395657.33,8.14907252788544e-10
"4036",2017-09-22 09:10:03,218487.72,218487.720000001
"4037",2017-09-22 09:28:50,-218487.72,8.14907252788544e-10
"4038",2017-09-22 10:55:05,250487.37,250487.370000001
"4039",2017-09-22 11:08:50,-250487.37,8.14907252788544e-10
"4040",2017-09-22 11:58:25,265915.3,265915.300000001
"4041",2017-09-22 12:31:39,195319.48,461234.780000001
"4042",2017-09-22 12:31:39,700009.17,1161243.95
"4043",2017-09-22 12:31:39,285349.78,1446593.73
"4044",2017-09-22 12:31:39,-265915.3,1180678.43
"4045",2017-09-22 12:45:57,-1180678.43,9.31322574615479e-10
"4046",2017-09-22 13:28:13,777786.18,777786.180000001
"4047",2017-09-22 14:02:34,-777786.18,9.31322574615479e-10
"4048",2017-09-22 17:32:58,227484.54,227484.540000001
"4049",2017-09-22 18:03:19,329401.75,556886.290000001
"4050",2017-09-22 18:03:19,-227484.54,329401.750000001
"4051",2017-09-22 18:15:53,-329401.75,9.31322574615479e-10
"4052",2017-09-22 21:33:18,338121.47,338121.470000001
"4053",2017-09-22 21:42:29,-338121.47,9.31322574615479e-10
"4054",2017-09-22 23:11:20,198445.41,198445.410000001
"4055",2017-09-22 23:13:02,-198445.41,9.31322574615479e-10
"4056",2017-09-23 02:25:40,235301.66,235301.660000001
"4057",2017-09-23 03:04:50,-235301.66,9.31322574615479e-10
"4058",2017-09-23 04:26:23,384888.64,384888.640000001
"4059",2017-09-23 04:37:08,-384888.64,9.31322574615479e-10
"4060",2017-09-23 05:00:47,218470.54,218470.540000001
"4061",2017-09-23 05:04:03,-218470.54,9.31322574615479e-10
"4062",2017-09-23 17:39:45,412893.49,412893.490000001
"4063",2017-09-23 18:55:34,-412893.49,9.31322574615479e-10
"4064",2017-09-24 08:55:11,279506.09,279506.090000001
"4065",2017-09-24 09:29:19,-279506.09,9.31322574615479e-10
"4066",2017-09-25 02:36:10,221847,221847.000000001
"4067",2017-09-25 02:36:10,290674.13,512521.130000001
"4068",2017-09-25 02:36:10,226625.44,739146.570000001
"4069",2017-09-25 02:55:24,-739146.57,1.04773789644241e-09
"4070",2017-09-25 15:55:57,451178.53,451178.530000001
"4071",2017-09-25 16:14:12,-451178.53,1.04773789644241e-09
"4072",2017-09-26 06:31:28,626637.88,626637.880000001
"4073",2017-09-26 06:34:51,-626637.88,1.04773789644241e-09
"4074",2017-09-28 11:14:25,433007.45,433007.450000001
"4075",2017-09-28 11:20:29,-433007.45,1.04773789644241e-09
"4076",2017-09-28 11:58:45,534471.64,534471.640000001
"4077",2017-09-28 12:31:01,-534471.64,1.04773789644241e-09
"4078",2017-09-28 14:48:17,468881.72,468881.720000001
"4079",2017-09-28 14:48:17,494588.58,963470.300000001
"4080",2017-09-28 14:54:25,777790.58,1741260.88
"4081",2017-09-28 14:54:25,-963470.3,777790.580000001
"4082",2017-09-28 15:14:56,800013.59,1577804.17
"4083",2017-09-28 15:14:56,-777790.58,800013.590000001
"4084",2017-09-28 15:23:21,-800013.59,9.31322574615479e-10
"4085",2017-09-28 16:02:25,326308.15,326308.150000001
"4086",2017-09-28 16:19:58,-326308.15,9.31322574615479e-10
"4087",2017-09-28 17:30:11,390698.44,390698.440000001
"4088",2017-09-28 17:39:27,-390698.44,9.31322574615479e-10
"4089",2017-09-28 18:55:48,441502,441502.000000001
"4090",2017-09-28 19:01:09,-441502,9.31322574615479e-10
"4091",2017-09-28 19:08:59,47152.22,47152.2200000009
"4092",2017-09-28 19:30:11,500254.88,547407.100000001
"4093",2017-09-28 19:30:11,-47152.22,500254.880000001
"4094",2017-09-28 19:35:11,-500254.88,9.31322574615479e-10
"4095",2017-09-28 20:20:48,447679.17,447679.170000001
"4096",2017-09-28 20:29:13,-447679.17,9.31322574615479e-10
"4097",2017-09-29 03:13:20,777787.74,777787.740000001
"4098",2017-09-29 03:13:20,238939.75,1016727.49
"4099",2017-09-29 03:13:20,444420.97,1461148.46
"4100",2017-09-29 03:31:24,-1461148.46,9.31322574615479e-10
"4101",2017-09-29 04:01:44,777787.81,777787.810000001
"4102",2017-09-29 04:01:44,447113.82,1224901.63
"4103",2017-09-29 04:16:26,888898.83,2113800.46
"4104",2017-09-29 04:16:26,-1224901.63,888898.830000001
"4105",2017-09-29 04:32:04,-888898.83,1.04773789644241e-09
"4106",2017-09-29 05:05:45,381409.75,381409.750000001
"4107",2017-09-29 05:10:13,-381409.75,1.04773789644241e-09
"4108",2017-09-29 05:44:08,384884.92,384884.920000001
"4109",2017-09-29 05:45:51,533623.69,918508.610000001
"4110",2017-09-29 05:45:51,-384884.92,533623.690000001
"4111",2017-09-29 06:02:46,-533623.69,1.16415321826935e-09
"4112",2017-09-29 06:28:54,598755.45,598755.450000001
"4113",2017-09-29 06:51:04,28472.03,627227.480000001
"4114",2017-09-29 06:51:04,-598755.45,28472.0300000012
"4115",2017-09-29 07:10:39,-28472.03,1.19325704872608e-09
"4116",2017-09-29 07:26:47,158224.92,158224.920000001
"4117",2017-09-29 07:35:16,-158224.92,1.19325704872608e-09
"4118",2017-09-29 10:13:43,700011.39,700011.390000001
"4119",2017-09-29 10:25:13,-700011.39,1.16415321826935e-09
"4120",2017-09-29 15:51:24,777788.02,777788.020000001
"4121",2017-09-29 15:54:36,-777788.02,1.16415321826935e-09
"4122",2017-09-30 00:02:47,77788.67,77788.6700000012
"4123",2017-09-30 00:08:32,-77788.67,1.16415321826935e-09
"4124",2017-09-30 01:27:11,658852.58,658852.580000001
"4125",2017-09-30 01:33:55,-658852.58,1.16415321826935e-09
"4126",2017-10-01 04:13:33,416178.73,416178.730000001
"4127",2017-10-01 04:21:01,-416178.73,1.16415321826935e-09
"4128",2017-10-03 06:48:19,565657.8,565657.800000001
"4129",2017-10-03 07:09:50,38341.27,603999.070000001
"4130",2017-10-03 07:09:50,-565657.8,38341.2700000012
"4131",2017-10-03 07:16:44,-38341.27,1.1859810911119e-09
"4132",2017-10-03 10:44:36,269867.89,269867.890000001
"4133",2017-10-03 10:47:43,-269867.89,1.16415321826935e-09
"4134",2017-10-03 11:24:33,284163.89,284163.890000001
"4135",2017-10-03 11:39:19,-284163.89,1.16415321826935e-09
"4136",2017-10-03 12:12:02,63427.56,63427.5600000012
"4137",2017-10-03 12:21:27,-63427.56,1.16415321826935e-09
"4138",2017-10-03 13:25:59,560941.21,560941.210000001
"4139",2017-10-03 13:29:43,-560941.21,1.16415321826935e-09
"4140",2017-10-03 13:59:53,276968.74,276968.740000001
"4141",2017-10-03 14:03:02,497309.08,774277.820000001
"4142",2017-10-03 14:13:14,-276968.74,497309.080000001
"4143",2017-10-03 14:19:07,-497309.08,1.22236087918282e-09
"4144",2017-10-03 14:38:29,777789.18,777789.180000001
"4145",2017-10-03 14:51:40,-777789.18,1.28056854009628e-09
"4146",2017-10-04 13:12:27,207478.02,207478.020000001
"4147",2017-10-04 13:24:42,30949.51,238427.530000001
"4148",2017-10-04 13:24:42,-207478.02,30949.5100000013
"4149",2017-10-04 14:10:05,-30949.51,1.29148247651756e-09
"4150",2017-10-04 14:33:12,186936.06,186936.060000001
"4151",2017-10-04 14:52:48,182179.75,369115.810000001
"4152",2017-10-04 14:52:48,-186936.06,182179.750000001
"4153",2017-10-04 15:15:09,144279.1,326458.850000001
"4154",2017-10-04 15:15:09,-182179.75,144279.100000001
"4155",2017-10-04 15:50:07,-144279.1,1.25146470963955e-09
"4156",2017-10-04 21:16:36,223934.78,223934.780000001
"4157",2017-10-04 21:51:09,-223934.78,1.25146470963955e-09
"4158",2017-10-05 03:15:33,177696.15,177696.150000001
"4159",2017-10-05 03:17:44,-177696.15,1.25146470963955e-09
"4160",2017-10-05 04:38:36,215539.82,215539.820000001
"4161",2017-10-05 04:53:07,-215539.82,1.25146470963955e-09
"4162",2017-10-05 05:49:33,276626.82,276626.820000001
"4163",2017-10-05 06:02:28,-276626.82,1.22236087918282e-09
"4164",2017-10-05 06:08:10,194347.02,194347.020000001
"4165",2017-10-05 06:25:15,-194347.02,1.22236087918282e-09
"4166",2017-10-05 06:47:03,15872.89,15872.8900000012
"4167",2017-10-05 06:47:03,211774.14,227647.030000001
"4168",2017-10-05 06:52:32,-227647.03,1.25146470963955e-09
"4169",2017-10-05 07:01:46,136463.2,136463.200000001
"4170",2017-10-05 07:18:30,-136463.2,1.25146470963955e-09
"4171",2017-10-05 10:45:08,170731.07,170731.070000001
"4172",2017-10-05 11:29:14,-170731.07,1.25146470963955e-09
"4173",2017-10-05 22:41:33,346908.4,346908.400000001
"4174",2017-10-05 22:47:31,-346908.4,1.28056854009628e-09
"4175",2017-10-07 00:45:34,605924.63,605924.630000001
"4176",2017-10-07 01:28:34,-605924.63,1.28056854009628e-09
"4177",2017-10-07 23:03:54,412958.55,412958.550000001
"4178",2017-10-07 23:07:56,-412958.55,1.28056854009628e-09
"4179",2017-10-07 23:38:15,382380.94,382380.940000001
"4180",2017-10-07 23:42:47,-382380.94,1.28056854009628e-09
"4181",2017-10-08 00:18:41,585893.49,585893.490000001
"4182",2017-10-08 00:24:19,-585893.49,1.28056854009628e-09
"4183",2017-10-10 01:13:23,619273.01,619273.010000001
"4184",2017-10-10 01:19:43,-619273.01,1.28056854009628e-09
"4185",2017-10-10 10:46:52,384972.82,384972.820000001
"4186",2017-10-10 11:08:54,512579.03,897551.850000001
"4187",2017-10-10 11:08:54,-384972.82,512579.030000001
"4188",2017-10-10 11:16:54,-512579.03,1.22236087918282e-09
"4189",2017-10-10 17:12:02,475540.45,475540.450000001
"4190",2017-10-10 17:25:45,664223.33,1139763.78
"4191",2017-10-10 17:25:45,-475540.45,664223.330000001
"4192",2017-10-10 17:40:34,-664223.33,1.28056854009628e-09
"4193",2017-10-12 08:05:32,622571.62,622571.620000001
"4194",2017-10-12 08:15:46,-622571.62,1.28056854009628e-09
"4195",2017-10-12 08:28:41,651228.81,651228.810000001
"4196",2017-10-12 08:37:13,-651228.81,1.28056854009628e-09
"4197",2017-10-12 08:46:24,470038.63,470038.630000001
"4198",2017-10-12 08:56:50,692252.17,1162290.8
"4199",2017-10-12 08:56:50,-470038.63,692252.170000001
"4200",2017-10-12 09:03:14,-692252.17,1.16415321826935e-09
"4201",2017-10-12 09:26:05,668787.2,668787.200000001
"4202",2017-10-12 09:51:19,-668787.2,1.16415321826935e-09
"4203",2017-10-12 17:39:30,686553.07,686553.070000001
"4204",2017-10-12 17:50:02,-686553.07,1.16415321826935e-09
"4205",2017-10-13 02:26:05,692358.96,692358.960000001
"4206",2017-10-13 02:36:57,-692358.96,1.16415321826935e-09
"4207",2017-10-13 03:24:51,77790.89,77790.8900000012
"4208",2017-10-13 03:24:51,777790.91,855581.800000001
"4209",2017-10-13 05:08:24,485668.59,1341250.39
"4210",2017-10-13 05:26:08,581688.61,1922939
"4211",2017-10-13 10:11:44,-855581.8,1067357.2
"4212",2017-10-13 10:37:38,-1067357.2,1.39698386192322e-09
"4213",2017-10-13 10:56:51,644405.14,644405.140000001
"4214",2017-10-13 15:26:54,705204.42,1349609.56
"4215",2017-10-13 20:05:33,-644405.14,705204.420000001
"4216",2017-10-13 20:15:51,-705204.42,1.39698386192322e-09
"4217",2017-10-15 05:49:32,661589.01,661589.010000001
"4218",2017-10-15 05:59:59,-661589.01,1.39698386192322e-09
"4219",2017-10-15 09:37:16,686338.46,686338.460000001
"4220",2017-10-15 10:10:22,-686338.46,1.39698386192322e-09
"4221",2017-10-15 12:28:55,312664.56,312664.560000001
"4222",2017-10-15 12:47:03,273576.44,586241.000000001
"4223",2017-10-15 12:47:03,-312664.56,273576.440000001
"4224",2017-10-15 13:11:30,-273576.44,1.39698386192322e-09
"4225",2017-10-15 13:44:32,283743.57,283743.570000001
"4226",2017-10-15 13:50:31,-283743.57,1.39698386192322e-09
"4227",2017-10-15 17:29:32,25818.99,25818.9900000014
"4228",2017-10-15 17:29:32,241213.03,267032.020000001
"4229",2017-10-15 17:34:35,-267032.02,1.39698386192322e-09
"4230",2017-10-15 22:22:10,278478.66,278478.660000001
"4231",2017-10-15 22:32:51,-278478.66,1.39698386192322e-09
"4232",2017-10-16 02:46:02,516850.89,516850.890000001
"4233",2017-10-16 02:48:59,-516850.89,1.39698386192322e-09
"4234",2017-10-17 00:47:31,603363.56,603363.560000001
"4235",2017-10-17 01:14:17,-603363.56,1.39698386192322e-09
"4236",2017-10-18 03:47:50,138591.16,138591.160000001
"4237",2017-10-18 03:47:50,21522.82,160113.980000001
"4238",2017-10-18 04:00:30,123488.89,283602.870000001
"4239",2017-10-18 04:00:30,-160113.98,123488.890000001
"4240",2017-10-18 04:04:10,195116.75,318605.640000001
"4241",2017-10-18 04:12:52,-318605.64,1.39698386192322e-09
"4242",2017-10-18 07:05:24,150015.39,150015.390000001
"4243",2017-10-18 07:12:06,-150015.39,1.39698386192322e-09
"4244",2017-10-18 07:26:50,300015.41,300015.410000001
"4245",2017-10-18 07:44:45,-300015.41,1.39698386192322e-09
"4246",2017-10-18 11:28:47,107394.37,107394.370000001
"4247",2017-10-18 11:28:47,139723.66,247118.030000001
"4248",2017-10-18 11:28:47,115329.69,362447.720000001
"4249",2017-10-18 11:35:52,-362447.72,1.39698386192322e-09
"4250",2017-10-18 12:05:56,199985.55,199985.550000001
"4251",2017-10-18 12:13:26,153975.82,353961.370000001
"4252",2017-10-18 12:13:26,-199985.55,153975.820000001
"4253",2017-10-18 12:38:10,-153975.82,1.39698386192322e-09
"4254",2017-10-18 13:23:47,171550.29,171550.290000001
"4255",2017-10-18 13:27:47,-171550.29,1.39698386192322e-09
"4256",2017-10-18 14:31:25,185717.62,185717.620000001
"4257",2017-10-18 15:01:59,150869.55,336587.170000001
"4258",2017-10-18 15:01:59,-185717.62,150869.550000001
"4259",2017-10-18 15:11:21,177792.77,328662.320000001
"4260",2017-10-18 15:11:21,-150869.55,177792.770000001
"4261",2017-10-18 15:16:59,-177792.77,1.36788003146648e-09
"4262",2017-10-19 01:19:34,157831.85,157831.850000001
"4263",2017-10-19 01:19:34,143024.37,300856.220000001
"4264",2017-10-19 01:23:23,-300856.22,1.39698386192322e-09
"4265",2017-10-19 02:41:52,192990.09,192990.090000001
"4266",2017-10-19 02:51:55,-192990.09,1.39698386192322e-09
"4267",2017-10-19 04:03:43,200697.39,200697.390000001
"4268",2017-10-19 04:13:07,-200697.39,1.39698386192322e-09
"4269",2017-10-19 07:15:51,157924.05,157924.050000001
"4270",2017-10-19 07:27:38,-157924.05,1.39698386192322e-09
"4271",2017-10-19 07:36:54,170631.1,170631.100000001
"4272",2017-10-19 08:08:37,9156.4,179787.500000001
"4273",2017-10-19 08:08:37,-170631.1,9156.40000000139
"4274",2017-10-19 08:28:58,-9156.4,1.39152689371258e-09
"4275",2017-10-19 10:01:10,188343.03,188343.030000001
"4276",2017-10-19 10:14:43,-188343.03,1.39698386192322e-09
"4277",2017-10-19 10:50:12,162448.97,162448.970000001
"4278",2017-10-19 11:01:55,-162448.97,1.39698386192322e-09
"4279",2017-10-19 13:08:15,280680.21,280680.210000001
"4280",2017-10-19 13:18:19,-280680.21,1.39698386192322e-09
"4281",2017-10-19 13:50:08,298414.88,298414.880000001
"4282",2017-10-19 13:56:47,-298414.88,1.39698386192322e-09
"4283",2017-10-19 14:54:22,178070.24,178070.240000001
"4284",2017-10-19 15:05:08,-178070.24,1.39698386192322e-09
"4285",2017-10-19 16:30:09,218306.49,218306.490000001
"4286",2017-10-19 16:36:17,-218306.49,1.39698386192322e-09
"4287",2017-10-19 18:37:34,9929.03,9929.0300000014
"4288",2017-10-19 18:50:11,-9929.03,1.39698386192322e-09
"4289",2017-10-19 22:12:29,146773.86,146773.860000001
"4290",2017-10-19 22:21:40,-146773.86,1.39698386192322e-09
"4291",2017-10-20 03:53:06,427765.41,427765.410000001
"4292",2017-10-20 03:59:24,-427765.41,1.39698386192322e-09
"4293",2017-10-20 14:10:29,309122.08,309122.080000001
"4294",2017-10-20 14:10:29,203886.75,513008.830000001
"4295",2017-10-20 14:43:41,300016.8,813025.630000001
"4296",2017-10-20 14:43:41,-513008.83,300016.800000001
"4297",2017-10-20 15:01:23,700016.84,1000033.64
"4298",2017-10-20 15:01:23,-300016.8,700016.840000001
"4299",2017-10-20 15:17:11,-700016.84,1.28056854009628e-09
"4300",2017-10-20 15:22:44,441787.3,441787.300000001
"4301",2017-10-20 15:44:38,259182.29,700969.590000001
"4302",2017-10-20 15:44:38,334955.89,1035925.48
"4303",2017-10-20 15:44:38,-441787.3,594138.180000001
"4304",2017-10-20 15:59:26,-594138.18,1.28056854009628e-09
"4305",2017-10-20 16:32:18,77793.96,77793.9600000013
"4306",2017-10-20 16:39:41,-77793.96,1.28056854009628e-09
"4307",2017-10-20 16:54:36,777793.99,777793.990000001
"4308",2017-10-20 17:00:01,777793.94,1555587.93
"4309",2017-10-20 17:00:01,777793.91,2333381.84
"4310",2017-10-20 17:00:01,-777793.99,1555587.85
"4311",2017-10-20 17:17:56,777793.9,2333381.75
"4312",2017-10-20 17:17:56,-1555587.85,777793.900000001
"4313",2017-10-20 17:27:50,-777793.9,1.28056854009628e-09
"4314",2017-10-20 19:07:19,380108.97,380108.970000001
"4315",2017-10-20 19:33:07,-380108.97,1.28056854009628e-09
"4316",2017-10-20 19:56:24,584902.63,584902.630000001
"4317",2017-10-20 20:05:42,-584902.63,1.28056854009628e-09
"4318",2017-10-21 03:56:58,578998.28,578998.280000001
"4319",2017-10-21 04:07:19,-578998.28,1.28056854009628e-09
"4320",2017-10-21 14:33:34,335457.93,335457.930000001
"4321",2017-10-21 14:39:32,-335457.93,1.28056854009628e-09
"4322",2017-10-21 17:22:09,195498.56,195498.560000001
"4323",2017-10-21 17:29:39,-195498.56,1.28056854009628e-09
"4324",2017-10-21 17:48:29,298365.53,298365.530000001
"4325",2017-10-21 17:58:56,-298365.53,1.28056854009628e-09
"4326",2017-10-21 21:40:16,207572.14,207572.140000001
"4327",2017-10-21 21:58:19,-207572.14,1.28056854009628e-09
"4328",2017-10-22 01:04:14,232181.04,232181.040000001
"4329",2017-10-22 01:04:14,289773.32,521954.360000001
"4330",2017-10-22 01:15:11,-521954.36,1.28056854009628e-09
"4331",2017-10-22 03:42:25,312076.56,312076.560000001
"4332",2017-10-22 03:55:03,-312076.56,1.28056854009628e-09
"4333",2017-10-22 11:30:34,211984.8,211984.800000001
"4334",2017-10-22 11:38:27,-211984.8,1.28056854009628e-09
"4335",2017-10-22 11:52:14,363762.06,363762.060000001
"4336",2017-10-22 12:08:31,377794.9,741556.960000001
"4337",2017-10-22 12:08:31,358511.78,1100068.74
"4338",2017-10-22 12:08:31,-363762.06,736306.680000001
"4339",2017-10-22 12:18:51,-736306.68,1.28056854009628e-09
"4340",2017-10-22 14:30:05,184398.45,184398.450000001
"4341",2017-10-22 14:44:23,-184398.45,1.28056854009628e-09
"4342",2017-10-22 22:18:45,208603.75,208603.750000001
"4343",2017-10-22 22:57:43,-208603.75,1.28056854009628e-09
"4344",2017-10-22 23:46:22,222835.23,222835.230000001
"4345",2017-10-22 23:52:59,-222835.23,1.28056854009628e-09
"4346",2017-10-23 02:17:44,222213.23,222213.230000001
"4347",2017-10-23 02:22:28,-222213.23,1.28056854009628e-09
"4348",2017-10-23 05:17:18,495899.37,495899.370000001
"4349",2017-10-23 05:36:31,-495899.37,1.28056854009628e-09
"4350",2017-10-23 06:29:20,371926.71,371926.710000001
"4351",2017-10-23 06:45:52,-371926.71,1.28056854009628e-09
"4352",2017-10-23 15:30:38,294254.39,294254.390000001
"4353",2017-10-23 16:02:38,-294254.39,1.28056854009628e-09
"4354",2017-10-23 16:19:10,12752.37,12752.3700000013
"4355",2017-10-23 16:26:19,170468.17,183220.540000001
"4356",2017-10-23 16:26:19,-12752.37,170468.170000001
"4357",2017-10-23 16:54:19,321229.35,491697.520000001
"4358",2017-10-23 16:58:10,-170468.17,321229.350000001
"4359",2017-10-23 17:22:52,-321229.35,1.28056854009628e-09
"4360",2017-10-23 17:29:20,158396.14,158396.140000001
"4361",2017-10-23 17:34:45,-158396.14,1.28056854009628e-09
"4362",2017-10-23 19:30:04,166525.6,166525.600000001
"4363",2017-10-23 19:57:08,-166525.6,1.28056854009628e-09
"4364",2017-10-23 20:37:16,504819.58,504819.580000001
"4365",2017-10-23 20:52:25,-504819.58,1.28056854009628e-09
"4366",2017-10-23 22:09:11,105292.31,105292.310000001
"4367",2017-10-23 22:09:11,5358.08,110650.390000001
"4368",2017-10-23 22:13:56,-110650.39,1.28056854009628e-09
"4369",2017-10-23 22:24:01,4337.25,4337.25000000128
"4370",2017-10-23 23:18:38,240078.55,244415.800000001
"4371",2017-10-23 23:18:38,113700.09,358115.890000001
"4372",2017-10-23 23:18:38,177795.79,535911.680000001
"4373",2017-10-23 23:18:38,-4337.25,531574.430000001
"4374",2017-10-23 23:21:50,300018.87,831593.300000001
"4375",2017-10-23 23:31:27,-531574.43,300018.870000001
"4376",2017-10-23 23:39:23,-300018.87,1.28056854009628e-09
"4377",2017-10-24 00:19:48,22673.55,22673.5500000013
"4378",2017-10-24 00:23:57,-22673.55,1.28056854009628e-09
"4379",2017-10-24 01:34:36,12740.83,12740.8300000013
"4380",2017-10-24 01:34:36,283067.19,295808.020000001
"4381",2017-10-24 01:43:21,-295808.02,1.28056854009628e-09
"4382",2017-10-24 02:11:30,161090.06,161090.060000001
"4383",2017-10-24 02:14:50,273770.88,434860.940000001
"4384",2017-10-24 02:18:31,-161090.06,273770.880000001
"4385",2017-10-24 02:28:20,-273770.88,1.28056854009628e-09
"4386",2017-10-24 02:43:25,112470.97,112470.970000001
"4387",2017-10-24 02:53:29,-112470.97,1.28056854009628e-09
"4388",2017-10-24 03:21:01,123008.01,123008.010000001
"4389",2017-10-24 03:31:06,162505.52,285513.530000001
"4390",2017-10-24 03:31:06,-123008.01,162505.520000001
"4391",2017-10-24 03:36:17,-162505.52,1.25146470963955e-09
"4392",2017-10-24 03:49:32,10853.44,10853.4400000013
"4393",2017-10-24 03:53:41,-10853.44,1.25146470963955e-09
"4394",2017-10-24 04:14:11,182800.06,182800.060000001
"4395",2017-10-24 04:14:11,105956.76,288756.820000001
"4396",2017-10-24 04:14:11,124014.32,412771.140000001
"4397",2017-10-24 04:20:30,-412771.14,1.22236087918282e-09
"4398",2017-10-24 04:45:51,135340.27,135340.270000001
"4399",2017-10-24 04:58:13,112601.84,247942.110000001
"4400",2017-10-24 04:58:13,129215.96,377158.070000001
"4401",2017-10-24 04:58:13,-135340.27,241817.800000001
"4402",2017-10-24 05:32:45,-241817.8,1.25146470963955e-09
"4403",2017-10-24 05:41:57,111610.58,111610.580000001
"4404",2017-10-24 05:46:40,-111610.58,1.25146470963955e-09
"4405",2017-10-24 06:31:42,118365.93,118365.930000001
"4406",2017-10-24 06:31:42,132596.59,250962.520000001
"4407",2017-10-24 06:31:42,160378.99,411341.510000001
"4408",2017-10-24 06:36:59,198289.81,609631.320000001
"4409",2017-10-24 06:36:59,-411341.51,198289.810000001
"4410",2017-10-24 06:55:26,-198289.81,1.22236087918282e-09
"4411",2017-10-24 07:44:42,179689.52,179689.520000001
"4412",2017-10-24 08:02:56,-179689.52,1.22236087918282e-09
"4413",2017-10-24 08:07:07,177795.98,177795.980000001
"4414",2017-10-24 08:07:07,188906.81,366702.790000001
"4415",2017-10-24 08:15:27,-366702.79,1.22236087918282e-09
"4416",2017-10-24 08:24:03,181105.55,181105.550000001
"4417",2017-10-24 08:31:28,-181105.55,1.22236087918282e-09
"4418",2017-10-24 08:57:41,297213.41,297213.410000001
"4419",2017-10-24 09:09:08,-297213.41,1.22236087918282e-09
"4420",2017-10-24 09:26:56,180870.7,180870.700000001
"4421",2017-10-24 09:36:25,-180870.7,1.22236087918282e-09
"4422",2017-10-24 09:49:43,308526.17,308526.170000001
"4423",2017-10-24 09:53:57,-308526.17,1.22236087918282e-09
"4424",2017-10-24 10:40:54,245064.82,245064.820000001
"4425",2017-10-24 10:59:06,8918.43,253983.250000001
"4426",2017-10-24 10:59:06,-245064.82,8918.43000000122
"4427",2017-10-24 11:11:28,487042.64,495961.070000001
"4428",2017-10-24 11:11:28,-8918.43,487042.640000001
"4429",2017-10-24 11:19:13,-487042.64,1.22236087918282e-09
"4430",2017-10-24 12:07:06,228812.79,228812.790000001
"4431",2017-10-24 12:13:40,-228812.79,1.22236087918282e-09
"4432",2017-10-24 13:31:18,239783.09,239783.090000001
"4433",2017-10-24 13:46:56,497572.58,737355.670000001
"4434",2017-10-24 13:46:56,-239783.09,497572.580000001
"4435",2017-10-24 14:01:37,-497572.58,1.22236087918282e-09
"4436",2017-10-24 14:27:02,377796.57,377796.570000001
"4437",2017-10-24 14:27:02,181375.58,559172.150000001
"4438",2017-10-24 14:36:32,-559172.15,1.16415321826935e-09
"4439",2017-10-24 15:01:36,15660.29,15660.2900000012
"4440",2017-10-24 15:10:19,185312.79,200973.080000001
"4441",2017-10-24 15:10:19,-15660.29,185312.790000001
"4442",2017-10-24 15:14:42,29356.08,214668.870000001
"4443",2017-10-24 15:14:42,-185312.79,29356.0800000012
"4444",2017-10-24 15:23:35,-29356.08,1.14960130304098e-09
"4445",2017-10-24 15:33:43,214246.43,214246.430000001
"4446",2017-10-24 16:38:57,285066.07,499312.500000001
"4447",2017-10-24 16:38:57,169959.72,669272.220000001
"4448",2017-10-24 16:42:49,-214246.43,455025.790000001
"4449",2017-10-24 16:55:32,-455025.79,1.16415321826935e-09
"4450",2017-10-24 17:05:23,377796.69,377796.690000001
"4451",2017-10-24 17:58:18,-377796.69,1.16415321826935e-09
"4452",2017-10-24 20:58:52,164296.61,164296.610000001
"4453",2017-10-24 21:04:53,188185.58,352482.190000001
"4454",2017-10-24 21:04:53,-164296.61,188185.580000001
"4455",2017-10-24 21:17:07,-188185.58,1.13504938781261e-09
"4456",2017-10-24 21:35:57,188381.94,188381.940000001
"4457",2017-10-24 21:42:34,204961.7,393343.640000001
"4458",2017-10-24 21:42:34,-188381.94,204961.700000001
"4459",2017-10-24 21:49:51,-204961.7,1.16415321826935e-09
"4460",2017-10-24 21:59:40,210693.54,210693.540000001
"4461",2017-10-24 22:01:03,-210693.54,1.16415321826935e-09
"4462",2017-10-24 22:39:20,196192.43,196192.430000001
"4463",2017-10-24 22:39:20,177381.98,373574.410000001
"4464",2017-10-24 22:52:17,300019.81,673594.220000001
"4465",2017-10-24 22:52:17,-373574.41,300019.810000001
"4466",2017-10-24 22:59:59,-300019.81,1.16415321826935e-09
"4467",2017-10-24 23:31:21,163023.12,163023.120000001
"4468",2017-10-24 23:40:13,-163023.12,1.16415321826935e-09
"4469",2017-10-25 00:25:41,166882.7,166882.700000001
"4470",2017-10-25 00:41:45,-166882.7,1.16415321826935e-09
"4471",2017-10-25 00:59:01,176624.3,176624.300000001
"4472",2017-10-25 01:04:12,211135.37,387759.670000001
"4473",2017-10-25 01:04:12,-176624.3,211135.370000001
"4474",2017-10-25 01:14:18,-211135.37,1.16415321826935e-09
"4475",2017-10-25 01:22:01,209837.96,209837.960000001
"4476",2017-10-25 01:27:28,-209837.96,1.16415321826935e-09
"4477",2017-10-25 01:30:21,184934.33,184934.330000001
"4478",2017-10-25 01:30:55,252665.37,437599.700000001
"4479",2017-10-25 01:34:13,-437599.7,1.10594555735588e-09
"4480",2017-10-25 01:40:46,206656.9,206656.900000001
"4481",2017-10-25 01:44:00,286598.79,493255.690000001
"4482",2017-10-25 02:08:04,296519.73,789775.420000001
"4483",2017-10-25 02:08:04,-493255.69,296519.730000001
"4484",2017-10-25 02:22:16,-296519.73,1.10594555735588e-09
"4485",2017-10-25 03:03:18,214112.81,214112.810000001
"4486",2017-10-25 03:03:18,300019.97,514132.780000001
"4487",2017-10-25 03:03:18,166600.43,680733.210000001
"4488",2017-10-25 03:03:18,23633.26,704366.470000001
"4489",2017-10-25 03:03:18,300019.98,1004386.45
"4490",2017-10-25 03:12:50,-1004386.45,1.16415321826935e-09
"4491",2017-10-25 05:21:16,289796.69,289796.690000001
"4492",2017-10-25 05:43:29,232694.38,522491.070000001
"4493",2017-10-25 05:43:29,-289796.69,232694.380000001
"4494",2017-10-25 05:50:06,-232694.38,1.16415321826935e-09
"4495",2017-10-25 06:25:59,201371.32,201371.320000001
"4496",2017-10-25 06:35:44,-201371.32,1.16415321826935e-09
"4497",2017-10-25 07:40:29,182771.88,182771.880000001
"4498",2017-10-25 07:55:41,-182771.88,1.16415321826935e-09
"4499",2017-10-25 10:49:23,364392.75,364392.750000001
"4500",2017-10-25 11:03:45,-364392.75,1.16415321826935e-09
"4501",2017-10-25 11:12:15,175585.13,175585.130000001
"4502",2017-10-25 11:19:53,-175585.13,1.16415321826935e-09
"4503",2017-10-25 11:36:08,241709.86,241709.860000001
"4504",2017-10-25 11:49:23,-241709.86,1.16415321826935e-09
"4505",2017-10-25 12:28:35,176147.5,176147.500000001
"4506",2017-10-25 12:58:49,-176147.5,1.16415321826935e-09
"4507",2017-10-25 16:31:59,163909.2,163909.200000001
"4508",2017-10-25 16:38:18,-163909.2,1.16415321826935e-09
"4509",2017-10-25 16:50:10,167482.46,167482.460000001
"4510",2017-10-25 17:04:58,180142.59,347625.050000001
"4511",2017-10-25 17:04:58,-167482.46,180142.590000001
"4512",2017-10-25 17:11:15,-180142.59,1.16415321826935e-09
"4513",2017-10-25 17:48:16,266847.14,266847.140000001
"4514",2017-10-25 17:55:56,-266847.14,1.16415321826935e-09
"4515",2017-10-25 18:26:32,188434.81,188434.810000001
"4516",2017-10-25 18:30:28,-188434.81,1.16415321826935e-09
"4517",2017-10-25 19:48:47,175681.53,175681.530000001
"4518",2017-10-25 20:05:50,371677.05,547358.580000001
"4519",2017-10-25 20:05:50,-175681.53,371677.050000001
"4520",2017-10-25 20:10:13,370020.29,741697.340000001
"4521",2017-10-25 20:18:39,-741697.34,1.04773789644241e-09
"4522",2017-10-25 20:50:32,300020.31,300020.310000001
"4523",2017-10-25 20:53:05,-300020.31,1.04773789644241e-09
"4524",2017-10-25 22:05:20,224549.97,224549.970000001
"4525",2017-10-25 22:14:09,-224549.97,1.04773789644241e-09
"4526",2017-10-25 22:20:33,190551.49,190551.490000001
"4527",2017-10-25 22:24:22,-190551.49,1.04773789644241e-09
"4528",2017-10-25 23:11:36,174446.85,174446.850000001
"4529",2017-10-25 23:18:33,-174446.85,1.04773789644241e-09
"4530",2017-10-25 23:36:50,239211.35,239211.350000001
"4531",2017-10-25 23:53:46,-239211.35,1.04773789644241e-09
"4532",2017-10-26 01:08:20,178909.37,178909.370000001
"4533",2017-10-26 01:21:13,-178909.37,1.04773789644241e-09
"4534",2017-10-26 02:56:32,217283.67,217283.670000001
"4535",2017-10-26 03:14:54,175543.28,392826.950000001
"4536",2017-10-26 03:14:54,-217283.67,175543.280000001
"4537",2017-10-26 03:21:51,-175543.28,1.04773789644241e-09
"4538",2017-10-26 04:52:53,279215.46,279215.460000001
"4539",2017-10-26 05:03:20,-279215.46,1.04773789644241e-09
"4540",2017-10-26 10:01:06,168208.31,168208.310000001
"4541",2017-10-26 10:04:43,-168208.31,1.04773789644241e-09
"4542",2017-10-26 11:23:26,360493.49,360493.490000001
"4543",2017-10-26 11:28:01,-360493.49,1.04773789644241e-09
"4544",2017-10-26 13:35:26,226481.82,226481.820000001
"4545",2017-10-26 13:39:19,-226481.82,1.04773789644241e-09
"4546",2017-10-26 13:50:25,186416.52,186416.520000001
"4547",2017-10-26 13:58:12,315156.39,501572.910000001
"4548",2017-10-26 13:58:12,-186416.52,315156.390000001
"4549",2017-10-26 14:11:02,162580.59,477736.980000001
"4550",2017-10-26 14:11:02,-315156.39,162580.590000001
"4551",2017-10-26 14:21:22,300020.64,462601.230000001
"4552",2017-10-26 14:21:22,-162580.59,300020.640000001
"4553",2017-10-26 14:28:02,-300020.64,1.04773789644241e-09
"4554",2017-10-26 18:47:59,323974.76,323974.760000001
"4555",2017-10-26 18:57:24,-323974.76,1.04773789644241e-09
"4556",2017-10-26 19:18:02,184330.58,184330.580000001
"4557",2017-10-26 19:43:53,-184330.58,1.04773789644241e-09
"4558",2017-10-26 22:18:29,304528.83,304528.830000001
"4559",2017-10-26 22:37:34,204261.76,508790.590000001
"4560",2017-10-26 22:37:34,-304528.83,204261.760000001
"4561",2017-10-26 23:47:26,188390.88,392652.640000001
"4562",2017-10-26 23:49:07,-204261.76,188390.880000001
"4563",2017-10-27 01:17:18,268487.99,456878.870000001
"4564",2017-10-27 01:17:18,331096.97,787975.840000001
"4565",2017-10-27 01:18:18,-188390.88,599584.960000001
"4566",2017-10-27 01:23:12,-599584.96,1.04773789644241e-09
"4567",2017-10-27 01:49:01,298424.65,298424.650000001
"4568",2017-10-27 03:23:56,-298424.65,1.04773789644241e-09
"4569",2017-10-27 10:50:26,161966.55,161966.550000001
"4570",2017-10-27 13:16:22,-161966.55,1.04773789644241e-09
"4571",2017-10-27 20:08:42,205713.93,205713.930000001
"4572",2017-10-27 20:21:25,-205713.93,1.04773789644241e-09
"4573",2017-10-28 00:27:18,195433.43,195433.430000001
"4574",2017-10-28 00:27:18,219620.95,415054.380000001
"4575",2017-10-28 00:31:14,-415054.38,1.04773789644241e-09
"4576",2017-10-29 04:55:10,165174.3,165174.300000001
"4577",2017-10-29 05:29:43,-165174.3,1.04773789644241e-09
"4578",2017-10-29 07:06:12,171898.2,171898.200000001
"4579",2017-10-29 07:09:23,-171898.2,1.04773789644241e-09
"4580",2017-10-29 07:37:38,300186.56,300186.560000001
"4581",2017-10-29 07:43:19,-300186.56,1.04773789644241e-09
"4582",2017-10-29 11:35:47,483895.44,483895.440000001
"4583",2017-10-29 11:49:10,219955.37,703850.810000001
"4584",2017-10-29 11:49:10,-483895.44,219955.370000001
"4585",2017-10-29 12:04:50,300021.9,519977.270000001
"4586",2017-10-29 12:04:50,-219955.37,300021.900000001
"4587",2017-10-29 12:18:20,-300021.9,9.89530235528946e-10
"4588",2017-10-29 14:43:25,368033.65,368033.650000001
"4589",2017-10-29 14:51:19,-368033.65,9.89530235528946e-10
"4590",2017-10-29 16:03:24,777798.94,777798.940000001
"4591",2017-10-29 16:10:00,-777798.94,9.31322574615479e-10
"4592",2017-10-29 16:36:27,777798.97,777798.970000001
"4593",2017-10-29 16:44:11,-777798.97,9.31322574615479e-10
"4594",2017-10-29 16:56:29,575475.34,575475.340000001
"4595",2017-10-29 17:04:46,-575475.34,9.31322574615479e-10
"4596",2017-10-29 17:31:59,674967.38,674967.380000001
"4597",2017-10-29 17:36:47,-674967.38,9.31322574615479e-10
"4598",2017-10-29 18:06:14,580524.63,580524.630000001
"4599",2017-10-29 18:40:56,-580524.63,9.31322574615479e-10
"4600",2017-10-29 20:00:04,660733.57,660733.570000001
"4601",2017-10-29 20:00:04,777799.06,1438532.63
"4602",2017-10-29 20:00:04,682984.49,2121517.12
"4603",2017-10-29 20:21:17,377799.28,2499316.4
"4604",2017-10-29 20:46:10,-2121517.12,377799.280000001
"4605",2017-10-29 21:04:41,-377799.28,1.16415321826935e-09
"4606",2017-10-29 21:57:39,777800.31,777800.310000001
"4607",2017-10-29 21:57:39,586240.33,1364040.64
"4608",2017-10-29 21:57:39,777800.32,2141840.96
"4609",2017-10-29 22:05:31,-2141840.96,9.31322574615479e-10
"4610",2017-10-29 22:59:45,595898.6,595898.600000001
"4611",2017-10-29 23:21:33,603831.4,1199730
"4612",2017-10-29 23:21:33,-595898.6,603831.400000001
"4613",2017-10-29 23:28:59,777800.43,1381631.83
"4614",2017-10-29 23:28:59,-603831.4,777800.430000001
"4615",2017-10-29 23:47:02,-777800.43,9.31322574615479e-10
"4616",2017-10-30 02:55:23,638676.34,638676.340000001
"4617",2017-10-30 03:10:19,-638676.34,9.31322574615479e-10
"4618",2017-10-30 03:58:13,245880.46,245880.460000001
"4619",2017-10-30 04:03:01,777800.45,1023680.91
"4620",2017-10-30 04:03:01,-245880.46,777800.450000001
"4621",2017-10-30 04:11:23,-777800.45,9.31322574615479e-10
"4622",2017-10-30 12:25:54,696731.59,696731.590000001
"4623",2017-10-30 12:39:17,-696731.59,9.31322574615479e-10
"4624",2017-11-02 00:41:42,388913.34,388913.340000001
"4625",2017-11-02 00:41:42,77802.31,466715.650000001
"4626",2017-11-02 00:53:21,-466715.65,9.31322574615479e-10
"4627",2017-11-02 02:21:17,214053.69,214053.690000001
"4628",2017-11-02 02:26:16,177802.42,391856.110000001
"4629",2017-11-02 02:28:04,-214053.69,177802.420000001
"4630",2017-11-02 02:36:18,-177802.42,9.02218744158745e-10
"4631",2017-11-02 04:43:04,196195.31,196195.310000001
"4632",2017-11-02 05:03:04,120530.67,316725.980000001
"4633",2017-11-02 05:03:04,104664.39,421390.370000001
"4634",2017-11-02 05:03:04,-196195.31,225195.060000001
"4635",2017-11-02 05:23:33,-225195.06,9.31322574615479e-10
"4636",2017-11-02 07:29:58,119040.95,119040.950000001
"4637",2017-11-02 07:29:58,118896.22,237937.170000001
"4638",2017-11-02 07:29:58,114454.85,352392.020000001
"4639",2017-11-02 07:48:32,-352392.02,9.31322574615479e-10
"4640",2017-11-02 08:39:45,94173.05,94173.0500000009
"4641",2017-11-02 08:54:35,-94173.05,9.31322574615479e-10
"4642",2017-11-02 09:07:14,77802.66,77802.6600000009
"4643",2017-11-02 09:12:37,-77802.66,9.31322574615479e-10
"4644",2017-11-02 10:54:28,48793.97,48793.9700000009
"4645",2017-11-02 11:09:43,-48793.97,9.31322574615479e-10
"4646",2017-11-02 11:41:12,56842.57,56842.5700000009
"4647",2017-11-02 11:48:11,-56842.57,9.31322574615479e-10
"4648",2017-11-02 12:06:38,37802.93,37802.9300000009
"4649",2017-11-02 12:06:38,77802.99,115605.920000001
"4650",2017-11-02 12:28:36,300026.06,415631.980000001
"4651",2017-11-02 12:28:36,-115605.92,300026.060000001
"4652",2017-11-02 12:52:05,-300026.06,9.31322574615479e-10
"4653",2017-11-02 13:23:54,178785.19,178785.190000001
"4654",2017-11-02 13:23:54,83392.43,262177.620000001
"4655",2017-11-02 13:31:11,-262177.62,9.31322574615479e-10
"4656",2017-11-02 13:41:02,177803.21,177803.210000001
"4657",2017-11-02 13:43:16,-177803.21,9.31322574615479e-10
"4658",2017-11-02 13:55:24,134828.68,134828.680000001
"4659",2017-11-02 13:55:24,101344.79,236173.470000001
"4660",2017-11-02 14:08:35,-236173.47,9.02218744158745e-10
"4661",2017-11-02 14:22:56,200789.24,200789.240000001
"4662",2017-11-02 14:34:13,77803.11,278592.350000001
"4663",2017-11-02 14:34:13,-200789.24,77803.1100000009
"4664",2017-11-02 14:44:37,137803.34,215606.450000001
"4665",2017-11-02 14:44:37,-77803.11,137803.340000001
"4666",2017-11-02 15:29:50,177803.41,315606.750000001
"4667",2017-11-02 15:29:50,137803.36,453410.110000001
"4668",2017-11-02 15:29:50,-137803.34,315606.770000001
"4669",2017-11-02 15:39:39,-315606.77,9.31322574615479e-10
"4670",2017-11-02 16:05:22,143837.18,143837.180000001
"4671",2017-11-02 16:09:26,-143837.18,9.31322574615479e-10
"4672",2017-11-02 16:22:57,102090.77,102090.770000001
"4673",2017-11-02 16:46:25,87749.8,189840.570000001
"4674",2017-11-02 16:46:25,-102090.77,87749.8000000009
"4675",2017-11-02 16:54:46,300026.51,387776.310000001
"4676",2017-11-02 16:54:46,-87749.8,300026.510000001
"4677",2017-11-02 17:03:19,-300026.51,9.31322574615479e-10
"4678",2017-11-02 17:23:51,86803.28,86803.2800000009
"4679",2017-11-02 17:40:51,70853.88,157657.160000001
"4680",2017-11-02 17:40:51,68071.13,225728.290000001
"4681",2017-11-02 17:40:51,-86803.28,138925.010000001
"4682",2017-11-02 17:49:04,-138925.01,9.31322574615479e-10
"4683",2017-11-02 18:17:03,179208.06,179208.060000001
"4684",2017-11-02 18:26:30,67321.7,246529.760000001
"4685",2017-11-02 18:26:30,-179208.06,67321.7000000009
"4686",2017-11-02 18:38:53,-67321.7,9.45874489843845e-10
"4687",2017-11-02 19:06:27,141403.75,141403.750000001
"4688",2017-11-02 19:09:55,108365.47,249769.220000001
"4689",2017-11-02 19:33:03,-141403.75,108365.470000001
"4690",2017-11-02 19:45:16,-108365.47,9.31322574615479e-10
"4691",2017-11-02 20:07:08,118148.79,118148.790000001
"4692",2017-11-02 20:17:36,-118148.79,9.31322574615479e-10
"4693",2017-11-02 20:17:36,77803.38,77803.3800000009
"4694",2017-11-02 20:19:27,86352.91,164156.290000001
"4695",2017-11-02 20:25:08,165099.91,329256.200000001
"4696",2017-11-02 20:25:08,-164156.29,165099.910000001
"4697",2017-11-02 20:33:24,193554.29,358654.200000001
"4698",2017-11-02 20:33:24,-165099.91,193554.290000001
"4699",2017-11-02 20:45:07,-193554.29,9.31322574615479e-10
"4700",2017-11-02 20:52:37,164759.53,164759.530000001
"4701",2017-11-02 20:57:40,-164759.53,9.31322574615479e-10
"4702",2017-11-02 21:24:24,132015.17,132015.170000001
"4703",2017-11-02 21:43:01,157047.19,289062.360000001
"4704",2017-11-02 21:43:01,-132015.17,157047.190000001
"4705",2017-11-02 22:02:08,132320.2,289367.390000001
"4706",2017-11-02 22:02:08,-157047.19,132320.200000001
"4707",2017-11-02 22:16:30,-132320.2,9.31322574615479e-10
"4708",2017-11-02 23:19:01,5187.6,5187.60000000093
"4709",2017-11-02 23:33:00,-5187.6,9.31322574615479e-10
"4710",2017-11-03 00:21:51,6447.41,6447.41000000093
"4711",2017-11-03 00:21:51,223426.78,229874.190000001
"4712",2017-11-03 00:27:00,204450.99,434325.180000001
"4713",2017-11-03 00:27:00,-229874.19,204450.990000001
"4714",2017-11-03 00:47:44,195926.05,400377.040000001
"4715",2017-11-03 00:47:44,136596.36,536973.400000001
"4716",2017-11-03 00:47:44,-204450.99,332522.410000001
"4717",2017-11-03 01:08:52,155638.56,488160.970000001
"4718",2017-11-03 01:08:52,-332522.41,155638.560000001
"4719",2017-11-03 01:49:17,170234.79,325873.350000001
"4720",2017-11-03 01:49:17,-155638.56,170234.790000001
"4721",2017-11-03 02:18:22,178662.15,348896.940000001
"4722",2017-11-03 02:18:22,-170234.79,178662.150000001
"4723",2017-11-03 03:02:09,-178662.15,8.73114913702011e-10
"4724",2017-11-03 03:21:36,266658.83,266658.830000001
"4725",2017-11-03 03:21:36,257866.96,524525.790000001
"4726",2017-11-03 03:48:27,-524525.79,8.14907252788544e-10
"4727",2017-11-03 04:11:48,177804.21,177804.210000001
"4728",2017-11-03 04:11:48,174331.85,352136.060000001
"4729",2017-11-03 04:23:14,-352136.06,8.14907252788544e-10
"4730",2017-11-03 09:12:47,777807.08,777807.080000001
"4731",2017-11-03 09:12:47,67427.09,845234.170000001
"4732",2017-11-03 09:25:11,-845234.17,6.98491930961609e-10
"4733",2017-11-03 10:12:43,300030.15,300030.150000001
"4734",2017-11-03 10:12:43,208400.3,508430.450000001
"4735",2017-11-03 10:17:04,388918.18,897348.630000001
"4736",2017-11-03 10:17:04,-508430.45,388918.180000001
"4737",2017-11-03 10:45:06,-388918.18,6.98491930961609e-10
"4738",2017-11-03 10:53:24,300030.19,300030.190000001
"4739",2017-11-03 11:11:21,-300030.19,6.98491930961609e-10
"4740",2017-11-03 12:14:37,300030.25,300030.250000001
"4741",2017-11-03 12:23:19,-300030.25,6.98491930961609e-10
"4742",2017-11-03 13:17:24,155856.76,155856.760000001
"4743",2017-11-03 13:23:52,-155856.76,6.98491930961609e-10
"4744",2017-11-03 13:35:22,181667.36,181667.360000001
"4745",2017-11-03 13:35:22,300030.34,481697.700000001
"4746",2017-11-03 13:38:58,-481697.7,6.98491930961609e-10
"4747",2017-11-03 14:07:28,300030.36,300030.360000001
"4748",2017-11-03 14:20:45,-300030.36,6.98491930961609e-10
"4749",2017-11-03 14:35:28,158956.29,158956.290000001
"4750",2017-11-03 16:03:29,283616.38,442572.670000001
"4751",2017-11-03 16:03:29,300030.43,742603.100000001
"4752",2017-11-03 16:33:53,-158956.29,583646.810000001
"4753",2017-11-03 17:00:46,-583646.81,6.98491930961609e-10
"4754",2017-11-03 17:24:44,146681.63,146681.630000001
"4755",2017-11-03 18:24:11,157713.1,304394.730000001
"4756",2017-11-03 18:32:47,135542.08,439936.810000001
"4757",2017-11-03 18:52:28,300030.53,739967.340000001
"4758",2017-11-03 19:05:28,-146681.63,593285.710000001
"4759",2017-11-03 21:18:25,-593285.71,6.98491930961609e-10
"4760",2017-11-03 22:04:40,114656.52,114656.520000001
"4761",2017-11-03 22:12:03,300030.75,414687.270000001
"4762",2017-11-03 22:12:03,-114656.52,300030.750000001
"4763",2017-11-03 22:27:39,-300030.75,6.98491930961609e-10
"4764",2017-11-04 01:00:36,228760.42,228760.420000001
"4765",2017-11-04 01:00:36,116595.56,345355.980000001
"4766",2017-11-04 01:00:36,5156.54,350512.520000001
"4767",2017-11-04 01:12:35,-350512.52,6.40284270048141e-10
"4768",2017-11-04 01:44:44,107587.84,107587.840000001
"4769",2017-11-04 01:44:44,144592.97,252180.810000001
"4770",2017-11-04 01:44:44,126047.26,378228.070000001
"4771",2017-11-04 02:05:22,115357.95,493586.020000001
"4772",2017-11-04 02:05:22,-378228.07,115357.950000001
"4773",2017-11-04 02:28:27,-115357.95,6.54836185276508e-10
"4774",2017-11-04 04:17:35,193873.22,193873.220000001
"4775",2017-11-04 04:33:55,377808.11,571681.330000001
"4776",2017-11-04 04:33:55,-193873.22,377808.110000001
"4777",2017-11-04 05:03:03,77808.15,455616.260000001
"4778",2017-11-04 05:03:03,-377808.11,77808.1500000007
"4779",2017-11-04 05:10:12,-77808.15,7.27595761418343e-10
"4780",2017-11-04 06:44:19,119332.8,119332.800000001
"4781",2017-11-04 06:56:10,101935.71,221268.510000001
"4782",2017-11-04 06:56:10,-119332.8,101935.710000001
"4783",2017-11-04 07:23:00,250031.22,351966.930000001
"4784",2017-11-04 07:23:00,-101935.71,250031.220000001
"4785",2017-11-04 07:33:21,-250031.22,7.27595761418343e-10
"4786",2017-11-04 09:43:16,116645.67,116645.670000001
"4787",2017-11-04 09:59:35,-116645.67,7.27595761418343e-10
"4788",2017-11-04 12:26:52,157656.31,157656.310000001
"4789",2017-11-04 12:26:52,135898.91,293555.220000001
"4790",2017-11-04 12:33:16,-293555.22,7.56699591875076e-10
"4791",2017-11-04 12:41:32,377808.49,377808.490000001
"4792",2017-11-04 12:47:06,-377808.49,7.56699591875076e-10
"4793",2017-11-04 13:27:16,189195.34,189195.340000001
"4794",2017-11-04 13:49:07,142087.06,331282.400000001
"4795",2017-11-04 13:49:07,-189195.34,142087.060000001
"4796",2017-11-04 13:57:11,200697.32,342784.380000001
"4797",2017-11-04 13:57:11,-142087.06,200697.320000001
"4798",2017-11-04 14:14:15,186249.69,386947.010000001
"4799",2017-11-04 14:14:15,-200697.32,186249.690000001
"4800",2017-11-04 14:15:16,184129.45,370379.140000001
"4801",2017-11-04 14:25:16,214678.21,585057.350000001
"4802",2017-11-04 14:25:16,-370379.14,214678.210000001
"4803",2017-11-04 14:36:03,-214678.21,6.69388100504875e-10
"4804",2017-11-04 14:44:06,300031.74,300031.740000001
"4805",2017-11-04 14:52:59,-300031.74,6.98491930961609e-10
"4806",2017-11-04 15:57:56,180595.77,180595.770000001
"4807",2017-11-04 16:14:52,300031.81,480627.580000001
"4808",2017-11-04 16:14:52,-180595.77,300031.810000001
"4809",2017-11-04 16:27:18,252914.07,552945.880000001
"4810",2017-11-04 16:27:18,-300031.81,252914.070000001
"4811",2017-11-04 16:38:23,-252914.07,5.82076609134674e-10
"4812",2017-11-04 22:56:04,481363.41,481363.410000001
"4813",2017-11-04 22:56:04,777811.4,1259174.81
"4814",2017-11-04 23:03:51,-1259174.81,4.65661287307739e-10
"4815",2017-11-05 01:10:28,15062.68,15062.6800000005
"4816",2017-11-05 01:26:32,-15062.68,4.65661287307739e-10
"4817",2017-11-05 23:54:26,390478.6,390478.6
"4818",2017-11-06 00:07:20,-390478.6,4.65661287307739e-10
"4819",2017-11-06 10:01:52,709335.7,709335.7
"4820",2017-11-06 10:08:59,-709335.7,4.65661287307739e-10
"4821",2017-11-06 10:18:13,217699.25,217699.25
"4822",2017-11-06 10:23:51,-217699.25,4.65661287307739e-10
"4823",2017-11-06 13:05:45,460039.59,460039.59
"4824",2017-11-06 13:05:45,249697.61,709737.2
"4825",2017-11-06 14:00:11,-709737.2,4.65661287307739e-10
"4826",2017-11-06 15:37:10,375922.49,375922.49
"4827",2017-11-06 15:52:48,458460.96,834383.45
"4828",2017-11-06 15:52:48,-375922.49,458460.96
"4829",2017-11-06 16:03:02,-458460.96,4.07453626394272e-10
"4830",2017-11-06 19:13:03,606686.97,606686.97
"4831",2017-11-06 19:20:06,-606686.97,4.65661287307739e-10
"4832",2017-11-06 19:34:59,449074.41,449074.41
"4833",2017-11-06 19:37:37,-449074.41,4.65661287307739e-10
"4834",2017-11-06 20:03:35,436488.18,436488.18
"4835",2017-11-06 20:35:18,-436488.18,4.65661287307739e-10
"4836",2017-11-07 00:09:22,300039.06,300039.06
"4837",2017-11-07 00:11:56,-300039.06,4.65661287307739e-10
"4838",2017-11-07 00:25:45,264414.42,264414.42
"4839",2017-11-07 00:38:36,-264414.42,4.65661287307739e-10
"4840",2017-11-07 01:09:37,184172.78,184172.78
"4841",2017-11-07 01:16:09,-184172.78,4.65661287307739e-10
"4842",2017-11-07 03:10:53,138846.07,138846.07
"4843",2017-11-07 03:36:03,-138846.07,4.65661287307739e-10
"4844",2017-11-07 05:48:03,184092.54,184092.54
"4845",2017-11-07 06:14:08,-184092.54,4.65661287307739e-10
"4846",2017-11-07 07:49:39,170460.21,170460.21
"4847",2017-11-07 07:55:19,-170460.21,4.65661287307739e-10
"4848",2017-11-07 08:02:51,77816.05,77816.0500000005
"4849",2017-11-07 08:13:10,-77816.05,4.65661287307739e-10
"4850",2017-11-07 08:51:00,77816.25,77816.2500000005
"4851",2017-11-07 08:56:51,-77816.25,4.65661287307739e-10
"4852",2017-11-07 09:52:33,88927.28,88927.2800000005
"4853",2017-11-07 10:11:57,-88927.28,4.65661287307739e-10
"4854",2017-11-07 11:41:07,231124.78,231124.78
"4855",2017-11-07 11:45:06,255039.8,486164.58
"4856",2017-11-07 11:45:06,-231124.78,255039.8
"4857",2017-11-07 12:07:03,-255039.8,4.36557456851006e-10
"4858",2017-11-07 13:38:28,7575.4,7575.40000000044
"4859",2017-11-07 13:52:09,-7575.4,4.36557456851006e-10
"4860",2017-11-07 15:18:52,409531.14,409531.14
"4861",2017-11-07 15:28:39,-409531.14,4.65661287307739e-10
"4862",2017-11-07 15:50:49,6332.47,6332.47000000047
"4863",2017-11-07 16:03:01,-6332.47,4.65661287307739e-10
"4864",2017-11-07 17:09:57,146462.74,146462.74
"4865",2017-11-07 17:17:29,125001.49,271464.23
"4866",2017-11-07 17:17:29,-146462.74,125001.49
"4867",2017-11-07 17:27:57,-125001.49,4.51109372079372e-10
"4868",2017-11-07 17:57:52,100039.6,100039.6
"4869",2017-11-07 18:08:06,-100039.6,4.51109372079372e-10
"4870",2017-11-07 20:44:01,70039.41,70039.4100000005
"4871",2017-11-07 20:46:54,-70039.41,4.51109372079372e-10
"4872",2017-11-07 21:19:19,77818.52,77818.5200000005
"4873",2017-11-07 21:22:30,77818.51,155637.03
"4874",2017-11-07 21:22:30,77818.56,233455.59
"4875",2017-11-07 21:23:50,-77818.52,155637.07
"4876",2017-11-07 21:34:52,-155637.07,4.07453626394272e-10
"4877",2017-11-07 22:50:01,100039.64,100039.64
"4878",2017-11-07 22:50:01,300039.53,400079.17
"4879",2017-11-07 22:50:01,614929.95,1015009.12
"4880",2017-11-07 22:58:35,-1015009.12,3.49245965480804e-10
"4881",2017-11-07 23:43:51,12146.32,12146.3200000003
"4882",2017-11-08 00:11:01,150726.46,162872.78
"4883",2017-11-08 00:11:01,-12146.32,150726.46
"4884",2017-11-08 00:18:30,-150726.46,3.49245965480804e-10
"4885",2017-11-08 00:32:07,166242,166242
"4886",2017-11-08 00:55:06,-166242,3.49245965480804e-10
"4887",2017-11-08 02:03:49,243581.14,243581.14
"4888",2017-11-08 02:03:49,305267.17,548848.31
"4889",2017-11-08 02:13:03,201433.23,750281.54
"4890",2017-11-08 02:13:03,-548848.31,201433.23
"4891",2017-11-08 02:21:03,-201433.23,2.03726813197136e-10
"4892",2017-11-08 02:26:26,271787.99,271787.99
"4893",2017-11-08 02:43:05,-271787.99,2.3283064365387e-10
"4894",2017-11-08 03:08:39,459611.2,459611.2
"4895",2017-11-08 03:33:07,-459611.2,2.3283064365387e-10
"4896",2017-11-08 03:58:48,210410.01,210410.01
"4897",2017-11-08 04:07:03,-210410.01,2.3283064365387e-10
"4898",2017-11-08 04:47:14,174894.17,174894.17
"4899",2017-11-08 05:11:36,165148.27,340042.44
"4900",2017-11-08 05:11:36,179450.05,519492.49
"4901",2017-11-08 05:11:36,-174894.17,344598.32
"4902",2017-11-08 05:32:54,300042.68,644641
"4903",2017-11-08 05:32:54,-344598.32,300042.68
"4904",2017-11-08 05:44:40,-300042.68,2.3283064365387e-10
"4905",2017-11-08 06:23:31,160916.58,160916.58
"4906",2017-11-08 06:29:06,-160916.58,2.3283064365387e-10
"4907",2017-11-08 06:59:06,199838.43,199838.43
"4908",2017-11-08 07:07:41,-199838.43,2.3283064365387e-10
"4909",2017-11-08 07:32:16,237279.32,237279.32
"4910",2017-11-08 08:02:57,176443.71,413723.03
"4911",2017-11-08 08:02:57,-237279.32,176443.71
"4912",2017-11-08 08:17:28,-176443.71,2.61934474110603e-10
"4913",2017-11-08 08:36:21,148798.53,148798.53
"4914",2017-11-08 08:50:18,-148798.53,2.61934474110603e-10
"4915",2017-11-08 09:52:50,171947.89,171947.89
"4916",2017-11-08 10:01:34,-171947.89,2.61934474110603e-10
"4917",2017-11-08 10:20:33,152930.23,152930.23
"4918",2017-11-08 10:32:24,-152930.23,2.61934474110603e-10
"4919",2017-11-08 11:40:25,312936.31,312936.31
"4920",2017-11-08 11:40:25,194602.15,507538.46
"4921",2017-11-08 11:48:44,191505.12,699043.58
"4922",2017-11-08 11:48:44,-507538.46,191505.12
"4923",2017-11-08 12:01:27,-191505.12,2.91038304567337e-10
"4924",2017-11-08 12:09:28,247362.34,247362.34
"4925",2017-11-08 12:14:14,-247362.34,2.91038304567337e-10
"4926",2017-11-08 12:28:10,288314.74,288314.74
"4927",2017-11-08 12:36:10,-288314.74,2.91038304567337e-10
"4928",2017-11-08 12:53:46,247944.83,247944.83
"4929",2017-11-08 12:58:57,-247944.83,2.91038304567337e-10
"4930",2017-11-08 13:22:28,229650.08,229650.08
"4931",2017-11-08 13:38:34,-229650.08,2.91038304567337e-10
"4932",2017-11-08 14:25:15,277829.83,277829.83
"4933",2017-11-08 14:39:19,184321.45,462151.28
"4934",2017-11-08 14:39:19,219548.75,681700.03
"4935",2017-11-08 14:39:19,-277829.83,403870.2
"4936",2017-11-08 15:00:18,182926.5,586796.7
"4937",2017-11-08 15:00:18,-403870.2,182926.5
"4938",2017-11-08 15:08:20,218780.91,401707.41
"4939",2017-11-08 15:21:00,-182926.5,218780.91
"4940",2017-11-08 15:30:38,-218780.91,1.45519152283669e-10
"4941",2017-11-08 15:50:00,260658.74,260658.74
"4942",2017-11-08 16:03:18,-260658.74,1.45519152283669e-10
"4943",2017-11-08 16:25:40,300043.12,300043.12
"4944",2017-11-08 16:48:44,-300043.12,1.16415321826935e-10
"4945",2017-11-08 17:14:45,77820.49,77820.4900000001
"4946",2017-11-08 17:28:50,-77820.49,1.16415321826935e-10
"4947",2017-11-08 23:51:00,777822.94,777822.94
"4948",2017-11-09 00:02:53,777822.97,1555645.91
"4949",2017-11-09 00:21:44,-777822.94,777822.97
"4950",2017-11-09 00:58:40,254032.92,1031855.89
"4951",2017-11-09 01:06:06,-777822.97,254032.92
"4952",2017-11-09 01:21:41,231903.15,485936.07
"4953",2017-11-09 01:23:21,-254032.92,231903.15
"4954",2017-11-09 01:39:23,13045.47,244948.62
"4955",2017-11-09 01:39:23,319394.57,564343.19
"4956",2017-11-09 01:39:23,-231903.15,332440.04
"4957",2017-11-09 02:02:08,218542.14,550982.18
"4958",2017-11-09 02:02:08,-332440.04,218542.14
"4959",2017-11-09 02:40:19,408942.91,627485.05
"4960",2017-11-09 03:28:24,300046.13,927531.18
"4961",2017-11-09 03:40:02,-218542.14,708989.04
"4962",2017-11-09 03:53:28,-708989.04,2.3283064365387e-10
"4963",2017-11-09 04:27:18,186978.09,186978.09
"4964",2017-11-09 04:35:47,-186978.09,2.3283064365387e-10
"4965",2017-11-09 05:05:40,251208.48,251208.48
"4966",2017-11-09 05:22:46,231561.34,482769.82
"4967",2017-11-09 05:22:46,-251208.48,231561.34
"4968",2017-11-09 05:44:10,396425.07,627986.41
"4969",2017-11-09 05:44:10,219715.39,847701.8
"4970",2017-11-09 05:44:10,-231561.34,616140.46
"4971",2017-11-09 05:52:39,-616140.46,3.49245965480804e-10
"4972",2017-11-09 07:11:58,406833.44,406833.44
"4973",2017-11-09 07:24:53,-406833.44,3.49245965480804e-10
"4974",2017-11-09 08:49:22,233975.15,233975.15
"4975",2017-11-09 09:12:15,-233975.15,3.49245965480804e-10
"4976",2017-11-09 09:26:51,300473.17,300473.17
"4977",2017-11-09 09:35:29,-300473.17,3.49245965480804e-10
"4978",2017-11-09 10:16:11,346622.52,346622.52
"4979",2017-11-09 10:20:49,-346622.52,3.49245965480804e-10
"4980",2017-11-09 12:03:00,229730.26,229730.26
"4981",2017-11-09 12:08:35,-229730.26,3.49245965480804e-10
"4982",2017-11-09 12:26:38,344155.01,344155.01
"4983",2017-11-09 12:46:53,212855.54,557010.55
"4984",2017-11-09 12:46:53,-344155.01,212855.54
"4985",2017-11-09 13:07:59,-212855.54,3.78349795937538e-10
"4986",2017-11-09 13:14:40,189480.31,189480.31
"4987",2017-11-09 13:23:14,-189480.31,3.78349795937538e-10
"4988",2017-11-09 14:21:33,293513.32,293513.32
"4989",2017-11-09 14:29:55,-293513.32,4.07453626394272e-10
"4990",2017-11-09 16:11:02,345135.24,345135.24
"4991",2017-11-09 16:29:40,-345135.24,4.07453626394272e-10
"4992",2017-11-10 01:01:37,777827.81,777827.810000001
"4993",2017-11-10 01:01:37,357803.82,1135631.63
"4994",2017-11-10 01:17:45,-1135631.63,6.98491930961609e-10
"4995",2017-11-10 01:35:52,236048.69,236048.690000001
"4996",2017-11-10 01:35:52,316351.16,552399.850000001
"4997",2017-11-10 01:43:50,204356.91,756756.760000001
"4998",2017-11-10 01:43:50,-552399.85,204356.910000001
"4999",2017-11-10 01:54:56,257704.58,462061.490000001
"5000",2017-11-10 01:54:56,-204356.91,257704.580000001
"5001",2017-11-10 02:15:36,392313.85,650018.430000001
"5002",2017-11-10 02:15:36,-257704.58,392313.850000001
"5003",2017-11-10 02:28:01,-392313.85,6.98491930961609e-10
"5004",2017-11-10 04:35:29,305405.22,305405.220000001
"5005",2017-11-10 04:50:36,17278.29,322683.510000001
"5006",2017-11-10 04:50:36,-305405.22,17278.2900000007
"5007",2017-11-10 05:08:36,-17278.29,6.76664058119059e-10
"5008",2017-11-10 07:25:04,310375.46,310375.460000001
"5009",2017-11-10 07:41:16,-310375.46,6.98491930961609e-10
"5010",2017-11-10 09:10:38,210230.35,210230.350000001
"5011",2017-11-10 09:22:50,-210230.35,6.98491930961609e-10
"5012",2017-11-10 12:13:29,214326.62,214326.620000001
"5013",2017-11-10 12:21:04,211023.09,425349.710000001
"5014",2017-11-10 12:21:04,-214326.62,211023.090000001
"5015",2017-11-10 12:47:09,272246.64,483269.730000001
"5016",2017-11-10 12:47:09,221738.57,705008.300000001
"5017",2017-11-10 12:47:09,-211023.09,493985.210000001
"5018",2017-11-10 13:22:44,309798.28,803783.490000001
"5019",2017-11-10 13:22:44,300051.47,1103834.96
"5020",2017-11-10 13:22:44,-493985.21,609849.750000001
"5021",2017-11-10 13:54:38,-609849.75,9.31322574615479e-10
"5022",2017-11-10 14:24:37,506497.87,506497.870000001
"5023",2017-11-10 14:39:21,777828.55,1284326.42
"5024",2017-11-10 14:39:21,-506497.87,777828.550000001
"5025",2017-11-10 15:19:38,-777828.55,8.14907252788544e-10
"5026",2017-11-10 16:03:25,616395.38,616395.380000001
"5027",2017-11-10 16:10:03,-616395.38,8.14907252788544e-10
"5028",2017-11-10 17:34:03,353687.18,353687.180000001
"5029",2017-11-10 17:57:02,302941.46,656628.640000001
"5030",2017-11-10 18:13:23,-353687.18,302941.460000001
"5031",2017-11-10 19:04:07,777828.76,1080770.22
"5032",2017-11-10 19:04:07,-302941.46,777828.760000001
"5033",2017-11-10 19:11:33,-777828.76,9.31322574615479e-10
"5034",2017-11-10 20:02:47,472771.85,472771.850000001
"5035",2017-11-10 20:02:47,235097.21,707869.060000001
"5036",2017-11-10 20:04:50,77828.81,785697.870000001
"5037",2017-11-10 20:04:50,88939.83,874637.700000001
"5038",2017-11-10 20:04:50,88939.84,963577.540000001
"5039",2017-11-10 20:33:08,-707869.06,255708.480000001
"5040",2017-11-10 20:33:08,88939.87,344648.350000001
"5041",2017-11-10 20:54:41,777828.91,1122477.26
"5042",2017-11-10 20:58:13,-344648.35,777828.910000001
"5043",2017-11-10 21:18:04,-777828.91,6.98491930961609e-10
"5044",2017-11-10 22:03:22,700051.97,700051.970000001
"5045",2017-11-10 22:08:42,-700051.97,6.98491930961609e-10
"5046",2017-11-11 00:01:01,436590.52,436590.520000001
"5047",2017-11-11 00:01:01,226790.44,663380.960000001
"5048",2017-11-11 00:34:16,700052.05,1363433.01
"5049",2017-11-11 05:40:16,-663380.96,700052.050000001
"5050",2017-11-11 16:11:28,366377.43,1066429.48
"5051",2017-11-11 18:31:45,7e+05,1766429.48
"5052",2017-11-11 20:46:23,8e+05,2566429.48
"5053",2017-11-11 22:29:35,1e+06,3566429.48
"5054",2017-11-12 01:05:13,1e+06,4566429.48
"5055",2017-11-13 01:51:34,1e+06,5566429.48
"5056",2017-11-13 01:52:52,88939.95,5655369.43
"5057",2017-11-13 01:52:52,88939.88,5744309.31
"5058",2017-11-13 04:00:15,-700052.05,5044257.26
"5059",2017-11-13 07:34:13,-5044257.26,9.31322574615479e-10
"5060",2017-11-13 10:16:40,399299.28,399299.280000001
"5061",2017-11-13 10:26:59,-399299.28,9.31322574615479e-10
"5062",2017-11-13 13:58:50,1165196.72,1165196.72
"5063",2017-11-13 14:06:56,-1165196.72,9.31322574615479e-10
"5064",2017-11-13 14:25:39,352281.9,352281.900000001
"5065",2017-11-13 14:32:44,-352281.9,9.31322574615479e-10
"5066",2017-11-13 14:32:44,481381.08,481381.080000001
"5067",2017-11-13 14:44:53,-481381.08,9.31322574615479e-10
"5068",2017-11-13 18:36:09,777830.16,777830.160000001
"5069",2017-11-13 18:45:34,-777830.16,9.31322574615479e-10
"5070",2017-11-13 18:45:34,351113.62,351113.620000001
"5071",2017-11-13 19:18:16,-351113.62,9.31322574615479e-10
"5072",2017-11-13 21:32:00,500053.21,500053.210000001
"5073",2017-11-13 21:38:20,-500053.21,9.31322574615479e-10
"5074",2017-11-13 21:38:20,500053.22,500053.220000001
"5075",2017-11-13 21:38:20,332821.54,832874.760000001
"5076",2017-11-13 21:38:20,465584.65,1298459.41
"5077",2017-11-13 21:52:46,-1298459.41,1.16415321826935e-09
"5078",2017-11-14 00:14:41,574525.74,574525.740000001
"5079",2017-11-14 00:32:31,-574525.74,1.16415321826935e-09
"5080",2017-11-14 02:35:32,453510.34,453510.340000001
"5081",2017-11-14 02:49:51,-453510.34,1.16415321826935e-09
"5082",2017-11-14 03:01:10,686326.94,686326.940000001
"5083",2017-11-14 03:13:13,-686326.94,1.16415321826935e-09
"5084",2017-11-14 09:58:22,327893.32,327893.320000001
"5085",2017-11-14 10:31:30,-327893.32,1.16415321826935e-09
"5086",2017-11-14 11:38:05,777830.45,777830.450000001
"5087",2017-11-14 11:52:00,-777830.45,1.16415321826935e-09
"5088",2017-11-14 11:52:00,136325.46,136325.460000001
"5089",2017-11-14 11:57:32,-136325.46,1.16415321826935e-09
"5090",2017-11-15 01:24:02,356247.82,356247.820000001
"5091",2017-11-15 01:30:06,-356247.82,1.16415321826935e-09
"5092",2017-11-15 02:45:56,774626.2,774626.200000001
"5093",2017-11-15 02:45:56,398904.99,1173531.19
"5094",2017-11-15 02:59:05,-1173531.19,1.16415321826935e-09
"5095",2017-11-15 03:10:05,641333.08,641333.080000001
"5096",2017-11-15 03:16:50,-641333.08,1.16415321826935e-09
"5097",2017-11-15 03:30:50,645111.43,645111.430000001
"5098",2017-11-15 03:38:25,-645111.43,1.16415321826935e-09
"5099",2017-11-15 04:45:10,452852.34,452852.340000001
"5100",2017-11-15 05:00:22,-452852.34,1.16415321826935e-09
"5101",2017-11-15 10:55:57,255935.38,255935.380000001
"5102",2017-11-15 11:30:54,-255935.38,1.16415321826935e-09
"5103",2017-11-15 11:30:54,777830.75,777830.750000001
"5104",2017-11-15 11:30:54,388864.54,1166695.29
"5105",2017-11-15 12:19:51,-1166695.29,1.16415321826935e-09
"5106",2017-11-15 13:19:42,150050.82,150050.820000001
"5107",2017-11-15 13:31:45,-150050.82,1.16415321826935e-09
"5108",2017-11-15 14:58:31,777830.84,777830.840000001
"5109",2017-11-15 14:58:31,380050.39,1157881.23
"5110",2017-11-15 15:15:36,-1157881.23,1.16415321826935e-09
"5111",2017-11-15 19:24:23,620359.14,620359.140000001
"5112",2017-11-15 19:38:56,-620359.14,1.16415321826935e-09
"5113",2017-11-15 20:26:01,325459.5,325459.500000001
"5114",2017-11-15 20:28:25,305994.79,631454.290000001
"5115",2017-11-15 20:30:21,-325459.5,305994.790000001
"5116",2017-11-15 20:43:19,-305994.79,1.22236087918282e-09
"5117",2017-11-15 20:43:19,490420.83,490420.830000001
"5118",2017-11-15 21:03:58,-490420.83,1.22236087918282e-09
"5119",2017-11-15 22:08:57,15945.32,15945.3200000012
"5120",2017-11-15 22:17:39,-15945.32,1.22236087918282e-09
"5121",2017-11-16 01:02:37,494491.39,494491.390000001
"5122",2017-11-16 01:29:27,-494491.39,1.22236087918282e-09
"5123",2017-11-16 02:13:46,405610.8,405610.800000001
"5124",2017-11-16 04:21:24,-405610.8,1.22236087918282e-09
"5125",2017-11-16 04:21:24,114185.9,114185.900000001
"5126",2017-11-16 04:21:24,777831.89,892017.790000001
"5127",2017-11-16 04:41:12,-892017.79,1.16415321826935e-09
"5128",2017-11-16 04:58:08,583760.62,583760.620000001
"5129",2017-11-16 05:03:02,-583760.62,1.16415321826935e-09
"5130",2017-11-16 07:59:57,490914.87,490914.870000001
"5131",2017-11-16 08:43:09,-490914.87,1.16415321826935e-09
"5132",2017-11-16 08:43:09,729910.97,729910.970000001
"5133",2017-11-16 08:58:48,-729910.97,1.16415321826935e-09
"5134",2017-11-16 10:45:52,771203.31,771203.310000001
"5135",2017-11-16 10:49:09,-771203.31,1.16415321826935e-09
"5136",2017-11-16 11:46:07,740542.33,740542.330000001
"5137",2017-11-16 12:02:55,-740542.33,1.16415321826935e-09
"5138",2017-11-16 13:55:45,704015.22,704015.220000001
"5139",2017-11-16 13:55:45,698181.5,1402196.72
"5140",2017-11-16 14:15:53,-1402196.72,1.16415321826935e-09
"5141",2017-11-16 15:35:24,459924.36,459924.360000001
"5142",2017-11-16 15:50:28,-459924.36,1.16415321826935e-09
"5143",2017-11-16 16:40:40,777832.13,777832.130000001
"5144",2017-11-16 16:40:40,48172.14,826004.270000001
"5145",2017-11-16 17:04:25,-826004.27,1.16415321826935e-09
"5146",2017-11-16 17:53:09,777832.16,777832.160000001
"5147",2017-11-16 17:53:09,143075.17,920907.330000001
"5148",2017-11-16 17:57:44,-920907.33,1.28056854009628e-09
"5149",2017-11-16 18:00:39,209229.21,209229.210000001
"5150",2017-11-16 18:03:20,777832.2,987061.410000001
"5151",2017-11-16 18:36:47,-987061.41,1.16415321826935e-09
"5152",2017-11-16 18:36:47,492333.78,492333.780000001
"5153",2017-11-16 18:53:15,-492333.78,1.16415321826935e-09
"5154",2017-11-16 19:13:16,777832.28,777832.280000001
"5155",2017-11-16 19:13:49,494163.52,1271995.8
"5156",2017-11-16 19:36:42,-1271995.8,1.16415321826935e-09
"5157",2017-11-16 19:39:58,636952.47,636952.470000001
"5158",2017-11-16 19:50:18,-636952.47,1.16415321826935e-09
"5159",2017-11-16 21:02:09,442769.06,442769.060000001
"5160",2017-11-16 21:21:55,-442769.06,1.16415321826935e-09
"5161",2017-11-16 21:42:56,75437.34,75437.3400000012
"5162",2017-11-16 21:42:56,777832.33,853269.670000001
"5163",2017-11-16 21:42:56,777832.32,1631101.99
"5164",2017-11-16 21:55:44,-1631101.99,1.16415321826935e-09
"5165",2017-11-16 22:07:37,777832.37,777832.370000001
"5166",2017-11-16 22:20:58,-777832.37,1.16415321826935e-09
"5167",2017-11-16 22:20:58,489861.41,489861.410000001
"5168",2017-11-16 22:20:58,777832.4,1267693.81
"5169",2017-11-16 22:35:47,-1267693.81,1.16415321826935e-09
"5170",2017-11-16 22:35:47,204230.44,204230.440000001
"5171",2017-11-16 22:35:47,777832.43,982062.870000001
"5172",2017-11-16 22:53:42,-982062.87,1.28056854009628e-09
"5173",2017-11-17 00:31:58,508350.46,508350.460000001
"5174",2017-11-17 00:31:58,777832.45,1286182.91
"5175",2017-11-17 00:41:23,-1286182.91,1.39698386192322e-09
"5176",2017-11-17 00:41:23,777832.49,777832.490000001
"5177",2017-11-17 00:41:23,381141.5,1158973.99
"5178",2017-11-17 01:18:35,-1158973.99,1.39698386192322e-09
"5179",2017-11-17 01:18:35,204725.54,204725.540000001
"5180",2017-11-17 01:34:35,-204725.54,1.39698386192322e-09
"5181",2017-11-17 02:24:54,777826.78,777826.780000001
"5182",2017-11-17 02:29:31,-777826.78,1.39698386192322e-09
"5183",2017-11-17 09:48:19,777828.03,777828.030000001
"5184",2017-11-17 09:53:24,100057.24,877885.270000001
"5185",2017-11-17 12:48:03,777835.1,1655720.37
"5186",2017-11-17 12:48:03,777832.53,2433552.9
"5187",2017-11-17 12:48:03,140301.11,2573854.01
"5188",2017-11-17 13:09:57,377828.19,2951682.2
"5189",2017-11-17 16:57:51,-2951682.2,9.31322574615479e-10
"5190",2017-11-17 22:33:41,565299.2,565299.200000001
"5191",2017-11-17 23:05:18,613325.45,1178624.65
"5192",2017-11-17 23:40:03,562501.76,1741126.41
"5193",2017-11-18 00:24:01,888946.2,2630072.61
"5194",2017-11-18 00:24:01,888946.19,3519018.8
"5195",2017-11-18 00:31:53,-1741126.41,1777892.39
"5196",2017-11-18 00:48:10,-1777892.39,9.31322574615479e-10
"5197",2017-11-18 09:03:02,458545.16,458545.160000001
"5198",2017-11-18 09:11:05,-458545.16,9.31322574615479e-10
"5199",2017-11-18 10:13:40,641025.24,641025.240000001
"5200",2017-11-18 10:27:58,-641025.24,9.31322574615479e-10
"5201",2017-11-18 11:54:52,659532.16,659532.160000001
"5202",2017-11-18 12:02:11,-659532.16,9.31322574615479e-10
"5203",2017-11-18 12:40:09,453686.38,453686.380000001
"5204",2017-11-18 12:55:18,-453686.38,9.31322574615479e-10
"5205",2017-11-18 13:45:15,682525.07,682525.070000001
"5206",2017-11-18 14:01:48,-682525.07,9.31322574615479e-10
"5207",2017-11-18 14:27:50,744237.36,744237.360000001
"5208",2017-11-18 14:38:07,-744237.36,9.31322574615479e-10
"5209",2017-11-18 14:38:07,449108.52,449108.520000001
"5210",2017-11-18 14:46:58,-449108.52,9.31322574615479e-10
"5211",2017-11-18 16:38:10,34151.54,34151.5400000009
"5212",2017-11-18 16:44:17,-34151.54,9.31322574615479e-10
"5213",2017-11-18 18:34:18,449583.59,449583.590000001
"5214",2017-11-18 18:42:21,-449583.59,9.31322574615479e-10
"5215",2017-11-18 19:08:28,217226.44,217226.440000001
"5216",2017-11-18 19:08:28,777835.43,995061.870000001
"5217",2017-11-18 19:34:56,-995061.87,1.04773789644241e-09
"5218",2017-11-18 19:34:56,479890.88,479890.880000001
"5219",2017-11-18 19:47:34,-479890.88,1.04773789644241e-09
"5220",2017-11-19 17:54:23,716845.58,716845.580000001
"5221",2017-11-19 18:10:38,-716845.58,1.04773789644241e-09
"5222",2017-11-19 18:10:38,777835.57,777835.570000001
"5223",2017-11-19 18:27:00,-777835.57,1.04773789644241e-09
"5224",2017-11-19 18:27:00,560576.64,560576.640000001
"5225",2017-11-19 18:27:00,777835.63,1338412.27
"5226",2017-11-19 18:37:19,-1338412.27,9.31322574615479e-10
"5227",2017-11-20 16:16:17,342374.81,342374.810000001
"5228",2017-11-20 16:16:17,777835.8,1120210.61
"5229",2017-11-20 16:20:22,-1120210.61,9.31322574615479e-10
"5230",2017-11-22 10:46:16,95496.68,95496.6800000009
"5231",2017-11-22 10:59:56,-95496.68,9.31322574615479e-10
"5232",2017-11-22 11:26:35,61713.99,61713.9900000009
"5233",2017-11-22 11:34:30,-61713.99,9.31322574615479e-10
"5234",2017-11-22 13:26:07,36370.31,36370.3100000009
"5235",2017-11-22 13:29:20,-36370.31,9.31322574615479e-10
"5236",2017-11-22 13:50:39,210144.44,210144.440000001
"5237",2017-11-22 14:19:30,173115.18,383259.620000001
"5238",2017-11-22 14:19:30,-210144.44,173115.180000001
"5239",2017-11-22 14:30:13,-173115.18,9.31322574615479e-10
"5240",2017-11-22 16:04:04,113369.62,113369.620000001
"5241",2017-11-22 16:23:49,-113369.62,9.31322574615479e-10
"5242",2017-11-22 21:55:40,56852.46,56852.4600000009
"5243",2017-11-22 22:08:51,-56852.46,9.31322574615479e-10
"5244",2017-11-23 05:06:45,777844.44,777844.440000001
"5245",2017-11-23 05:26:13,777844.49,1555688.93
"5246",2017-11-23 05:26:13,-777844.44,777844.490000001
"5247",2017-11-23 05:39:46,-777844.49,9.31322574615479e-10
"5248",2017-11-23 10:44:47,777846.62,777846.620000001
"5249",2017-11-23 10:51:40,777846.71,1555693.33
"5250",2017-11-23 10:51:40,777846.69,2333540.02
"5251",2017-11-23 11:01:05,-777846.62,1555693.4
"5252",2017-11-23 11:11:15,-1555693.4,9.31322574615479e-10
"5253",2017-11-23 12:05:06,777847.14,777847.140000001
"5254",2017-11-23 12:08:50,-777847.14,9.31322574615479e-10
"5255",2017-11-23 14:35:44,777848.29,777848.290000001
"5256",2017-11-23 14:47:25,-777848.29,9.31322574615479e-10
"5257",2017-11-23 19:54:12,313408.87,313408.870000001
"5258",2017-11-23 20:03:09,335331.75,648740.620000001
"5259",2017-11-23 20:03:09,-313408.87,335331.750000001
"5260",2017-11-23 20:18:29,-335331.75,9.31322574615479e-10
"5261",2017-11-23 20:50:33,129171.68,129171.680000001
"5262",2017-11-23 20:50:33,591036.36,720208.040000001
"5263",2017-11-23 20:59:38,-720208.04,9.31322574615479e-10
"5264",2017-11-24 01:16:34,303092.72,303092.720000001
"5265",2017-11-24 01:41:24,-303092.72,9.31322574615479e-10
"5266",2017-11-24 03:54:13,266031.24,266031.240000001
"5267",2017-11-24 04:08:25,-266031.24,9.31322574615479e-10
"5268",2017-11-24 06:23:21,320418.95,320418.950000001
"5269",2017-11-24 06:31:19,-320418.95,9.31322574615479e-10
"5270",2017-11-24 08:27:30,597153.99,597153.990000001
"5271",2017-11-24 08:27:30,356559.05,953713.040000001
"5272",2017-11-24 08:43:21,402713.61,1356426.65
"5273",2017-11-24 08:43:21,-953713.04,402713.610000001
"5274",2017-11-24 09:00:01,274593.37,677306.980000001
"5275",2017-11-24 09:00:01,-402713.61,274593.370000001
"5276",2017-11-24 09:10:36,-274593.37,8.14907252788544e-10
"5277",2017-11-24 09:43:17,463246.21,463246.210000001
"5278",2017-11-24 09:50:45,-463246.21,8.14907252788544e-10
"5279",2017-11-24 11:47:07,403917.83,403917.830000001
"5280",2017-11-24 11:58:37,-403917.83,8.14907252788544e-10
"5281",2017-11-24 12:33:50,338880.65,338880.650000001
"5282",2017-11-24 12:38:04,368815.79,707696.440000001
"5283",2017-11-24 12:57:52,-707696.44,9.31322574615479e-10
"5284",2017-11-24 13:39:08,887911.51,887911.510000001
"5285",2017-11-24 14:14:41,-887911.51,9.31322574615479e-10
"5286",2017-11-24 14:42:17,477827.96,477827.960000001
"5287",2017-11-24 14:54:39,-477827.96,9.31322574615479e-10
"5288",2017-11-24 15:23:11,19068.4,19068.4000000009
"5289",2017-11-24 15:35:03,483911.19,502979.590000001
"5290",2017-11-24 15:35:03,-19068.4,483911.190000001
"5291",2017-11-24 15:56:30,-483911.19,9.31322574615479e-10
"5292",2017-11-24 16:48:43,406419.76,406419.760000001
"5293",2017-11-24 16:52:41,-406419.76,9.31322574615479e-10
"5294",2017-11-24 17:58:58,726518.02,726518.020000001
"5295",2017-11-24 18:04:31,-726518.02,9.31322574615479e-10
"5296",2017-11-24 20:27:58,437784.47,437784.470000001
"5297",2017-11-24 20:50:34,-437784.47,9.31322574615479e-10
"5298",2017-11-24 23:30:00,633749.35,633749.350000001
"5299",2017-11-24 23:49:16,-633749.35,9.31322574615479e-10
"5300",2017-11-25 01:38:38,475124.27,475124.270000001
"5301",2017-11-25 02:06:19,-475124.27,9.31322574615479e-10
"5302",2017-11-25 05:15:59,697647.39,697647.390000001
"5303",2017-11-25 05:46:50,-697647.39,9.31322574615479e-10
"5304",2017-11-25 07:09:51,35373.72,35373.7200000009
"5305",2017-11-25 07:24:31,-35373.72,9.31322574615479e-10
"5306",2017-11-25 08:33:13,777850.66,777850.660000001
"5307",2017-11-25 08:33:13,636619.07,1414469.73
"5308",2017-11-25 08:33:13,286629.67,1701099.4
"5309",2017-11-25 08:54:06,-1701099.4,9.31322574615479e-10
"5310",2017-11-25 09:07:14,121590.7,121590.700000001
"5311",2017-11-25 09:07:14,777850.69,899441.390000001
"5312",2017-11-25 09:19:18,-899441.39,8.14907252788544e-10
"5313",2017-11-25 09:29:01,743434.44,743434.440000001
"5314",2017-11-25 09:33:19,-743434.44,8.14907252788544e-10
"5315",2017-11-25 09:41:47,621472.11,621472.110000001
"5316",2017-11-25 09:59:36,-621472.11,8.14907252788544e-10
"5317",2017-11-25 10:38:54,105626.77,105626.770000001
"5318",2017-11-25 10:38:54,777850.76,883477.530000001
"5319",2017-11-25 10:52:48,-883477.53,8.14907252788544e-10
"5320",2017-11-25 13:32:56,88962.45,88962.4500000008
"5321",2017-11-25 13:32:56,300074.51,389036.960000001
"5322",2017-11-25 13:51:49,-389036.96,8.14907252788544e-10
"5323",2017-11-25 17:03:44,53005.8,53005.8000000008
"5324",2017-11-25 17:16:28,-53005.8,8.14907252788544e-10
"5325",2017-11-25 17:36:26,59949.16,59949.1600000008
"5326",2017-11-25 17:44:48,-59949.16,8.14907252788544e-10
"5327",2017-11-25 18:00:15,89746.45,89746.4500000008
"5328",2017-11-25 18:04:43,-89746.45,8.14907252788544e-10
"5329",2017-11-25 18:44:51,75483.59,75483.5900000008
"5330",2017-11-25 18:52:25,-75483.59,8.14907252788544e-10
"5331",2017-11-25 20:04:27,113721.93,113721.930000001
"5332",2017-11-25 20:33:52,-113721.93,8.14907252788544e-10
"5333",2017-11-25 23:22:39,300075.26,300075.260000001
"5334",2017-11-25 23:26:44,-300075.26,8.14907252788544e-10
"5335",2017-11-26 01:04:06,364595.74,364595.740000001
"5336",2017-11-26 01:25:27,-364595.74,8.14907252788544e-10
"5337",2017-11-26 01:35:38,207436.55,207436.550000001
"5338",2017-11-26 02:13:41,-207436.55,8.14907252788544e-10
"5339",2017-11-26 03:03:58,352091.14,352091.140000001
"5340",2017-11-26 03:14:48,-352091.14,8.14907252788544e-10
"5341",2017-11-26 04:03:28,236190.39,236190.390000001
"5342",2017-11-26 04:30:13,-236190.39,8.14907252788544e-10
"5343",2017-11-26 06:16:20,270017.41,270017.410000001
"5344",2017-11-26 06:17:14,230868.6,500886.010000001
"5345",2017-11-26 06:30:01,-500886.01,8.14907252788544e-10
"5346",2017-11-26 06:30:01,230802.12,230802.120000001
"5347",2017-11-26 06:38:37,-230802.12,8.14907252788544e-10
"5348",2017-11-26 07:23:02,228934.78,228934.780000001
"5349",2017-11-26 07:31:37,-228934.78,8.14907252788544e-10
"5350",2017-11-26 08:21:16,10190.2,10190.2000000008
"5351",2017-11-26 08:29:28,-10190.2,8.14907252788544e-10
"5352",2017-11-26 08:29:28,198336.43,198336.430000001
"5353",2017-11-26 08:38:46,-198336.43,8.14907252788544e-10
"5354",2017-11-26 09:41:46,355244.14,355244.140000001
"5355",2017-11-26 09:41:46,196750.62,551994.760000001
"5356",2017-11-26 09:47:49,-551994.76,8.14907252788544e-10
"5357",2017-11-26 18:15:05,367824.89,367824.890000001
"5358",2017-11-26 18:28:03,-367824.89,8.14907252788544e-10
"5359",2017-11-26 19:58:10,16770.06,16770.0600000008
"5360",2017-11-26 20:14:41,-16770.06,8.14907252788544e-10
"5361",2017-11-26 20:14:41,147372.17,147372.170000001
"5362",2017-11-26 20:31:25,-147372.17,8.14907252788544e-10
"5363",2017-11-26 21:34:21,114038.71,114038.710000001
"5364",2017-11-26 21:47:15,-114038.71,8.14907252788544e-10
"5365",2017-11-26 21:47:15,78793.55,78793.5500000008
"5366",2017-11-26 22:01:16,-78793.55,8.14907252788544e-10
"5367",2017-11-26 22:09:53,7807.88,7807.88000000082
"5368",2017-11-26 22:32:10,-7807.88,8.14907252788544e-10
"5369",2017-11-26 23:36:36,777853.4,777853.400000001
"5370",2017-11-26 23:38:21,777853.42,1555706.82
"5371",2017-11-26 23:49:04,777853.44,2333560.26
"5372",2017-11-26 23:49:04,777853.46,3111413.72
"5373",2017-11-26 23:49:04,-1555706.82,1555706.9
"5374",2017-11-27 00:10:24,888964.49,2444671.39
"5375",2017-11-27 00:10:24,777853.53,3222524.92
"5376",2017-11-27 00:10:24,-1555706.9,1666818.02
"5377",2017-11-27 00:20:55,777853.55,2444671.57
"5378",2017-11-27 00:20:55,-1666818.02,777853.550000001
"5379",2017-11-27 00:32:52,777853.58,1555707.13
"5380",2017-11-27 00:32:52,-777853.55,777853.580000001
"5381",2017-11-27 00:46:30,-777853.58,1.28056854009628e-09
"5382",2017-11-27 12:07:58,461002.66,461002.660000001
"5383",2017-11-27 12:07:58,777853.65,1238856.31
"5384",2017-11-27 12:07:58,888965.85,2127822.16
"5385",2017-11-27 12:07:58,888965.81,3016787.97
"5386",2017-11-27 12:07:58,777854.83,3794642.8
"5387",2017-11-27 12:24:30,888965.87,4683608.67
"5388",2017-11-27 12:24:30,888965.89,5572574.56
"5389",2017-11-27 12:24:30,-3794642.8,1777931.76
"5390",2017-11-27 12:34:05,-1777931.76,6.98491930961609e-10
"5391",2017-11-27 12:45:07,888965.9,888965.900000001
"5392",2017-11-27 12:58:19,-888965.9,6.98491930961609e-10
"5393",2017-11-27 13:02:40,88965.91,88965.9100000007
"5394",2017-11-27 13:07:20,-88965.91,6.98491930961609e-10
"5395",2017-11-27 13:32:36,888965.94,888965.940000001
"5396",2017-11-27 13:32:36,888965.93,1777931.87
"5397",2017-11-27 13:57:50,-1777931.87,4.65661287307739e-10
"5398",2017-11-27 14:21:05,888965.96,888965.96
"5399",2017-11-27 14:33:35,-888965.96,4.65661287307739e-10
"5400",2017-11-27 15:32:55,888966,888966
"5401",2017-11-27 15:44:17,-888966,4.65661287307739e-10
"5402",2017-11-27 17:07:00,777855.04,777855.040000001
"5403",2017-11-27 17:17:41,-777855.04,4.65661287307739e-10
"5404",2017-11-27 21:03:56,777855.07,777855.07
"5405",2017-11-27 21:03:56,377748.08,1155603.15
"5406",2017-11-27 21:16:34,-1155603.15,4.65661287307739e-10
"5407",2017-11-27 22:19:08,603696.16,603696.16
"5408",2017-11-27 22:32:14,-603696.16,4.65661287307739e-10
"5409",2017-11-28 00:56:04,33057.39,33057.3900000005
"5410",2017-11-28 01:21:18,-33057.39,4.65661287307739e-10
"5411",2017-11-28 04:04:34,65503.24,65503.2400000005
"5412",2017-11-28 04:13:57,-65503.24,4.65661287307739e-10
"5413",2017-11-28 07:15:23,77855.73,77855.7300000005
"5414",2017-11-28 07:15:23,777855.71,855711.44
"5415",2017-11-28 07:28:48,522139.31,1377850.75
"5416",2017-11-28 07:28:48,777855.79,2155706.54
"5417",2017-11-28 07:28:48,-855711.44,1299995.1
"5418",2017-11-28 07:51:55,-1299995.1,4.65661287307739e-10
"5419",2017-11-28 12:57:45,738473.42,738473.420000001
"5420",2017-11-28 13:08:49,-738473.42,4.65661287307739e-10
"5421",2017-11-28 14:22:52,888967.13,888967.13
"5422",2017-11-28 14:22:52,888967.09,1777934.22
"5423",2017-11-28 14:41:17,888967.11,2666901.33
"5424",2017-11-28 14:41:17,-1777934.22,888967.110000001
"5425",2017-11-28 14:52:12,-888967.11,5.82076609134674e-10
"5426",2017-11-29 01:58:09,888967.27,888967.270000001
"5427",2017-11-29 02:07:32,-888967.27,5.82076609134674e-10
"5428",2017-11-29 02:58:30,888967.29,888967.290000001
"5429",2017-11-29 03:31:23,-888967.29,5.82076609134674e-10
"5430",2017-11-29 04:31:20,777856.31,777856.310000001
"5431",2017-11-29 04:43:38,-777856.31,5.82076609134674e-10
"5432",2017-11-29 08:11:21,888967.71,888967.710000001
"5433",2017-11-29 08:11:21,888967.69,1777935.4
"5434",2017-11-29 08:20:49,-1777935.4,4.65661287307739e-10
"5435",2017-11-29 08:38:54,888967.81,888967.810000001
"5436",2017-11-29 08:38:54,888967.75,1777935.56
"5437",2017-11-29 08:38:54,888967.73,2666903.29
"5438",2017-11-29 08:38:54,888967.79,3555871.08
"5439",2017-11-29 08:47:38,888967.77,4444838.85
"5440",2017-11-29 08:47:38,-3555871.08,888967.77
"5441",2017-11-29 08:58:14,-888967.77,4.65661287307739e-10
"5442",2017-11-29 16:46:12,95745.16,95745.1600000005
"5443",2017-11-29 17:11:07,-95745.16,4.65661287307739e-10
"5444",2017-11-29 17:38:07,777857.11,777857.11
"5445",2017-11-29 17:50:13,888968.12,1666825.23
"5446",2017-11-29 17:53:04,-777857.11,888968.12
"5447",2017-11-29 18:13:02,-888968.12,4.65661287307739e-10
"5448",2017-11-29 18:54:57,392815.75,392815.75
"5449",2017-11-29 19:05:14,292772.15,685587.9
"5450",2017-11-29 19:05:14,777857.14,1463445.04
"5451",2017-11-29 19:05:14,-392815.75,1070629.29
"5452",2017-11-29 19:56:44,-1070629.29,4.65661287307739e-10
"5453",2017-11-29 22:18:48,494093.27,494093.27
"5454",2017-11-29 22:18:48,777857.28,1271950.55
"5455",2017-11-29 22:18:48,777857.26,2049807.81
"5456",2017-11-29 22:18:48,777857.25,2827665.06
"5457",2017-11-29 22:45:48,-2827665.06,4.65661287307739e-10
"5458",2017-11-29 23:45:59,900720.94,900720.94
"5459",2017-11-29 23:48:24,5666.35,906387.29
"5460",2017-11-29 23:48:24,777857.34,1684244.63
"5461",2017-11-29 23:50:21,-900720.94,783523.69
"5462",2017-11-30 00:09:38,777857.39,1561381.08
"5463",2017-11-30 00:09:38,197009.37,1758390.45
"5464",2017-11-30 00:09:38,777857.36,2536247.81
"5465",2017-11-30 00:09:38,-783523.69,1752724.12
"5466",2017-11-30 00:20:23,-1752724.12,4.65661287307739e-10
"5467",2017-11-30 00:33:58,777857.4,777857.4
"5468",2017-11-30 00:33:58,381455.41,1159312.81
"5469",2017-11-30 00:39:09,-1159312.81,4.65661287307739e-10
"5470",2017-11-30 01:13:59,579456.18,579456.180000001
"5471",2017-11-30 01:25:35,-579456.18,4.65661287307739e-10
"5472",2017-11-30 01:31:17,632743.53,632743.53
"5473",2017-11-30 01:31:17,472435.65,1105179.18
"5474",2017-11-30 01:54:03,-1105179.18,6.98491930961609e-10
"5475",2017-11-30 08:30:33,777858.41,777858.410000001
"5476",2017-11-30 08:30:33,343090.42,1120948.83
"5477",2017-11-30 08:54:34,-1120948.83,6.98491930961609e-10
"5478",2017-11-30 10:08:23,467828.79,467828.790000001
"5479",2017-11-30 10:22:28,-467828.79,6.98491930961609e-10
"5480",2017-11-30 12:02:04,390499.52,390499.520000001
"5481",2017-11-30 12:07:53,-390499.52,6.98491930961609e-10
"5482",2017-11-30 12:57:46,766070.85,766070.850000001
"5483",2017-11-30 13:26:28,-766070.85,6.98491930961609e-10
"5484",2017-11-30 15:13:42,543445.73,543445.730000001
"5485",2017-11-30 15:13:42,675035.48,1218481.21
"5486",2017-11-30 15:30:39,-1218481.21,6.98491930961609e-10
"5487",2017-11-30 15:56:26,480947.36,480947.360000001
"5488",2017-11-30 16:32:23,468519.35,949466.710000001
"5489",2017-11-30 16:32:23,447538.43,1397005.14
"5490",2017-11-30 16:32:23,583892.45,1980897.59
"5491",2017-11-30 17:33:21,777858.67,2758756.26
"5492",2017-11-30 19:47:01,-480947.36,2277808.9
"5493",2017-11-30 19:58:32,-2277808.9,9.31322574615479e-10
"5494",2017-11-30 20:39:38,777858.94,777858.940000001
"5495",2017-11-30 20:39:38,334531.95,1112390.89
"5496",2017-11-30 20:39:38,580013.22,1692404.11
"5497",2017-11-30 21:10:17,888969.98,2581374.09
"5498",2017-11-30 21:10:17,-1692404.11,888969.980000001
"5499",2017-11-30 21:30:54,-888969.98,6.98491930961609e-10
"5500",2017-11-30 22:23:15,745209.08,745209.080000001
"5501",2017-11-30 22:23:15,689149.44,1434358.52
"5502",2017-11-30 22:29:09,-1434358.52,4.65661287307739e-10
"5503",2017-11-30 23:16:41,3158.07,3158.07000000047
"5504",2017-11-30 23:16:41,777859.06,781017.13
"5505",2017-11-30 23:16:41,517700.31,1298717.44
"5506",2017-11-30 23:24:41,-1298717.44,4.65661287307739e-10
"5507",2017-11-30 23:29:35,508170.06,508170.06
"5508",2017-11-30 23:42:12,-508170.06,4.65661287307739e-10
"5509",2017-12-01 02:44:07,582316.2,582316.2
"5510",2017-12-01 02:50:29,-582316.2,4.65661287307739e-10
"5511",2017-12-01 03:04:16,582828.22,582828.22
"5512",2017-12-01 03:46:32,-582828.22,4.65661287307739e-10
"5513",2017-12-01 04:27:06,598711.29,598711.290000001
"5514",2017-12-01 04:47:00,26081.25,624792.540000001
"5515",2017-12-01 04:47:00,-598711.29,26081.2500000005
"5516",2017-12-01 04:55:04,492325.55,518406.8
"5517",2017-12-01 04:57:43,-26081.25,492325.55
"5518",2017-12-01 05:10:46,-492325.55,4.65661287307739e-10
"5519",2017-12-01 08:48:48,593274.71,593274.71
"5520",2017-12-01 09:04:30,529676.94,1122951.65
"5521",2017-12-01 09:04:30,-593274.71,529676.94
"5522",2017-12-01 09:30:23,-529676.94,4.65661287307739e-10
"5523",2017-12-01 09:44:35,777859.21,777859.21
"5524",2017-12-01 09:44:35,237010.22,1014869.43
"5525",2017-12-01 09:52:52,-1014869.43,3.49245965480804e-10
"5526",2017-12-01 10:08:04,777859.24,777859.24
"5527",2017-12-01 10:08:04,324118.25,1101977.49
"5528",2017-12-01 10:18:31,-1101977.49,2.3283064365387e-10
"5529",2017-12-01 11:08:24,530885.3,530885.3
"5530",2017-12-01 11:16:56,-530885.3,2.3283064365387e-10
"5531",2017-12-01 12:23:29,777859.32,777859.32
"5532",2017-12-01 12:23:29,629837.33,1407696.65
"5533",2017-12-01 12:32:23,-1407696.65,2.3283064365387e-10
"5534",2017-12-01 12:33:05,777859.36,777859.36
"5535",2017-12-01 12:34:17,194083.37,971942.73
"5536",2017-12-01 12:50:24,-971942.73,2.3283064365387e-10
"5537",2017-12-02 00:32:47,777861.15,777861.15
"5538",2017-12-02 00:32:47,777861.17,1555722.32
"5539",2017-12-02 00:32:47,777861.16,2333583.48
"5540",2017-12-02 00:32:47,777861.14,3111444.62
"5541",2017-12-02 00:32:47,252653.18,3364097.8
"5542",2017-12-02 00:41:50,-3364097.8,9.31322574615479e-10
"5543",2017-12-02 00:43:17,888972.2,888972.200000001
"5544",2017-12-02 00:53:55,-888972.2,9.31322574615479e-10
"5545",2017-12-02 01:40:54,777861.28,777861.280000001
"5546",2017-12-02 01:40:54,167487.29,945348.570000001
"5547",2017-12-02 01:54:41,888972.31,1834320.88
"5548",2017-12-02 01:54:41,-945348.57,888972.310000001
"5549",2017-12-02 02:45:05,-888972.31,1.04773789644241e-09
"5550",2017-12-02 03:07:52,87126.36,87126.360000001
"5551",2017-12-02 03:07:52,777861.35,864987.710000001
"5552",2017-12-02 03:24:55,-864987.71,1.04773789644241e-09
"5553",2017-12-02 06:56:14,777861.38,777861.380000001
"5554",2017-12-02 07:12:02,138313.03,916174.410000001
"5555",2017-12-02 07:12:02,-777861.38,138313.030000001
"5556",2017-12-02 07:55:21,-138313.03,1.07684172689915e-09
"5557",2017-12-02 07:57:37,1493192.2,1493192.2
"5558",2017-12-02 08:25:32,-1493192.2,1.16415321826935e-09
"5559",2017-12-02 14:23:52,119319.49,119319.490000001
"5560",2017-12-02 14:23:52,777863.48,897182.970000001
"5561",2017-12-02 14:31:54,-897182.97,1.16415321826935e-09
"5562",2017-12-03 05:11:37,550584.88,550584.880000001
"5563",2017-12-03 05:38:08,777863.68,1328448.56
"5564",2017-12-03 05:38:08,661712,1990160.56
"5565",2017-12-03 05:38:08,51717.69,2041878.25
"5566",2017-12-03 05:38:08,53611.23,2095489.48
"5567",2017-12-03 05:38:08,-550584.88,1544904.6
"5568",2017-12-03 05:52:55,-1544904.6,9.31322574615479e-10
"5569",2017-12-03 06:48:05,741535.19,741535.190000001
"5570",2017-12-03 07:06:15,-741535.19,9.31322574615479e-10
"5571",2017-12-03 09:27:06,605839.4,605839.400000001
"5572",2017-12-03 09:37:51,-605839.4,9.31322574615479e-10
"5573",2017-12-03 11:22:51,397401.79,397401.790000001
"5574",2017-12-03 11:22:51,777863.78,1175265.57
"5575",2017-12-03 11:30:23,448032.84,1623298.41
"5576",2017-12-03 11:30:23,777863.83,2401162.24
"5577",2017-12-03 11:33:32,-1175265.57,1225896.67
"5578",2017-12-03 11:47:09,777863.88,2003760.55
"5579",2017-12-03 11:47:09,117207.89,2120968.44
"5580",2017-12-03 11:47:09,-1225896.67,895071.770000001
"5581",2017-12-03 12:04:15,777863.91,1672935.68
"5582",2017-12-03 12:04:15,777863.9,2450799.58
"5583",2017-12-03 12:04:15,509952.92,2960752.5
"5584",2017-12-03 12:04:15,-895071.77,2065680.73
"5585",2017-12-03 12:13:26,230670.99,2296351.72
"5586",2017-12-03 12:13:26,888975,3185326.72
"5587",2017-12-03 12:13:26,777863.98,3963190.7
"5588",2017-12-03 12:13:26,777863.97,4741054.67
"5589",2017-12-03 12:13:26,888975.01,5630029.68
"5590",2017-12-03 12:16:34,888975.02,6519004.7
"5591",2017-12-03 12:17:39,-5630029.68,888975.020000001
"5592",2017-12-03 12:27:58,-888975.02,1.39698386192322e-09
"5593",2017-12-04 20:54:20,493995.22,493995.220000001
"5594",2017-12-04 20:54:20,300087.44,794082.660000001
"5595",2017-12-04 21:00:51,772666.53,1566749.19
"5596",2017-12-04 21:19:34,-794082.66,772666.530000001
"5597",2017-12-04 21:40:54,-772666.53,1.28056854009628e-09
"5598",2017-12-04 23:20:53,485450.01,485450.010000001
"5599",2017-12-04 23:36:49,-485450.01,1.28056854009628e-09
"5600",2017-12-04 23:57:37,49315.72,49315.7200000013
"5601",2017-12-04 23:57:37,777864.71,827180.430000001
"5602",2017-12-05 00:29:40,-827180.43,1.16415321826935e-09
"5603",2017-12-06 02:16:01,308642.31,308642.310000001
"5604",2017-12-06 02:30:42,503239.23,811881.540000001
"5605",2017-12-06 02:30:42,-308642.31,503239.230000001
"5606",2017-12-06 02:46:26,536872.77,1040112
"5607",2017-12-06 02:46:26,-503239.23,536872.770000001
"5608",2017-12-06 03:24:02,-536872.77,1.16415321826935e-09
"5609",2017-12-06 06:13:53,79872.61,79872.6100000012
"5610",2017-12-06 06:13:53,777865.6,857738.210000001
"5611",2017-12-06 06:29:11,-857738.21,1.16415321826935e-09
"5612",2017-12-06 19:48:22,378500.22,378500.220000001
"5613",2017-12-06 19:58:50,-378500.22,1.16415321826935e-09
"5614",2017-12-06 20:20:20,465972.22,465972.220000001
"5615",2017-12-06 20:36:40,529917.68,995889.900000001
"5616",2017-12-06 20:36:40,-465972.22,529917.680000001
"5617",2017-12-06 20:44:04,-529917.68,1.16415321826935e-09
"5618",2017-12-06 23:44:26,681262.04,681262.040000001
"5619",2017-12-06 23:57:21,-681262.04,1.16415321826935e-09
"5620",2017-12-07 00:57:42,665715.33,665715.330000001
"5621",2017-12-07 01:03:08,-665715.33,1.16415321826935e-09
"5622",2017-12-07 04:28:57,587825.86,587825.860000001
"5623",2017-12-07 04:52:46,-587825.86,1.16415321826935e-09
"5624",2017-12-07 15:25:40,314163.26,314163.260000001
"5625",2017-12-07 15:34:59,-314163.26,1.16415321826935e-09
"5626",2017-12-08 00:31:58,3e+06,3e+06
"5627",2017-12-08 07:44:27,1999998,4999998
"5628",2017-12-08 17:39:13,-4999998,9.31322574615479e-10
"5629",2017-12-08 18:33:01,753905.59,753905.590000001
"5630",2017-12-08 18:33:01,499026.77,1252932.36
"5631",2017-12-08 18:54:17,-1252932.36,6.98491930961609e-10
"5632",2017-12-08 19:28:07,24450.24,24450.2400000007
"5633",2017-12-08 19:28:07,777866.23,802316.470000001
"5634",2017-12-08 20:21:24,-802316.47,6.98491930961609e-10
"5635",2017-12-08 21:46:31,734625.37,734625.370000001
"5636",2017-12-08 21:49:14,708864.84,1443490.21
"5637",2017-12-08 21:59:42,-734625.37,708864.840000001
"5638",2017-12-08 22:24:44,-708864.84,6.98491930961609e-10
"5639",2017-12-09 00:12:41,737085.49,737085.490000001
"5640",2017-12-09 00:23:56,-737085.49,6.98491930961609e-10
"5641",2017-12-09 00:32:37,543295.02,543295.020000001
"5642",2017-12-09 00:43:49,-543295.02,6.98491930961609e-10
"5643",2017-12-09 02:51:31,831433.02,831433.020000001
"5644",2017-12-09 03:01:11,679156.2,1510589.22
"5645",2017-12-09 03:01:11,-831433.02,679156.200000001
"5646",2017-12-09 03:06:46,519136.88,1198293.08
"5647",2017-12-09 03:18:39,596475.07,1794768.15
"5648",2017-12-09 03:18:39,-679156.2,1115611.95
"5649",2017-12-09 03:43:09,-1115611.95,4.65661287307739e-10
"5650",2017-12-09 10:09:54,888977.7,888977.7
"5651",2017-12-09 10:21:24,-888977.7,4.65661287307739e-10
"5652",2017-12-09 11:29:25,300084.61,300084.61
"5653",2017-12-09 11:29:25,300084.69,600169.300000001
"5654",2017-12-09 11:40:03,-600169.3,4.65661287307739e-10
"5655",2017-12-09 14:36:42,777866.76,777866.76
"5656",2017-12-09 14:36:42,54640.77,832507.53
"5657",2017-12-09 14:50:06,-832507.53,4.65661287307739e-10
"5658",2017-12-09 17:13:12,638930.85,638930.85
"5659",2017-12-09 17:13:12,777866.84,1416797.69
"5660",2017-12-09 17:27:40,-1416797.69,4.65661287307739e-10
"5661",2017-12-09 17:32:17,777866.9,777866.9
"5662",2017-12-09 17:32:17,169612.91,947479.810000001
"5663",2017-12-09 17:54:21,724162.38,1671642.19
"5664",2017-12-09 17:54:21,-947479.81,724162.38
"5665",2017-12-09 18:05:48,682313.96,1406476.34
"5666",2017-12-09 18:05:48,777866.95,2184343.29
"5667",2017-12-09 18:05:48,-724162.38,1460180.91
"5668",2017-12-09 18:19:21,123775.98,1583956.89
"5669",2017-12-09 18:19:21,777866.97,2361823.86
"5670",2017-12-09 18:19:21,-1460180.91,901642.95
"5671",2017-12-09 18:29:23,-901642.95,4.65661287307739e-10
"5672",2017-12-09 19:23:59,720871.21,720871.21
"5673",2017-12-09 19:45:47,687949.05,1408820.26
"5674",2017-12-09 19:45:47,-720871.21,687949.050000001
"5675",2017-12-09 19:56:13,-687949.05,4.65661287307739e-10
"5676",2017-12-09 22:54:15,587735.61,587735.61
"5677",2017-12-09 23:01:34,-587735.61,4.65661287307739e-10
"5678",2017-12-10 00:57:09,573036.89,573036.89
"5679",2017-12-10 01:23:57,-573036.89,4.65661287307739e-10
"5680",2017-12-10 01:41:58,461205.29,461205.29
"5681",2017-12-10 01:48:33,-461205.29,4.65661287307739e-10
"5682",2017-12-10 01:59:09,777867.18,777867.180000001
"5683",2017-12-10 01:59:09,52482.19,830349.370000001
"5684",2017-12-10 02:16:31,776890.37,1607239.74
"5685",2017-12-10 02:16:31,-830349.37,776890.370000001
"5686",2017-12-10 02:36:28,534967.36,1311857.73
"5687",2017-12-10 02:36:28,-776890.37,534967.360000001
"5688",2017-12-10 02:55:00,-534967.36,6.98491930961609e-10
"5689",2017-12-10 03:58:10,378984.71,378984.710000001
"5690",2017-12-10 04:10:53,-378984.71,6.98491930961609e-10
"5691",2017-12-10 04:49:07,132622.74,132622.740000001
"5692",2017-12-10 04:49:07,167048.79,299671.530000001
"5693",2017-12-10 04:49:07,223735.84,523407.370000001
"5694",2017-12-10 04:49:07,226490.49,749897.860000001
"5695",2017-12-10 05:14:33,-749897.86,6.98491930961609e-10
"5696",2017-12-10 05:32:33,1580238.2,1580238.2
"5697",2017-12-10 05:46:31,-1580238.2,6.98491930961609e-10
"5698",2017-12-10 06:23:19,767045.86,767045.860000001
"5699",2017-12-10 06:34:21,-767045.86,6.98491930961609e-10
"5700",2017-12-10 09:30:27,595589.06,595589.060000001
"5701",2017-12-10 09:40:00,-595589.06,6.98491930961609e-10
"5702",2017-12-10 09:58:36,28209.67,28209.6700000007
"5703",2017-12-10 10:12:21,-28209.67,6.98491930961609e-10
"5704",2017-12-10 10:51:03,618310.58,618310.580000001
"5705",2017-12-10 11:07:01,-618310.58,6.98491930961609e-10
"5706",2017-12-10 14:13:49,84482.72,84482.7200000007
"5707",2017-12-10 14:33:48,15306.57,99789.2900000007
"5708",2017-12-10 14:33:48,777867.56,877656.850000001
"5709",2017-12-10 14:33:48,-84482.72,793174.130000001
"5710",2017-12-10 14:42:24,530646.34,1323820.47
"5711",2017-12-10 14:42:24,-793174.13,530646.340000001
"5712",2017-12-10 14:59:36,499418.62,1030064.96
"5713",2017-12-10 14:59:36,777867.61,1807932.57
"5714",2017-12-10 14:59:36,-530646.34,1277286.23
"5715",2017-12-10 15:15:51,-1277286.23,9.31322574615479e-10
"5716",2017-12-10 15:18:48,777867.64,777867.640000001
"5717",2017-12-10 15:21:55,182909.65,960777.290000001
"5718",2017-12-10 15:53:21,193478.7,1154255.99
"5719",2017-12-10 15:53:21,-960777.29,193478.700000001
"5720",2017-12-10 16:07:50,777867.69,971346.390000001
"5721",2017-12-10 16:07:50,-193478.7,777867.690000001
"5722",2017-12-10 16:21:03,-777867.69,9.31322574615479e-10
"5723",2017-12-10 19:11:26,693776.86,693776.860000001
"5724",2017-12-10 19:27:08,-693776.86,9.31322574615479e-10
"5725",2017-12-11 09:58:58,777868.24,777868.240000001
"5726",2017-12-11 09:58:58,777868.25,1555736.49
"5727",2017-12-11 09:58:58,777868.26,2333604.75
"5728",2017-12-11 10:04:15,504255.27,2837860.02
"5729",2017-12-11 10:14:55,-2333604.75,504255.270000001
"5730",2017-12-11 10:56:10,-504255.27,9.31322574615479e-10
"5731",2017-12-11 11:02:32,32605.84,32605.8400000009
"5732",2017-12-11 11:38:24,-32605.84,9.31322574615479e-10
"5733",2017-12-11 16:04:31,688240.14,688240.140000001
"5734",2017-12-11 16:12:59,777868.42,1466108.56
"5735",2017-12-11 16:12:59,414827.43,1880935.99
"5736",2017-12-11 16:12:59,-688240.14,1192695.85
"5737",2017-12-11 16:25:29,-1192695.85,9.31322574615479e-10
"5738",2017-12-11 20:43:00,27704.31,27704.3100000009
"5739",2017-12-11 20:43:00,580655.62,608359.930000001
"5740",2017-12-11 20:43:00,121529.07,729889.000000001
"5741",2017-12-11 20:56:00,-729889,9.31322574615479e-10
"5742",2017-12-11 21:11:24,461068.68,461068.680000001
"5743",2017-12-11 21:27:03,-461068.68,9.31322574615479e-10
"5744",2017-12-11 23:57:47,3183.35,3183.35000000093
"5745",2017-12-12 00:17:53,-3183.35,9.31322574615479e-10
"5746",2017-12-12 03:35:06,860.33,860.330000000931
"5747",2017-12-12 04:00:41,-860.33,9.31322574615479e-10
"5748",2017-12-12 06:45:47,19460.56,19460.5600000009
"5749",2017-12-12 07:12:12,-19460.56,9.31322574615479e-10
"5750",2017-12-12 15:43:57,26988.64,26988.6400000009
"5751",2017-12-12 15:43:57,18699.39,45688.0300000009
"5752",2017-12-12 16:30:15,12355.44,58043.4700000009
"5753",2017-12-12 17:24:29,-45688.03,12355.4400000009
"5754",2017-12-12 17:26:56,11968.26,24323.7000000009
"5755",2017-12-12 17:26:56,5118.98,29442.6800000009
"5756",2017-12-12 18:17:55,-29442.68,9.3496055342257e-10
"5757",2017-12-12 19:06:09,841.71,841.710000000935
"5758",2017-12-12 20:00:43,-841.71,9.3496055342257e-10
"5759",2017-12-12 21:44:37,14469.83,14469.8300000009
"5760",2017-12-12 22:01:24,-14469.83,9.3496055342257e-10
"5761",2017-12-13 01:45:36,1777869.78,1777869.78
"5762",2017-12-13 02:18:14,777869.82,2555739.6
"5763",2017-12-13 02:18:14,-1777869.78,777869.820000001
"5764",2017-12-13 03:12:42,-777869.82,1.04773789644241e-09
"5765",2017-12-13 07:58:35,16397.56,16397.560000001
"5766",2017-12-13 18:01:54,888983.78,905381.340000001
"5767",2017-12-13 18:12:26,-16397.56,888983.780000001
"5768",2017-12-13 18:45:09,-888983.78,1.04773789644241e-09
"5769",2017-12-13 19:15:38,60842.74,60842.740000001
"5770",2017-12-13 19:46:53,-60842.74,1.04773789644241e-09
"5771",2017-12-13 20:21:26,8492.73,8492.73000000105
"5772",2017-12-13 20:50:48,-8492.73,1.04773789644241e-09
"5773",2017-12-13 20:50:48,1236.17,1236.17000000105
"5774",2017-12-13 21:01:02,-1236.17,1.04773789644241e-09
"5775",2017-12-13 21:22:41,7535.99,7535.99000000105
"5776",2017-12-13 21:25:39,888983.79,896519.780000001
"5777",2017-12-13 21:25:39,888983.8,1785503.58
"5778",2017-12-13 21:32:24,777872.82,2563376.4
"5779",2017-12-13 21:37:19,-1785503.58,777872.820000001
"5780",2017-12-13 22:02:22,-777872.82,8.14907252788544e-10
"5781",2017-12-13 22:02:22,43639.69,43639.6900000008
"5782",2017-12-13 22:12:55,888984.39,932624.080000001
"5783",2017-12-13 22:12:55,888984.35,1821608.43
"5784",2017-12-13 22:12:55,777873.34,2599481.77
"5785",2017-12-13 22:24:26,888984.37,3488466.14
"5786",2017-12-13 22:24:26,-2599481.77,888984.370000001
"5787",2017-12-13 22:34:57,-888984.37,5.82076609134674e-10
"5788",2017-12-13 23:55:16,88984.88,88984.8800000006
"5789",2017-12-14 00:09:55,-88984.88,5.82076609134674e-10
"5790",2017-12-14 00:31:34,39384.97,39384.9700000006
"5791",2017-12-14 00:48:08,88985.17,128370.140000001
"5792",2017-12-14 00:48:08,-39384.97,88985.1700000006
"5793",2017-12-14 00:48:08,10038.16,99023.3300000006
"5794",2017-12-14 00:48:08,4491.1,103514.430000001
"5795",2017-12-14 01:07:29,-103514.43,5.96628524363041e-10
"5796",2017-12-14 02:54:54,1349.26,1349.2600000006
"5797",2017-12-14 03:25:17,-1349.26,5.96628524363041e-10
"5798",2017-12-14 10:28:24,653.71,653.710000000597
"5799",2017-12-14 10:36:43,11710.02,12363.7300000006
"5800",2017-12-14 10:36:43,403.93,12767.6600000006
"5801",2017-12-14 10:55:27,777873.46,790641.120000001
"5802",2017-12-14 10:55:27,888986.7,1679627.82
"5803",2017-12-14 10:55:27,777873.45,2457501.27
"5804",2017-12-14 10:55:27,639141.47,3096642.74
"5805",2017-12-14 11:14:20,888986.72,3985629.46
"5806",2017-12-14 11:14:20,888986.76,4874616.22
"5807",2017-12-14 11:14:20,888986.74,5763602.96
"5808",2017-12-14 12:10:21,777875.8,6541478.76
"5809",2017-12-14 12:10:21,406790.82,6948269.58
"5810",2017-12-14 12:10:21,777875.81,7726145.39
"5811",2017-12-14 12:17:17,-12767.66,7713377.73
"5812",2017-12-14 12:44:01,-7713377.73,0
"5813",2017-12-14 13:15:22,408320.62,408320.62
"5814",2017-12-14 13:17:57,777875.89,1186196.51
"5815",2017-12-14 13:21:11,521377.9,1707574.41
"5816",2017-12-14 13:42:08,888986.94,2596561.35
"5817",2017-12-14 13:42:08,888986.93,3485548.28
"5818",2017-12-14 13:48:33,-1186196.51,2299351.77
"5819",2017-12-14 14:39:49,-2299351.77,4.65661287307739e-10
"5820",2017-12-14 16:07:16,777875.98,777875.98
"5821",2017-12-14 18:20:58,888987.09,1666863.07
"5822",2017-12-14 18:24:58,888987.12,2555850.19
"5823",2017-12-14 18:43:11,777876.13,3333726.32
"5824",2017-12-14 18:43:11,-777875.98,2555850.34
"5825",2017-12-14 18:46:20,114579.14,2670429.48
"5826",2017-12-14 19:15:04,34550.24,2704979.72
"5827",2017-12-14 19:15:04,777876.23,3482855.95
"5828",2017-12-14 19:15:04,222093.21,3704949.16
"5829",2017-12-14 19:15:04,777876.2,4482825.36
"5830",2017-12-14 19:18:05,777876.25,5260701.61
"5831",2017-12-14 19:18:05,-2670429.48,2590272.13
"5832",2017-12-14 19:48:32,777876.27,3368148.4
"5833",2017-12-14 19:48:32,303088.28,3671236.68
"5834",2017-12-14 19:48:32,-2590272.13,1080964.55
"5835",2017-12-14 19:59:00,-1080964.55,6.98491930961609e-10
"5836",2017-12-14 21:57:41,777876.37,777876.370000001
"5837",2017-12-14 22:26:39,777876.35,1555752.72
"5838",2017-12-14 22:26:39,777876.39,2333629.11
"5839",2017-12-14 22:26:39,777876.36,3111505.47
"5840",2017-12-14 22:26:39,640182.38,3751687.85
"5841",2017-12-14 22:26:39,-777876.37,2973811.48
"5842",2017-12-14 22:47:29,300099.43,3273910.91
"5843",2017-12-14 22:50:08,-2973811.48,300099.430000001
"5844",2017-12-14 23:00:44,-300099.43,6.40284270048141e-10
"5845",2017-12-14 23:30:07,32817,32817.0000000006
"5846",2017-12-15 00:01:45,-32817,6.40284270048141e-10
"5847",2017-12-15 00:21:52,590496.65,590496.650000001
"5848",2017-12-15 00:21:52,777876.64,1368373.29
"5849",2017-12-15 00:29:23,593122.57,1961495.86
"5850",2017-12-15 00:50:30,389769.7,2351265.56
"5851",2017-12-15 00:50:30,777876.69,3129142.25
"5852",2017-12-15 00:50:30,-1961495.86,1167646.39
"5853",2017-12-15 00:50:53,1072773.64,2240420.03
"5854",2017-12-15 01:33:55,-2240420.03,4.65661287307739e-10
"5855",2017-12-15 03:39:43,1169344.07,1169344.07
"5856",2017-12-15 04:11:11,388481.79,1557825.86
"5857",2017-12-15 04:11:11,777876.78,2335702.64
"5858",2017-12-15 04:44:22,209789.81,2545492.45
"5859",2017-12-15 04:44:22,777876.8,3323369.25
"5860",2017-12-15 04:57:24,777876.83,4101246.08
"5861",2017-12-15 04:57:24,271231.84,4372477.92
"5862",2017-12-15 04:57:24,-2335702.64,2036775.28
"5863",2017-12-15 05:37:20,-2036775.28,6.98491930961609e-10
"5864",2017-12-15 06:04:55,51727.54,51727.5400000007
"5865",2017-12-15 06:49:32,-51727.54,6.98491930961609e-10
"5866",2017-12-15 06:53:44,88940.24,88940.2400000007
"5867",2017-12-15 07:27:57,-88940.24,6.98491930961609e-10
"5868",2017-12-15 08:21:51,77831.06,77831.0600000007
"5869",2017-12-15 09:05:09,-77831.06,6.98491930961609e-10
"5870",2017-12-15 10:40:27,410843.99,410843.990000001
"5871",2017-12-15 10:40:27,777876.98,1188720.97
"5872",2017-12-15 11:06:22,372866.03,1561587
"5873",2017-12-15 11:06:22,777877,2339464
"5874",2017-12-15 11:06:22,777877.01,3117341.01
"5875",2017-12-15 11:06:22,777877.02,3895218.03
"5876",2017-12-15 11:30:44,777877.06,4673095.09
"5877",2017-12-15 11:30:44,777037.07,5450132.16
"5878",2017-12-15 11:50:53,320013.1,5770145.26
"5879",2017-12-15 11:50:53,777877.09,6548022.35
"5880",2017-12-15 12:18:46,777877.13,7325899.48
"5881",2017-12-15 12:18:46,777877.12,8103776.6
"5882",2017-12-15 12:21:09,356681.14,8460457.74
"5883",2017-12-15 12:33:54,777877.17,9238334.91
"5884",2017-12-15 12:33:54,277035.18,9515370.09
"5885",2017-12-15 12:43:03,777877.19,10293247.28
"5886",2017-12-15 12:43:03,297251.2,10590498.48
"5887",2017-12-15 13:04:52,777877.23,11368375.71
"5888",2017-12-15 13:04:52,301291.25,11669666.96
"5889",2017-12-15 13:04:52,777877.24,12447544.2
"5890",2017-12-15 13:18:16,777877.28,13225421.48
"5891",2017-12-15 13:31:52,617250.29,13842671.77
"5892",2017-12-15 13:39:30,777877.31,14620549.08
"5893",2017-12-15 13:39:30,91069.48,14711618.56
"5894",2017-12-15 14:03:01,777877.36,15489495.92
"5895",2017-12-15 14:03:01,777877.37,16267373.29
"5896",2017-12-15 14:03:01,61856.38,16329229.67
"5897",2017-12-15 14:25:09,507847.77,16837077.44
"5898",2017-12-15 14:25:09,27849.86,16864927.3
"5899",2017-12-15 17:52:06,-16864927.3,0
"5900",2017-12-16 12:51:05,888994.74,888994.74
"5901",2017-12-16 12:51:05,888994.69,1777989.43
"5902",2017-12-16 12:51:05,888994.72,2666984.15
"5903",2017-12-16 12:51:05,888994.75,3555978.9
"5904",2017-12-16 12:51:05,888994.71,4444973.61
"5905",2017-12-16 12:51:05,888994.73,5333968.34
"5906",2017-12-16 12:51:05,888994.7,6222963.04
"5907",2017-12-16 13:02:17,-6222963.04,0
"5908",2017-12-17 00:47:33,888994.94,888994.94
"5909",2017-12-17 00:47:33,888994.95,1777989.89
"5910",2017-12-17 00:47:33,888994.97,2666984.86
"5911",2017-12-17 01:19:20,-2666984.86,0
"5912",2017-12-17 04:15:50,777883.98,777883.98
"5913",2017-12-17 04:15:50,888995,1666878.98
"5914",2017-12-17 04:22:10,777884.08,2444763.06
"5915",2017-12-17 04:22:10,777884.02,3222647.08
"5916",2017-12-17 04:22:10,777884.06,4000531.14
"5917",2017-12-17 04:22:10,888995.01,4889526.15
"5918",2017-12-17 04:22:10,777884.04,5667410.19
"5919",2017-12-17 04:22:10,777884.03,6445294.22
"5920",2017-12-17 04:22:10,777884.05,7223178.27
"5921",2017-12-17 04:22:10,327423.07,7550601.34
"5922",2017-12-17 04:23:05,777883.99,8328485.33
"5923",2017-12-17 04:44:11,-8328485.33,9.31322574615479e-10
"5924",2017-12-17 07:20:54,290275.12,290275.120000001
"5925",2017-12-17 07:20:54,777884.11,1068159.23
"5926",2017-12-17 07:32:31,777884.16,1846043.39
"5927",2017-12-17 07:32:31,250997.17,2097040.56
"5928",2017-12-17 07:32:31,777884.15,2874924.71
"5929",2017-12-17 07:46:46,-1068159.23,1806765.48
"5930",2017-12-17 07:57:28,1332909.9,3139675.38
"5931",2017-12-17 08:13:17,-1806765.48,1332909.9
"5932",2017-12-17 08:31:56,-1332909.9,9.31322574615479e-10
"5933",2017-12-17 10:06:01,777884.23,777884.230000001
"5934",2017-12-17 10:06:01,456041.24,1233925.47
"5935",2017-12-17 10:30:02,777884.25,2011809.72
"5936",2017-12-17 10:30:02,502324.26,2514133.98
"5937",2017-12-17 10:30:02,-1233925.47,1280208.51
"5938",2017-12-17 11:10:31,-1280208.51,9.31322574615479e-10
"5939",2017-12-17 14:57:54,755832.38,755832.380000001
"5940",2017-12-17 14:57:54,777884.37,1533716.75
"5941",2017-12-17 15:25:24,-1533716.75,9.31322574615479e-10
"5942",2017-12-17 15:38:22,777884.41,777884.410000001
"5943",2017-12-17 15:38:22,777884.4,1555768.81
"5944",2017-12-17 15:38:22,73775.42,1629544.23
"5945",2017-12-17 15:38:22,777884.39,2407428.62
"5946",2017-12-17 16:03:56,777884.45,3185313.07
"5947",2017-12-17 16:21:28,777884.44,3963197.51
"5948",2017-12-17 16:21:28,209363.46,4172560.97
"5949",2017-12-17 16:21:28,-2407428.62,1765132.35
"5950",2017-12-17 16:38:40,-1765132.35,9.31322574615479e-10
"5951",2017-12-17 20:16:51,445418.54,445418.540000001
"5952",2017-12-17 20:16:51,777884.53,1223303.07
"5953",2017-12-17 20:26:51,-1223303.07,9.31322574615479e-10
"5954",2017-12-17 20:26:51,63345.19,63345.1900000009
"5955",2017-12-17 20:58:14,-63345.19,9.31322574615479e-10
"5956",2017-12-17 23:42:24,777884.58,777884.580000001
"5957",2017-12-17 23:42:24,252356.6,1030241.18
"5958",2017-12-17 23:42:24,777884.59,1808125.77
"5959",2017-12-18 00:09:49,-1808125.77,9.31322574615479e-10
"5960",2017-12-18 02:15:34,48904.16,48904.1600000009
"5961",2017-12-18 02:22:08,-48904.16,9.31322574615479e-10
"5962",2017-12-18 03:40:26,117247.93,117247.930000001
"5963",2017-12-18 03:40:26,31237.7,148485.630000001
"5964",2017-12-18 03:40:26,118612.15,267097.780000001
"5965",2017-12-18 03:40:26,19494.1,286591.880000001
"5966",2017-12-18 04:34:15,-286591.88,9.31322574615479e-10
"5967",2017-12-18 04:40:38,7736.01,7736.01000000093
"5968",2017-12-18 05:10:06,-7736.01,9.31322574615479e-10
"5969",2017-12-18 05:49:17,777884.68,777884.680000001
"5970",2017-12-18 05:49:17,777884.69,1555769.37
"5971",2017-12-18 06:09:28,-1555769.37,9.31322574615479e-10
"5972",2017-12-18 06:09:28,1418598.26,1418598.26
"5973",2017-12-18 06:42:11,-1418598.26,9.31322574615479e-10
"5974",2017-12-18 07:13:59,888995.71,888995.710000001
"5975",2017-12-18 07:13:59,888995.72,1777991.43
"5976",2017-12-18 07:29:48,540337.08,2318328.51
"5977",2017-12-18 07:49:36,-2318328.51,9.31322574615479e-10
"5978",2017-12-18 13:38:32,532591.24,532591.240000001
"5979",2017-12-18 13:38:32,777885.23,1310476.47
"5980",2017-12-18 14:09:01,-1310476.47,9.31322574615479e-10
"5981",2017-12-18 18:32:31,777885.42,777885.420000001
"5982",2017-12-18 18:32:31,119611.43,897496.850000001
"5983",2017-12-18 19:05:31,61236.48,958733.330000001
"5984",2017-12-18 19:05:31,777885.47,1736618.8
"5985",2017-12-18 19:33:56,-1736618.8,9.31322574615479e-10
"5986",2017-12-19 04:40:18,777888.23,777888.230000001
"5987",2017-12-19 04:40:18,3716.24,781604.470000001
"5988",2017-12-19 05:25:13,-781604.47,9.31322574615479e-10
"5989",2017-12-19 08:28:51,401349.34,401349.340000001
"5990",2017-12-19 08:28:51,777888.33,1179237.67
"5991",2017-12-19 09:33:54,-1179237.67,9.31322574615479e-10
"5992",2017-12-19 14:07:16,678331.71,678331.710000001
"5993",2017-12-19 14:13:18,777888.69,1456220.4
"5994",2017-12-19 14:13:18,777888.71,2234109.11
"5995",2017-12-19 14:30:59,308205.72,2542314.83
"5996",2017-12-19 15:01:39,-2234109.11,308205.720000001
"5997",2017-12-19 15:51:12,-308205.72,1.16415321826935e-09
"5998",2017-12-19 17:13:29,777888.83,777888.830000001
"5999",2017-12-19 19:17:00,-777888.83,1.16415321826935e-09
"6000",2017-12-19 22:38:34,777888.92,777888.920000001
"6001",2017-12-19 22:38:34,777888.7,1555777.62
"6002",2017-12-19 23:05:18,-1555777.62,9.31322574615479e-10
"6003",2017-12-19 23:35:35,888999.94,888999.940000001
"6004",2017-12-20 00:10:19,-888999.94,9.31322574615479e-10
"6005",2017-12-20 05:05:35,777888.96,777888.960000001
"6006",2017-12-20 05:05:35,234744.98,1012633.94
"6007",2017-12-20 05:05:35,777888.97,1790522.91
"6008",2017-12-20 05:08:24,595832.53,2386355.44
"6009",2017-12-20 05:35:32,-2386355.44,9.31322574615479e-10
"6010",2017-12-20 09:14:21,563335.23,563335.230000001
"6011",2017-12-20 09:47:39,-563335.23,9.31322574615479e-10
"6012",2017-12-20 15:52:07,300112.33,300112.330000001
"6013",2017-12-20 16:24:58,-300112.33,9.31322574615479e-10
"6014",2017-12-20 18:39:41,888992.53,888992.530000001
"6015",2017-12-20 18:51:11,-888992.53,9.31322574615479e-10
"6016",2017-12-20 22:41:13,300112.69,300112.690000001
"6017",2017-12-20 23:36:01,-300112.69,9.31322574615479e-10
"6018",2017-12-21 06:00:54,720180.64,720180.640000001
"6019",2017-12-21 06:31:32,-720180.64,9.31322574615479e-10
"6020",2017-12-21 10:12:26,117486.89,117486.890000001
"6021",2017-12-21 10:12:26,120424.84,237911.730000001
"6022",2017-12-21 10:12:26,207705.86,445617.590000001
"6023",2017-12-21 10:12:26,146714.26,592331.850000001
"6024",2017-12-21 10:12:26,85821.55,678153.400000001
"6025",2017-12-21 10:12:26,70569.12,748722.520000001
"6026",2017-12-21 10:12:26,101496.07,850218.590000001
"6027",2017-12-21 10:59:51,-850218.59,1.04773789644241e-09
"6028",2017-12-22 00:09:57,286953.71,286953.710000001
"6029",2017-12-22 00:09:57,777890.7,1064844.41
"6030",2017-12-22 00:44:33,-1064844.41,1.16415321826935e-09
"6031",2017-12-22 01:53:51,189130.56,189130.560000001
"6032",2017-12-22 01:53:51,168578.49,357709.050000001
"6033",2017-12-22 01:53:51,238287.14,595996.190000001
"6034",2017-12-22 02:44:41,-595996.19,1.16415321826935e-09
"6035",2017-12-22 07:19:43,100114.41,100114.410000001
"6036",2017-12-22 07:48:20,-100114.41,1.16415321826935e-09
"6037",2017-12-22 10:20:06,300114.69,300114.690000001
"6038",2017-12-22 11:31:16,-300114.69,1.16415321826935e-09
"6039",2017-12-22 14:16:46,777891.85,777891.850000001
"6040",2017-12-22 15:17:02,-777891.85,1.16415321826935e-09
"6041",2017-12-22 16:05:22,777891.93,777891.930000001
"6042",2017-12-23 01:07:28,246606.65,1024498.58
"6043",2017-12-23 01:53:46,-1024498.58,1.28056854009628e-09
"6044",2017-12-23 02:31:41,369857.52,369857.520000001
"6045",2017-12-23 02:31:41,184461.36,554318.880000001
"6046",2017-12-23 02:39:51,-554318.88,1.28056854009628e-09
"6047",2017-12-23 10:03:47,984449.08,984449.080000001
"6048",2017-12-23 10:38:46,286117.95,1270567.03
"6049",2017-12-23 10:38:46,390827.28,1661394.31
"6050",2017-12-23 11:05:59,-984449.08,676945.230000001
"6051",2017-12-23 11:12:43,344804.82,1021750.05
"6052",2017-12-23 12:17:24,-1021750.05,1.16415321826935e-09
"6053",2017-12-23 12:58:51,341144.26,341144.260000001
"6054",2017-12-23 12:58:51,233462.28,574606.540000001
"6055",2017-12-23 13:05:48,-574606.54,1.16415321826935e-09
"6056",2017-12-23 13:05:48,79654.78,79654.7800000012
"6057",2017-12-23 13:07:44,252343.63,331998.410000001
"6058",2017-12-23 13:39:07,-79654.78,252343.630000001
"6059",2017-12-23 13:53:45,-252343.63,1.19325704872608e-09
"6060",2017-12-23 13:53:45,255450.84,255450.840000001
"6061",2017-12-23 14:57:54,-255450.84,1.19325704872608e-09
"6062",2017-12-23 16:25:00,262309.76,262309.760000001
"6063",2017-12-23 16:42:29,-262309.76,1.16415321826935e-09
"6064",2017-12-23 18:30:17,420610.63,420610.630000001
"6065",2017-12-23 18:30:17,360146.85,780757.480000001
"6066",2017-12-23 18:30:17,37400.51,818157.990000001
"6067",2017-12-23 18:54:55,-818157.99,1.16415321826935e-09
"6068",2017-12-23 19:35:00,351842.74,351842.740000001
"6069",2017-12-23 19:51:43,-351842.74,1.16415321826935e-09
"6070",2017-12-23 20:25:03,340614.72,340614.720000001
"6071",2017-12-23 20:46:11,-340614.72,1.16415321826935e-09
"6072",2017-12-23 22:37:48,151369.91,151369.910000001
"6073",2017-12-23 22:37:48,237127.8,388497.710000001
"6074",2017-12-23 22:37:48,204484.13,592981.840000001
"6075",2017-12-23 22:55:10,-592981.84,1.16415321826935e-09
"6076",2017-12-23 22:55:10,454894.32,454894.320000001
"6077",2017-12-23 23:15:00,-454894.32,1.16415321826935e-09
"6078",2017-12-23 23:15:00,396390.14,396390.140000001
"6079",2017-12-23 23:15:00,712044.32,1108434.46
"6080",2017-12-23 23:21:37,-1108434.46,1.16415321826935e-09
"6081",2017-12-23 23:50:33,509419.31,509419.310000001
"6082",2017-12-23 23:50:33,777893.55,1287312.86
"6083",2017-12-23 23:50:33,196375.56,1483688.42
"6084",2017-12-23 23:50:33,593396.72,2077085.14
"6085",2017-12-24 00:00:11,-2077085.14,1.39698386192322e-09
"6086",2017-12-24 00:55:43,777893.6,777893.600000001
"6087",2017-12-24 00:55:43,777893.59,1555787.19
"6088",2017-12-24 00:55:43,526968.61,2082755.8
"6089",2017-12-24 00:59:01,-2082755.8,1.16415321826935e-09
"6090",2017-12-24 01:17:07,777893.69,777893.690000001
"6091",2017-12-24 01:17:07,352371.71,1130265.4
"6092",2017-12-24 01:17:07,777893.7,1908159.1
"6093",2017-12-24 01:20:11,-1908159.1,9.31322574615479e-10
"6094",2017-12-24 01:56:08,777893.75,777893.750000001
"6095",2017-12-24 01:56:08,159932.76,937826.510000001
"6096",2017-12-24 01:56:08,777893.74,1715720.25
"6097",2017-12-24 02:00:32,-1715720.25,9.31322574615479e-10
"6098",2017-12-24 02:32:40,165595.83,165595.830000001
"6099",2017-12-24 02:32:40,777893.78,943489.610000001
"6100",2017-12-24 02:32:40,501387.79,1444877.4
"6101",2017-12-24 02:32:40,777893.82,2222771.22
"6102",2017-12-24 02:47:31,-2222771.22,4.65661287307739e-10
"6103",2017-12-24 03:05:30,777893.88,777893.88
"6104",2017-12-24 03:05:30,777893.89,1555787.77
"6105",2017-12-24 03:05:30,665498.9,2221286.67
"6106",2017-12-24 03:29:38,-2221286.67,4.65661287307739e-10
"6107",2017-12-24 03:45:03,777893.95,777893.95
"6108",2017-12-24 03:45:03,622283.96,1400177.91
"6109",2017-12-24 03:49:01,-1400177.91,4.65661287307739e-10
"6110",2017-12-24 07:18:56,570201,570201
"6111",2017-12-24 07:18:56,550869.41,1121070.41
"6112",2017-12-24 07:23:51,-1121070.41,6.98491930961609e-10
"6113",2017-12-24 07:36:31,22160.95,22160.9500000007
"6114",2017-12-24 07:36:31,94574.94,116735.890000001
"6115",2017-12-24 07:43:44,-116735.89,6.98491930961609e-10
"6116",2017-12-24 08:20:54,496377.36,496377.360000001
"6117",2017-12-24 08:20:54,831990.45,1328367.81
"6118",2017-12-24 08:28:39,-1328367.81,4.65661287307739e-10
"6119",2017-12-24 08:49:06,494247.17,494247.17
"6120",2017-12-24 08:49:06,625269.14,1119516.31
"6121",2017-12-24 09:00:49,-1119516.31,4.65661287307739e-10
"6122",2017-12-24 09:19:18,412786.71,412786.71
"6123",2017-12-24 09:20:00,667683.13,1080469.84
"6124",2017-12-24 09:27:26,-1080469.84,4.65661287307739e-10
"6125",2017-12-24 09:27:26,385048.96,385048.96
"6126",2017-12-24 09:42:29,-385048.96,4.65661287307739e-10
"6127",2017-12-24 10:35:11,282857.28,282857.28
"6128",2017-12-24 10:35:11,466296.75,749154.03
"6129",2017-12-24 10:35:11,20690.66,769844.690000001
"6130",2017-12-24 10:53:47,300112.33,1069957.02
"6131",2017-12-24 10:53:47,-769844.69,300112.330000001
"6132",2017-12-24 10:53:47,77894.34,378006.670000001
"6133",2017-12-24 11:08:49,-378006.67,5.23868948221207e-10
"6134",2017-12-24 11:33:57,77894.36,77894.3600000005
"6135",2017-12-24 11:41:53,-77894.36,5.23868948221207e-10
"6136",2017-12-24 11:41:53,89005.44,89005.4400000005
"6137",2017-12-24 12:04:43,-89005.44,5.23868948221207e-10
"6138",2017-12-24 12:04:43,300117.49,300117.490000001
"6139",2017-12-24 12:04:43,89005.47,389122.960000001
"6140",2017-12-24 12:04:43,300117.46,689240.420000001
"6141",2017-12-24 12:18:27,-689240.42,5.82076609134674e-10
"6142",2017-12-24 12:18:27,300117.54,300117.540000001
"6143",2017-12-24 12:18:27,300117.51,600235.050000001
"6144",2017-12-24 12:42:36,-600235.05,4.65661287307739e-10
"6145",2017-12-24 13:32:49,225840.14,225840.14
"6146",2017-12-24 13:43:45,-225840.14,4.65661287307739e-10
"6147",2017-12-24 14:02:45,343229.98,343229.98
"6148",2017-12-24 14:13:42,-343229.98,4.65661287307739e-10
"6149",2017-12-24 14:47:20,253049.03,253049.03
"6150",2017-12-24 14:47:20,379356.04,632405.07
"6151",2017-12-24 14:47:20,284278.64,916683.71
"6152",2017-12-24 14:55:07,-916683.71,4.65661287307739e-10
"6153",2017-12-24 15:17:26,76623.66,76623.6600000005
"6154",2017-12-24 15:29:42,-76623.66,4.65661287307739e-10
"6155",2017-12-24 15:29:42,270165.68,270165.68
"6156",2017-12-24 15:29:42,248278.89,518444.57
"6157",2017-12-24 15:36:31,-518444.57,4.65661287307739e-10
"6158",2017-12-24 15:42:55,352220.75,352220.75
"6159",2017-12-24 15:55:17,-352220.75,4.65661287307739e-10
"6160",2017-12-24 16:05:17,276040.89,276040.89
"6161",2017-12-24 16:07:09,298013.39,574054.28
"6162",2017-12-24 16:09:56,-276040.89,298013.39
"6163",2017-12-24 16:33:25,-298013.39,4.65661287307739e-10
"6164",2017-12-24 16:33:25,281217.03,281217.03
"6165",2017-12-24 16:33:25,308571.27,589788.300000001
"6166",2017-12-24 16:43:40,-589788.3,4.65661287307739e-10
"6167",2017-12-24 17:08:48,177895.06,177895.06
"6168",2017-12-24 17:12:18,-177895.06,4.65661287307739e-10
"6169",2017-12-24 18:00:57,215718.07,215718.07
"6170",2017-12-24 18:10:13,-215718.07,4.65661287307739e-10
"6171",2017-12-24 18:46:53,276916.13,276916.13
"6172",2017-12-24 18:46:53,501066.04,777982.17
"6173",2017-12-24 18:49:46,-777982.17,3.49245965480804e-10
"6174",2017-12-24 19:14:25,250415.57,250415.57
"6175",2017-12-24 19:14:25,334662.3,585077.87
"6176",2017-12-24 19:34:43,-585077.87,3.49245965480804e-10
"6177",2017-12-24 20:04:14,637155.18,637155.18
"6178",2017-12-24 20:08:23,-637155.18,3.49245965480804e-10
"6179",2017-12-24 21:15:12,300118.31,300118.31
"6180",2017-12-24 21:20:13,-300118.31,3.49245965480804e-10
"6181",2017-12-24 21:20:13,426550.69,426550.69
"6182",2017-12-24 21:26:23,-426550.69,3.49245965480804e-10
"6183",2017-12-24 22:42:52,271058.89,271058.89
"6184",2017-12-24 22:46:42,-271058.89,3.49245965480804e-10
"6185",2017-12-25 01:56:01,385323.67,385323.67
"6186",2017-12-25 02:00:11,-385323.67,3.49245965480804e-10
"6187",2017-12-25 02:29:21,381589.45,381589.45
"6188",2017-12-25 02:46:29,-381589.45,3.49245965480804e-10
"6189",2017-12-25 03:41:53,336965.55,336965.55
"6190",2017-12-25 03:57:37,-336965.55,3.49245965480804e-10
"6191",2017-12-25 05:00:09,412570.45,412570.45
"6192",2017-12-25 05:00:09,265352.25,677922.7
"6193",2017-12-25 05:00:09,499991.54,1177914.24
"6194",2017-12-25 05:00:09,353827.03,1531741.27
"6195",2017-12-25 05:10:27,-1531741.27,4.65661287307739e-10
"6196",2017-12-25 05:10:27,590804.08,590804.08
"6197",2017-12-25 05:18:16,-590804.08,4.65661287307739e-10
"6198",2017-12-25 05:18:16,222731.45,222731.45
"6199",2017-12-25 05:35:09,-222731.45,4.65661287307739e-10
"6200",2017-12-25 06:29:26,509109.19,509109.19
"6201",2017-12-25 06:31:53,410196.56,919305.75
"6202",2017-12-25 07:00:48,-509109.19,410196.56
"6203",2017-12-25 08:03:18,-410196.56,4.65661287307739e-10
"6204",2017-12-25 08:29:20,308811.82,308811.82
"6205",2017-12-25 08:51:14,-308811.82,4.65661287307739e-10
"6206",2017-12-25 08:51:14,403875.86,403875.86
"6207",2017-12-25 09:13:39,-403875.86,4.65661287307739e-10
"6208",2017-12-25 13:03:42,352661.46,352661.46
"6209",2017-12-25 13:10:12,-352661.46,4.65661287307739e-10
"6210",2017-12-25 13:27:24,511529.06,511529.06
"6211",2017-12-25 13:27:24,857087.94,1368617
"6212",2017-12-25 13:44:35,-1368617,4.65661287307739e-10
"6213",2017-12-25 14:50:34,94667.24,94667.2400000005
"6214",2017-12-25 14:50:34,530288.81,624956.050000001
"6215",2017-12-25 14:50:34,359435.41,984391.46
"6216",2017-12-25 15:22:44,-984391.46,4.65661287307739e-10
"6217",2017-12-25 17:42:45,241229.91,241229.91
"6218",2017-12-25 18:01:43,-241229.91,4.65661287307739e-10
"6219",2017-12-25 18:08:06,469945.03,469945.03
"6220",2017-12-25 18:17:33,-469945.03,4.65661287307739e-10
"6221",2017-12-25 20:58:35,306085.39,306085.39
"6222",2017-12-25 20:58:35,36919.84,343005.23
"6223",2017-12-25 21:17:09,-343005.23,4.65661287307739e-10
"6224",2017-12-25 23:07:50,481790.77,481790.77
"6225",2017-12-25 23:07:50,350404.37,832195.14
"6226",2017-12-25 23:07:50,302060.72,1134255.86
"6227",2017-12-25 23:36:04,-1134255.86,2.3283064365387e-10
"6228",2017-12-26 00:16:44,516969.16,516969.16
"6229",2017-12-26 00:28:12,-516969.16,2.3283064365387e-10
"6230",2017-12-26 01:11:48,478654.13,478654.13
"6231",2017-12-26 01:43:01,-478654.13,2.3283064365387e-10
"6232",2017-12-26 01:43:01,523035.55,523035.55
"6233",2017-12-26 01:57:08,-523035.55,2.3283064365387e-10
"6234",2017-12-26 02:44:45,192553.87,192553.87
"6235",2017-12-26 03:12:41,-192553.87,2.3283064365387e-10
"6236",2017-12-26 03:50:59,186951.48,186951.48
"6237",2017-12-26 03:58:31,-186951.48,2.3283064365387e-10
"6238",2017-12-26 04:13:20,269913.6,269913.6
"6239",2017-12-26 04:13:20,238310.6,508224.2
"6240",2017-12-26 04:19:57,-508224.2,1.74622982740402e-10
"6241",2017-12-26 04:58:17,407294.97,407294.97
"6242",2017-12-26 04:58:17,216806.14,624101.11
"6243",2017-12-26 05:03:06,-624101.11,1.16415321826935e-10
"6244",2017-12-26 05:25:54,429281.89,429281.89
"6245",2017-12-26 05:38:20,185601.91,614883.8
"6246",2017-12-26 05:38:20,-429281.89,185601.91
"6247",2017-12-26 06:14:47,292891.65,478493.56
"6248",2017-12-26 06:14:47,192629.83,671123.39
"6249",2017-12-26 06:14:47,215383.59,886506.98
"6250",2017-12-26 06:14:47,-185601.91,700905.07
"6251",2017-12-26 06:25:57,-700905.07,1.16415321826935e-10
"6252",2017-12-26 07:03:23,431030.37,431030.37
"6253",2017-12-26 07:14:38,-431030.37,1.16415321826935e-10
"6254",2017-12-26 07:50:52,306672.05,306672.05
"6255",2017-12-26 07:58:42,-306672.05,1.16415321826935e-10
"6256",2017-12-26 08:35:19,268316.71,268316.71
"6257",2017-12-26 08:44:35,-268316.71,1.16415321826935e-10
"6258",2017-12-26 10:03:03,246608.88,246608.88
"6259",2017-12-26 10:19:11,-246608.88,1.16415321826935e-10
"6260",2017-12-26 11:46:33,211520.1,211520.1
"6261",2017-12-26 11:50:35,-211520.1,1.16415321826935e-10
"6262",2017-12-26 14:40:51,275850.62,275850.62
"6263",2017-12-26 14:40:51,348438.08,624288.7
"6264",2017-12-26 15:08:46,-624288.7,2.3283064365387e-10
"6265",2017-12-26 15:08:46,510180.11,510180.11
"6266",2017-12-26 15:21:13,-510180.11,2.3283064365387e-10
"6267",2017-12-26 15:39:11,534919.22,534919.22
"6268",2017-12-26 16:10:53,-534919.22,2.3283064365387e-10
"6269",2017-12-26 17:03:34,321529.17,321529.17
"6270",2017-12-26 17:26:35,268243.63,589772.8
"6271",2017-12-26 17:26:35,-321529.17,268243.63
"6272",2017-12-26 17:35:34,-268243.63,2.91038304567337e-10
"6273",2017-12-26 18:15:14,381222.57,381222.57
"6274",2017-12-26 18:33:29,303897.45,685120.02
"6275",2017-12-26 18:33:29,-381222.57,303897.45
"6276",2017-12-26 18:42:41,-303897.45,2.3283064365387e-10
"6277",2017-12-26 19:28:42,225842.27,225842.27
"6278",2017-12-26 20:23:38,454923.15,680765.42
"6279",2017-12-26 20:44:37,225312.16,906077.58
"6280",2017-12-26 20:44:37,261685.81,1167763.39
"6281",2017-12-26 20:45:22,226072.23,1393835.62
"6282",2017-12-26 20:45:22,-225842.27,1167993.35
"6283",2017-12-26 21:00:37,-1167993.35,2.3283064365387e-10
"6284",2017-12-26 21:03:05,193028.7,193028.7
"6285",2017-12-26 21:15:14,-193028.7,2.3283064365387e-10
"6286",2017-12-26 21:52:04,276709.64,276709.64
"6287",2017-12-26 21:57:23,-276709.64,2.3283064365387e-10
"6288",2017-12-26 22:56:48,317963.67,317963.67
"6289",2017-12-26 23:36:43,-317963.67,2.3283064365387e-10
"6290",2017-12-27 01:16:04,432794.14,432794.14
"6291",2017-12-27 01:16:04,415498.29,848292.43
"6292",2017-12-27 01:16:04,487885.49,1336177.92
"6293",2017-12-27 01:27:43,256009.7,1592187.62
"6294",2017-12-27 01:27:43,-1336177.92,256009.7
"6295",2017-12-27 01:48:24,647898.23,903907.93
"6296",2017-12-27 01:48:24,-256009.7,647898.23
"6297",2017-12-27 01:59:37,-647898.23,2.3283064365387e-10
"6298",2017-12-27 10:34:56,777898.95,777898.95
"6299",2017-12-27 10:34:56,76972.96,854871.91
"6300",2017-12-27 10:50:56,72952.17,927824.08
"6301",2017-12-27 10:50:56,-854871.91,72952.1700000002
"6302",2017-12-27 11:00:17,712271.04,785223.21
"6303",2017-12-27 11:00:17,-72952.17,712271.04
"6304",2017-12-27 11:05:51,-712271.04,1.16415321826935e-10
"6305",2017-12-27 11:09:35,627101.17,627101.17
"6306",2017-12-27 11:23:51,-627101.17,1.16415321826935e-10
"6307",2017-12-27 11:43:29,645400.46,645400.46
"6308",2017-12-27 11:43:29,32023.61,677424.07
"6309",2017-12-27 11:48:07,-677424.07,1.16415321826935e-10
"6310",2017-12-27 12:34:21,610271.57,610271.57
"6311",2017-12-27 13:11:51,-610271.57,1.16415321826935e-10
"6312",2017-12-27 14:35:14,462880.5,462880.5
"6313",2017-12-27 14:35:14,23211.44,486091.94
"6314",2017-12-27 14:42:43,-486091.94,1.16415321826935e-10
"6315",2017-12-27 15:19:30,777899.2,777899.2
"6316",2017-12-27 15:19:30,479536.58,1257435.78
"6317",2017-12-27 15:19:30,652843.21,1910278.99
"6318",2017-12-27 15:31:48,-1910278.99,0
"6319",2017-12-27 15:49:52,951948.42,951948.42
"6320",2017-12-27 16:05:56,-951948.42,0
"6321",2017-12-27 16:29:06,513982.63,513982.63
"6322",2017-12-27 16:44:44,661822.21,1175804.84
"6323",2017-12-27 16:44:44,38402.16,1214207
"6324",2017-12-27 16:44:44,-513982.63,700224.37
"6325",2017-12-27 17:27:11,328924.24,1029148.61
"6326",2017-12-27 17:27:11,327479.15,1356627.76
"6327",2017-12-27 17:39:51,-700224.37,656403.39
"6328",2017-12-27 18:09:51,327917.75,984321.14
"6329",2017-12-27 18:09:51,517250.45,1501571.59
"6330",2017-12-27 18:09:51,-656403.39,845168.2
"6331",2017-12-27 18:30:53,-845168.2,-1.16415321826935e-10
"6332",2017-12-27 18:58:11,353185.01,353185.01
"6333",2017-12-27 19:08:01,-353185.01,-1.16415321826935e-10
"6334",2017-12-27 19:10:02,774631.55,774631.55
"6335",2017-12-27 19:15:57,-774631.55,-1.16415321826935e-10
"6336",2017-12-27 19:39:38,600048.95,600048.95
"6337",2017-12-27 19:39:38,381529.54,981578.49
"6338",2017-12-27 19:47:59,-981578.49,-2.3283064365387e-10
"6339",2017-12-27 22:23:09,777899.57,777899.57
"6340",2017-12-27 22:23:09,777899.54,1555799.11
"6341",2017-12-27 22:26:16,777899.53,2333698.64
"6342",2017-12-27 22:26:16,777899.55,3111598.19
"6343",2017-12-27 22:26:16,777899.56,3889497.75
"6344",2017-12-27 22:35:18,67950.58,3957448.33
"6345",2017-12-27 22:35:18,-1555799.11,2401649.22
"6346",2017-12-27 22:46:56,825899.18,3227548.4
"6347",2017-12-27 22:46:56,-2401649.22,825899.18
"6348",2017-12-27 23:13:35,-825899.18,-3.49245965480804e-10
"6349",2017-12-28 03:16:31,111161.61,111161.61
"6350",2017-12-28 03:25:09,110062.85,221224.46
"6351",2017-12-28 03:25:09,-111161.61,110062.85
"6352",2017-12-28 03:32:07,180913.88,290976.73
"6353",2017-12-28 03:32:07,777899.87,1068876.6
"6354",2017-12-28 03:32:07,352977.12,1421853.72
"6355",2017-12-28 03:32:07,777899.84,2199753.56
"6356",2017-12-28 03:37:03,-110062.85,2089690.71
"6357",2017-12-28 03:51:12,252191.91,2341882.62
"6358",2017-12-28 03:51:12,777899.9,3119782.52
"6359",2017-12-28 03:51:12,24824.09,3144606.61
"6360",2017-12-28 03:51:12,-2089690.71,1054915.9
"6361",2017-12-28 04:01:23,-1054915.9,-4.65661287307739e-10
"6362",2017-12-28 04:29:53,659889.17,659889.17
"6363",2017-12-28 04:29:53,60333.88,720223.05
"6364",2017-12-28 04:56:43,-720223.05,-4.65661287307739e-10
"6365",2017-12-28 05:14:54,777900.03,777900.03
"6366",2017-12-28 05:14:54,661119.83,1439019.86
"6367",2017-12-28 05:14:54,34053.04,1473072.9
"6368",2017-12-28 05:22:30,-1473072.9,-4.65661287307739e-10
"6369",2017-12-28 05:56:06,758185.04,758185.04
"6370",2017-12-28 05:59:17,-758185.04,-4.65661287307739e-10
"6371",2017-12-28 07:45:30,358830.32,358830.32
"6372",2017-12-28 07:57:21,46793.94,405624.26
"6373",2017-12-28 07:57:21,-358830.32,46793.9399999995
"6374",2017-12-28 08:11:05,-46793.94,-4.65661287307739e-10
"6375",2017-12-28 10:33:39,421941.57,421941.57
"6376",2017-12-28 10:43:33,-421941.57,-4.65661287307739e-10
"6377",2017-12-28 14:52:30,353384.2,353384.2
"6378",2017-12-28 15:00:44,355079.06,708463.26
"6379",2017-12-28 15:00:44,-353384.2,355079.06
"6380",2017-12-28 15:13:36,407079.23,762158.29
"6381",2017-12-28 15:13:36,324106.67,1086264.96
"6382",2017-12-28 15:13:36,31249.41,1117514.37
"6383",2017-12-28 15:13:36,-355079.06,762435.309999999
"6384",2017-12-28 15:26:23,-762435.31,-6.98491930961609e-10
"6385",2017-12-28 15:40:02,589271.26,589271.259999999
"6386",2017-12-28 15:47:16,-589271.26,-6.98491930961609e-10
"6387",2017-12-28 16:37:11,188152.98,188152.979999999
"6388",2017-12-28 16:41:09,-188152.98,-6.98491930961609e-10
"6389",2017-12-28 16:59:49,285816.58,285816.579999999
"6390",2017-12-28 16:59:49,183587.63,469404.209999999
"6391",2017-12-28 17:09:24,-469404.21,-6.98491930961609e-10
"6392",2017-12-28 18:39:49,114724.12,114724.119999999
"6393",2017-12-28 18:49:46,-114724.12,-6.98491930961609e-10
"6394",2017-12-28 20:15:36,178985.44,178985.439999999
"6395",2017-12-28 20:44:15,-178985.44,-6.98491930961609e-10
"6396",2017-12-28 22:31:54,86763.31,86763.3099999993
"6397",2017-12-28 22:31:54,311431.77,398195.079999999
"6398",2017-12-28 22:46:28,-398195.08,-6.98491930961609e-10
"6399",2017-12-28 23:00:55,155103.76,155103.759999999
"6400",2017-12-28 23:02:58,-155103.76,-6.98491930961609e-10
"6401",2017-12-29 00:04:46,416914.94,416914.939999999
"6402",2017-12-29 00:04:46,249166.39,666081.329999999
"6403",2017-12-29 00:25:22,-666081.33,-5.82076609134674e-10
"6404",2017-12-29 01:16:54,274644,274643.999999999
"6405",2017-12-29 01:26:35,-274644,-5.82076609134674e-10
"6406",2017-12-29 02:00:26,506742.58,506742.579999999
"6407",2017-12-29 02:03:40,-506742.58,-5.82076609134674e-10
"6408",2017-12-29 02:25:55,239912.43,239912.429999999
"6409",2017-12-29 02:25:55,355697.47,595609.899999999
"6410",2017-12-29 02:25:55,237203.62,832813.519999999
"6411",2017-12-29 02:31:12,-832813.52,-5.82076609134674e-10
"6412",2017-12-29 02:54:54,549210.89,549210.889999999
"6413",2017-12-29 02:54:54,283362.86,832573.749999999
"6414",2017-12-29 03:05:53,-832573.75,-5.82076609134674e-10
"6415",2017-12-29 03:18:05,356446.84,356446.839999999
"6416",2017-12-29 03:36:00,295465.31,651912.149999999
"6417",2017-12-29 03:36:00,-356446.84,295465.309999999
"6418",2017-12-29 04:07:43,456693.79,752159.099999999
"6419",2017-12-29 04:07:43,-295465.31,456693.789999999
"6420",2017-12-29 04:13:52,-456693.79,-5.82076609134674e-10
"6421",2017-12-29 04:39:27,458786.97,458786.969999999
"6422",2017-12-29 04:42:06,-458786.97,-5.82076609134674e-10
"6423",2017-12-29 05:04:58,395862.4,395862.399999999
"6424",2017-12-29 05:12:29,284206.58,680068.98
"6425",2017-12-29 05:12:29,-395862.4,284206.579999999
"6426",2017-12-29 05:19:20,-284206.58,-5.23868948221207e-10
"6427",2017-12-29 05:58:49,777901.3,777901.3
"6428",2017-12-29 05:58:49,397546.02,1175447.32
"6429",2017-12-29 05:58:49,208314.31,1383761.63
"6430",2017-12-29 06:15:41,-1383761.63,-2.3283064365387e-10
"6431",2017-12-29 07:11:21,453690.24,453690.24
"6432",2017-12-29 07:11:21,370396.12,824086.36
"6433",2017-12-29 07:11:21,354140.83,1178227.19
"6434",2017-12-29 07:19:22,-1178227.19,-2.3283064365387e-10
"6435",2017-12-29 07:48:46,308675.3,308675.3
"6436",2017-12-29 07:56:36,286152.49,594827.79
"6437",2017-12-29 07:56:36,-308675.3,286152.49
"6438",2017-12-29 08:10:32,-286152.49,-1.74622982740402e-10
"6439",2017-12-29 08:16:00,320290.15,320290.15
"6440",2017-12-29 08:16:00,590738.58,911028.73
"6441",2017-12-29 08:26:56,-911028.73,-2.3283064365387e-10
"6442",2017-12-29 09:50:51,333473.48,333473.48
"6443",2017-12-29 09:50:51,347410.1,680883.58
"6444",2017-12-29 10:16:42,-680883.58,-2.3283064365387e-10
"6445",2017-12-29 11:06:31,355223.08,355223.08
"6446",2017-12-29 11:16:49,-355223.08,-2.3283064365387e-10
"6447",2017-12-29 12:39:32,178661.41,178661.41
"6448",2017-12-29 13:09:47,-178661.41,-2.3283064365387e-10
"6449",2017-12-29 13:54:21,302350.49,302350.49
"6450",2017-12-29 14:13:33,131781.85,434132.34
"6451",2017-12-29 14:13:33,-302350.49,131781.85
"6452",2017-12-29 14:25:01,-131781.85,-2.61934474110603e-10
"6453",2017-12-29 14:38:49,48603.13,48603.1299999997
"6454",2017-12-29 14:59:08,183651.7,232254.83
"6455",2017-12-29 14:59:08,-48603.13,183651.7
"6456",2017-12-29 15:06:24,-183651.7,-2.61934474110603e-10
"6457",2017-12-29 17:48:21,397655.56,397655.56
"6458",2017-12-29 17:48:21,777903.55,1175559.11
"6459",2017-12-29 17:53:59,-1175559.11,-2.3283064365387e-10
"6460",2017-12-29 18:17:44,52544.98,52544.9799999998
"6461",2017-12-29 18:32:08,665113.34,717658.32
"6462",2017-12-29 18:32:08,257698.72,975357.04
"6463",2017-12-29 18:32:08,-52544.98,922812.06
"6464",2017-12-29 18:39:56,-922812.06,-3.49245965480804e-10
"6465",2017-12-29 19:24:07,267683.75,267683.75
"6466",2017-12-29 19:33:26,280651.54,548335.29
"6467",2017-12-29 19:33:26,-267683.75,280651.54
"6468",2017-12-29 20:05:13,250291.16,530942.7
"6469",2017-12-29 20:05:13,-280651.54,250291.16
"6470",2017-12-29 20:11:06,-250291.16,-3.78349795937538e-10
"6471",2017-12-29 20:28:57,306306.78,306306.78
"6472",2017-12-29 20:36:50,-306306.78,-3.49245965480804e-10
"6473",2017-12-29 21:09:37,411407.79,411407.79
"6474",2017-12-29 21:14:31,458269.41,869677.2
"6475",2017-12-29 21:14:31,-411407.79,458269.41
"6476",2017-12-29 21:28:32,-458269.41,-3.49245965480804e-10
"6477",2017-12-29 22:15:20,767994.06,767994.06
"6478",2017-12-29 22:19:55,-767994.06,-3.49245965480804e-10
"6479",2017-12-29 22:57:02,315046.96,315046.96
"6480",2017-12-29 23:06:20,-315046.96,-3.49245965480804e-10
"6481",2017-12-30 00:04:20,329752.04,329752.04
"6482",2017-12-30 00:10:49,-329752.04,-3.49245965480804e-10
"6483",2017-12-30 00:34:08,572451.56,572451.56
"6484",2017-12-30 00:52:43,-572451.56,-3.49245965480804e-10
"6485",2017-12-30 01:09:23,589999.3,589999.3
"6486",2017-12-30 01:12:19,-589999.3,-3.49245965480804e-10
"6487",2017-12-30 01:20:36,314504.54,314504.54
"6488",2017-12-30 01:33:10,-314504.54,-3.49245965480804e-10
"6489",2017-12-30 02:43:54,425141.45,425141.45
"6490",2017-12-30 02:47:58,-425141.45,-3.49245965480804e-10
"6491",2017-12-30 04:56:30,62808.12,62808.1199999997
"6492",2017-12-30 05:41:15,-62808.12,-3.49245965480804e-10
"6493",2017-12-30 06:56:44,27652.67,27652.6699999996
"6494",2017-12-30 07:03:50,-27652.67,-3.49245965480804e-10
"6495",2017-12-30 08:37:12,259623.43,259623.43
"6496",2017-12-30 08:44:40,-259623.43,-3.49245965480804e-10
"6497",2017-12-30 10:02:07,218611.56,218611.56
"6498",2017-12-30 10:10:55,300128.06,518739.62
"6499",2017-12-30 10:10:55,-218611.56,300128.06
"6500",2017-12-30 10:23:14,298782.71,598910.77
"6501",2017-12-30 10:23:14,-300128.06,298782.71
"6502",2017-12-30 10:32:34,501620.87,800403.58
"6503",2017-12-30 10:36:50,-298782.71,501620.87
"6504",2017-12-30 10:42:33,-501620.87,-4.07453626394272e-10
"6505",2017-12-30 11:19:49,403792.39,403792.39
"6506",2017-12-30 11:31:29,245441.66,649234.05
"6507",2017-12-30 11:31:29,-403792.39,245441.66
"6508",2017-12-30 11:47:47,-245441.66,-4.36557456851006e-10
"6509",2017-12-30 14:40:55,272654.23,272654.23
"6510",2017-12-30 15:02:10,-272654.23,-4.65661287307739e-10
"6511",2017-12-30 15:18:12,474326.16,474326.16
"6512",2017-12-30 15:22:10,-474326.16,-4.65661287307739e-10
"6513",2017-12-30 16:28:51,28134.59,28134.5899999995
"6514",2017-12-30 16:30:54,446901.63,475036.22
"6515",2017-12-30 16:34:06,-28134.59,446901.63
"6516",2017-12-30 16:36:43,279338.29,726239.919999999
"6517",2017-12-30 17:04:49,256517.45,982757.369999999
"6518",2017-12-30 17:04:49,-726239.92,256517.449999999
"6519",2017-12-30 17:16:51,-256517.45,-6.40284270048141e-10
"6520",2017-12-30 18:13:58,328766.33,328766.329999999
"6521",2017-12-30 18:26:00,467404.5,796170.829999999
"6522",2017-12-30 18:26:00,252589.37,1048760.2
"6523",2017-12-30 18:26:00,-328766.33,719993.869999999
"6524",2017-12-30 19:08:04,-719993.87,-8.14907252788544e-10
"6525",2017-12-30 20:34:41,300128.86,300128.859999999
"6526",2017-12-30 21:01:49,-300128.86,-8.14907252788544e-10
"6527",2017-12-30 21:14:33,493918.96,493918.959999999
"6528",2017-12-30 21:22:16,-493918.96,-8.14907252788544e-10
"6529",2017-12-30 22:07:18,66827.27,66827.2699999992
"6530",2017-12-30 22:20:44,-66827.27,-8.14907252788544e-10
"6531",2017-12-30 22:47:24,332855.88,332855.879999999
"6532",2017-12-30 22:47:24,353700.63,686556.509999999
"6533",2017-12-30 23:14:37,200129.03,886685.539999999
"6534",2017-12-30 23:14:37,-686556.51,200129.029999999
"6535",2017-12-30 23:23:03,-200129.03,-7.8580342233181e-10
"6536",2017-12-31 00:08:05,363917.34,363917.339999999
"6537",2017-12-31 00:14:29,-363917.34,-7.56699591875076e-10
"6538",2017-12-31 00:20:54,264169.15,264169.149999999
"6539",2017-12-31 00:27:19,-264169.15,-7.56699591875076e-10
"6540",2017-12-31 00:52:15,467669.99,467669.989999999
"6541",2017-12-31 00:57:21,-467669.99,-7.56699591875076e-10
"6542",2017-12-31 01:51:27,281334.52,281334.519999999
"6543",2017-12-31 01:55:31,-281334.52,-7.56699591875076e-10
"6544",2017-12-31 03:43:34,497953.88,497953.879999999
"6545",2017-12-31 03:52:54,-497953.88,-7.56699591875076e-10
"6546",2017-12-31 04:49:01,339113.58,339113.579999999
"6547",2017-12-31 04:53:25,235946.98,575060.559999999
"6548",2017-12-31 04:53:25,-339113.58,235946.979999999
"6549",2017-12-31 05:06:08,434682.33,670629.309999999
"6550",2017-12-31 05:06:08,-235946.98,434682.329999999
"6551",2017-12-31 05:12:49,-434682.33,-7.56699591875076e-10
"6552",2017-12-31 05:46:24,337384.61,337384.609999999
"6553",2017-12-31 05:51:16,-337384.61,-7.56699591875076e-10
"6554",2017-12-31 07:26:32,398492.96,398492.959999999
"6555",2017-12-31 07:52:52,-398492.96,-7.56699591875076e-10
"6556",2017-12-31 09:51:19,378445.66,378445.659999999
"6557",2017-12-31 10:09:42,-378445.66,-7.56699591875076e-10
"6558",2017-12-31 10:50:40,275618.88,275618.879999999
"6559",2017-12-31 10:50:40,410375.13,685994.009999999
"6560",2017-12-31 11:02:05,-685994.01,-6.98491930961609e-10
"6561",2017-12-31 11:50:12,320580.83,320580.829999999
"6562",2017-12-31 12:12:38,418320.87,738901.699999999
"6563",2017-12-31 12:12:38,-320580.83,418320.869999999
"6564",2017-12-31 12:23:25,-418320.87,-7.56699591875076e-10
"6565",2017-12-31 12:32:38,709554.67,709554.669999999
"6566",2017-12-31 12:36:40,-709554.67,-8.14907252788544e-10
"6567",2017-12-31 14:49:56,200129.75,200129.749999999
"6568",2017-12-31 14:49:56,380912.37,581042.119999999
"6569",2017-12-31 14:49:56,358222.54,939264.659999999
"6570",2017-12-31 14:52:19,397390.4,1336655.06
"6571",2017-12-31 14:58:48,-939264.66,397390.399999999
"6572",2017-12-31 15:39:56,619867.78,1017258.18
"6573",2017-12-31 15:39:56,356789.57,1374047.75
"6574",2017-12-31 15:39:56,-397390.4,976657.349999999
"6575",2017-12-31 15:55:04,517658.58,1494315.93
"6576",2017-12-31 15:55:04,-976657.35,517658.579999999
"6577",2017-12-31 16:03:38,-517658.58,-9.89530235528946e-10
"6578",2017-12-31 16:09:47,777906.86,777906.859999999
"6579",2017-12-31 16:22:44,232603.89,1010510.75
"6580",2017-12-31 16:22:44,40696.87,1051207.62
"6581",2017-12-31 16:22:44,777906.88,1829114.5
"6582",2017-12-31 16:22:44,-777906.86,1051207.64
"6583",2017-12-31 16:30:42,-1051207.64,-6.98491930961609e-10
"6584",2017-12-31 16:43:02,546692.65,546692.649999999
"6585",2017-12-31 16:45:22,-546692.65,-6.98491930961609e-10
"6586",2017-12-31 16:53:49,497627.06,497627.059999999
"6587",2017-12-31 17:03:51,-497627.06,-6.98491930961609e-10
"6588",2017-12-31 18:02:28,496299.65,496299.649999999
"6589",2017-12-31 18:02:28,371604.02,867903.669999999
"6590",2017-12-31 18:10:03,-867903.67,-6.98491930961609e-10
"6591",2017-12-31 18:35:13,34706.83,34706.8299999993
"6592",2017-12-31 18:53:15,-34706.83,-6.98491930961609e-10
"6593",2017-12-31 19:26:46,423194.5,423194.499999999
"6594",2017-12-31 19:42:45,-423194.5,-6.98491930961609e-10
"6595",2017-12-31 19:53:56,55662.31,55662.3099999993
"6596",2017-12-31 20:08:28,390452.22,446114.529999999
"6597",2017-12-31 20:08:28,-55662.31,390452.219999999
"6598",2017-12-31 20:16:44,-390452.22,-6.98491930961609e-10
"6599",2017-12-31 23:40:56,383900.76,383900.759999999
"6600",2017-12-31 23:43:42,-383900.76,-6.98491930961609e-10
"6601",2018-01-01 00:33:42,399509.98,399509.979999999
"6602",2018-01-01 00:41:38,-399509.98,-6.98491930961609e-10
"6603",2018-01-01 01:21:28,471648.41,471648.409999999
"6604",2018-01-01 01:44:42,-471648.41,-6.98491930961609e-10
"6605",2018-01-01 01:56:34,441802.67,441802.669999999
"6606",2018-01-01 02:10:45,-441802.67,-6.98491930961609e-10
"6607",2018-01-01 03:49:40,83347.85,83347.8499999993
"6608",2018-01-01 03:56:10,-83347.85,-6.98491930961609e-10
"6609",2018-01-01 03:57:29,274201.33,274201.329999999
"6610",2018-01-01 04:03:23,777907.32,1052108.65
"6611",2018-01-01 04:03:23,-274201.33,777907.319999999
"6612",2018-01-01 04:10:24,-777907.32,-8.14907252788544e-10
"6613",2018-01-01 04:29:12,491468.53,491468.529999999
"6614",2018-01-01 04:51:50,362973.65,854442.179999999
"6615",2018-01-01 04:51:50,-491468.53,362973.649999999
"6616",2018-01-01 04:57:50,-362973.65,-8.14907252788544e-10
"6617",2018-01-01 06:12:20,415736.72,415736.719999999
"6618",2018-01-01 06:16:15,-415736.72,-8.14907252788544e-10
"6619",2018-01-01 07:22:29,466228.16,466228.159999999
"6620",2018-01-01 07:22:29,67608.87,533837.029999999
"6621",2018-01-01 07:22:29,427033.89,960870.919999999
"6622",2018-01-01 07:40:05,-960870.92,-9.31322574615479e-10
"6623",2018-01-01 12:44:31,66931.6,66931.5999999991
"6624",2018-01-01 12:55:58,-66931.6,-9.31322574615479e-10
"6625",2018-01-01 14:26:21,327225.29,327225.289999999
"6626",2018-01-01 14:31:10,-327225.29,-9.31322574615479e-10
"6627",2018-01-01 19:57:33,471486.46,471486.459999999
"6628",2018-01-01 20:03:41,-471486.46,-9.31322574615479e-10
"6629",2018-01-01 20:39:28,347970.77,347970.769999999
"6630",2018-01-01 20:53:20,357701.6,705672.369999999
"6631",2018-01-01 20:53:20,-347970.77,357701.599999999
"6632",2018-01-01 21:07:10,-357701.6,-9.31322574615479e-10
"6633",2018-01-01 21:16:52,469343.77,469343.769999999
"6634",2018-01-01 21:22:19,-469343.77,-9.31322574615479e-10
"6635",2018-01-01 21:43:12,444853.16,444853.159999999
"6636",2018-01-01 21:52:48,-444853.16,-9.31322574615479e-10
"6637",2018-01-01 22:56:31,226546.11,226546.109999999
"6638",2018-01-01 22:56:31,777908.1,1004454.21
"6639",2018-01-01 23:14:17,-1004454.21,-9.31322574615479e-10
"6640",2018-01-02 00:19:12,423391.02,423391.019999999
"6641",2018-01-02 00:37:08,-423391.02,-9.31322574615479e-10
"6642",2018-01-02 01:45:26,616528.99,616528.989999999
"6643",2018-01-02 01:55:27,-616528.99,-9.31322574615479e-10
"6644",2018-01-02 03:12:26,667245.24,667245.239999999
"6645",2018-01-02 03:16:12,-667245.24,-9.31322574615479e-10
"6646",2018-01-02 04:54:22,656792.79,656792.789999999
"6647",2018-01-02 04:54:22,65802.9,722595.689999999
"6648",2018-01-02 04:59:42,-722595.69,-8.14907252788544e-10
"6649",2018-01-02 13:28:19,777908.66,777908.659999999
"6650",2018-01-02 13:28:19,59957.67,837866.329999999
"6651",2018-01-02 13:35:16,-837866.33,-6.98491930961609e-10
"6652",2018-01-02 13:49:59,494314.55,494314.549999999
"6653",2018-01-02 13:49:59,614827.49,1109142.04
"6654",2018-01-02 13:51:49,-1109142.04,-6.98491930961609e-10
"6655",2018-01-02 14:32:16,641727.22,641727.219999999
"6656",2018-01-02 14:32:16,66536.68,708263.899999999
"6657",2018-01-02 14:49:44,485758.94,1194022.84
"6658",2018-01-02 14:49:44,-708263.9,485758.939999999
"6659",2018-01-02 14:58:11,-485758.94,-8.73114913702011e-10
"6660",2018-01-02 18:20:33,18570.92,18570.9199999991
"6661",2018-01-02 18:20:33,777908.91,796479.829999999
"6662",2018-01-02 18:24:10,-796479.83,-8.14907252788544e-10
"6663",2018-01-02 18:39:51,687865.02,687865.019999999
"6664",2018-01-02 18:54:24,-687865.02,-8.14907252788544e-10
"6665",2018-01-02 19:25:26,716541.57,716541.569999999
"6666",2018-01-02 19:29:01,-716541.57,-8.14907252788544e-10
"6667",2018-01-02 20:38:34,13860.04,13860.0399999992
"6668",2018-01-02 20:38:34,777909.03,791769.069999999
"6669",2018-01-02 20:55:49,777909.07,1569678.14
"6670",2018-01-02 20:55:49,66727.08,1636405.22
"6671",2018-01-02 20:55:49,-791769.07,844636.149999999
"6672",2018-01-02 21:02:26,-844636.15,-6.98491930961609e-10
"6673",2018-01-02 22:14:34,546278.92,546278.919999999
"6674",2018-01-02 22:22:43,-546278.92,-6.98491930961609e-10
"6675",2018-01-03 00:28:59,487599.06,487599.059999999
"6676",2018-01-03 00:54:07,627365.33,1114964.39
"6677",2018-01-03 00:59:01,-487599.06,627365.329999999
"6678",2018-01-03 01:15:15,-627365.33,-8.14907252788544e-10
"6679",2018-01-03 03:02:17,516923.43,516923.429999999
"6680",2018-01-03 03:14:39,-516923.43,-8.14907252788544e-10
"6681",2018-01-03 04:26:25,208994.5,208994.499999999
"6682",2018-01-03 04:34:02,274879.63,483874.129999999
"6683",2018-01-03 04:34:02,-208994.5,274879.629999999
"6684",2018-01-03 04:47:52,293401.21,568280.839999999
"6685",2018-01-03 04:47:52,-274879.63,293401.209999999
"6686",2018-01-03 04:53:21,369088.62,662489.829999999
"6687",2018-01-03 05:20:06,-662489.83,-8.14907252788544e-10
"6688",2018-01-03 05:39:27,548116.97,548116.969999999
"6689",2018-01-03 05:47:42,-548116.97,-8.14907252788544e-10
"6690",2018-01-03 07:11:30,554046.7,554046.699999999
"6691",2018-01-03 07:22:03,461240.06,1015286.76
"6692",2018-01-03 07:22:03,-554046.7,461240.059999999
"6693",2018-01-03 08:49:13,663912.42,1125152.48
"6694",2018-01-03 08:54:17,-461240.06,663912.419999999
"6695",2018-01-03 09:08:27,29128.2,693040.619999999
"6696",2018-01-03 09:08:27,42402.72,735443.339999999
"6697",2018-01-03 09:08:27,42422.69,777866.029999999
"6698",2018-01-03 09:08:27,-663912.42,113953.609999999
"6699",2018-01-03 09:21:13,-113953.61,-1.17870513349771e-09
"6700",2018-01-03 10:21:01,550866.73,550866.729999999
"6701",2018-01-03 10:28:30,547460.49,1098327.22
"6702",2018-01-03 10:28:30,52827.54,1151154.76
"6703",2018-01-03 10:50:14,-1151154.76,-1.16415321826935e-09
"6704",2018-01-03 10:54:37,469702.35,469702.349999999
"6705",2018-01-03 11:50:09,454711.31,924413.659999999
"6706",2018-01-03 11:50:09,475418.68,1399832.34
"6707",2018-01-03 11:50:09,36503.18,1436335.52
"6708",2018-01-03 12:31:13,380822.96,1817158.48
"6709",2018-01-03 12:31:13,904880.9,2722039.38
"6710",2018-01-03 13:02:27,-469702.35,2252337.03
"6711",2018-01-03 13:30:04,-2252337.03,-1.39698386192322e-09
"6712",2018-01-03 13:33:22,481796.4,481796.399999999
"6713",2018-01-03 13:33:22,97390.85,579187.249999999
"6714",2018-01-03 13:40:20,-579187.25,-1.39698386192322e-09
"6715",2018-01-03 14:47:51,777642.89,777642.889999999
"6716",2018-01-03 14:47:51,422869.18,1200512.07
"6717",2018-01-03 14:47:51,539399.74,1739911.81
"6718",2018-01-03 14:59:17,-1739911.81,-1.39698386192322e-09
"6719",2018-01-03 15:15:51,777909.8,777909.799999999
"6720",2018-01-03 15:27:24,129047.81,906957.609999999
"6721",2018-01-03 15:27:24,58076.86,965034.469999999
"6722",2018-01-03 15:27:24,-777909.8,187124.669999999
"6723",2018-01-03 15:47:53,681051.45,868176.119999999
"6724",2018-01-03 15:47:53,-187124.67,681051.449999999
"6725",2018-01-03 16:18:12,575122.63,1256174.08
"6726",2018-01-03 16:21:16,-681051.45,575122.629999999
"6727",2018-01-03 16:41:15,-575122.63,-1.28056854009628e-09
"6728",2018-01-03 17:11:18,533842.22,533842.219999999
"6729",2018-01-03 17:24:47,-533842.22,-1.28056854009628e-09
"6730",2018-01-03 17:36:34,769446.91,769446.909999999
"6731",2018-01-03 17:51:02,777909.92,1547356.83
"6732",2018-01-03 17:51:02,214951.93,1762308.76
"6733",2018-01-03 17:51:02,-769446.91,992861.849999999
"6734",2018-01-03 18:09:30,-992861.85,-1.39698386192322e-09
"6735",2018-01-03 18:33:12,549150.69,549150.689999999
"6736",2018-01-03 18:42:20,-549150.69,-1.39698386192322e-09
"6737",2018-01-03 20:17:39,131920.62,131920.619999999
"6738",2018-01-03 20:20:43,-131920.62,-1.39698386192322e-09
"6739",2018-01-03 20:59:01,462244.08,462244.079999999
"6740",2018-01-03 21:05:43,-462244.08,-1.39698386192322e-09
"6741",2018-01-03 21:50:00,581423.4,581423.399999999
"6742",2018-01-03 21:50:00,777910.13,1359333.53
"6743",2018-01-03 21:50:00,713769.14,2073102.67
"6744",2018-01-03 22:04:04,-2073102.67,-1.39698386192322e-09
"6745",2018-01-03 23:13:38,638479.66,638479.659999999
"6746",2018-01-03 23:44:59,-638479.66,-1.39698386192322e-09
"6747",2018-01-04 00:51:38,48873.38,48873.3799999986
"6748",2018-01-04 00:51:38,460231.86,509105.239999999
"6749",2018-01-04 01:03:29,777910.24,1287015.48
"6750",2018-01-04 01:03:29,320689.25,1607704.73
"6751",2018-01-04 01:03:29,614055.82,2221760.55
"6752",2018-01-04 01:03:29,-509105.24,1712655.31
"6753",2018-01-04 01:21:11,135411.27,1848066.58
"6754",2018-01-04 01:21:11,777910.26,2625976.84
"6755",2018-01-04 01:21:11,450621.17,3076598.01
"6756",2018-01-04 01:21:11,54412.39,3131010.4
"6757",2018-01-04 01:21:11,-1712655.31,1418355.09
"6758",2018-01-04 01:45:58,-1418355.09,-1.62981450557709e-09
"6759",2018-01-04 02:34:16,573109.77,573109.769999998
"6760",2018-01-04 02:42:47,-573109.77,-1.62981450557709e-09
"6761",2018-01-04 08:55:54,506030.85,506030.849999998
"6762",2018-01-04 09:10:04,-506030.85,-1.62981450557709e-09
"6763",2018-01-04 10:29:35,664352.09,664352.089999998
"6764",2018-01-04 10:36:33,433482.35,1097834.44
"6765",2018-01-04 10:37:47,-664352.09,433482.349999998
"6766",2018-01-04 10:55:54,-433482.35,-1.62981450557709e-09
"6767",2018-01-04 11:21:40,455238.43,455238.429999998
"6768",2018-01-04 11:24:21,-455238.43,-1.62981450557709e-09
"6769",2018-01-04 12:01:03,47297.16,47297.1599999984
"6770",2018-01-04 12:06:42,-47297.16,-1.62981450557709e-09
"6771",2018-01-04 12:18:11,745882.77,745882.769999998
"6772",2018-01-04 12:29:23,-745882.77,-1.62981450557709e-09
"6773",2018-01-04 13:34:52,563919.93,563919.929999998
"6774",2018-01-04 14:04:00,-563919.93,-1.62981450557709e-09
"6775",2018-01-04 15:36:10,591355.98,591355.979999998
"6776",2018-01-04 15:48:12,-591355.98,-1.62981450557709e-09
"6777",2018-01-04 16:36:12,777911.72,777911.719999998
"6778",2018-01-04 16:49:49,7366.73,785278.449999998
"6779",2018-01-04 16:49:49,593347.01,1378625.46
"6780",2018-01-04 16:49:49,-777911.72,600713.739999998
"6781",2018-01-04 16:57:00,-600713.74,-1.62981450557709e-09
"6782",2018-01-04 17:25:19,478016.32,478016.319999998
"6783",2018-01-04 17:33:30,-478016.32,-1.62981450557709e-09
"6784",2018-01-04 19:06:11,645994.59,645994.589999998
"6785",2018-01-04 19:32:52,777911.84,1423906.43
"6786",2018-01-04 19:36:40,225873.85,1649780.28
"6787",2018-01-04 19:36:40,-645994.59,1003785.69
"6788",2018-01-04 19:42:57,-1003785.69,-1.51339918375015e-09
"6789",2018-01-04 19:51:47,656797.73,656797.729999998
"6790",2018-01-04 20:05:56,846564.48,1503362.21
"6791",2018-01-04 20:18:10,534534.89,2037897.1
"6792",2018-01-04 20:18:10,588613.01,2626510.11
"6793",2018-01-04 20:20:00,-656797.73,1969712.38
"6794",2018-01-04 20:27:52,-1969712.38,-1.39698386192322e-09
"6795",2018-01-04 20:36:16,777911.9,777911.899999999
"6796",2018-01-04 20:36:16,297088.91,1075000.81
"6797",2018-01-04 21:15:03,-1075000.81,-1.39698386192322e-09
"6798",2018-01-04 21:52:27,1082786.1,1082786.1
"6799",2018-01-04 22:03:41,-1082786.1,-1.39698386192322e-09
"6800",2018-01-04 23:52:03,619737.79,619737.789999999
"6801",2018-01-04 23:54:58,-619737.79,-1.39698386192322e-09
"6802",2018-01-05 01:17:36,48297.11,48297.1099999986
"6803",2018-01-05 01:22:13,-48297.11,-1.39698386192322e-09
"6804",2018-01-05 02:43:46,630345.83,630345.829999999
"6805",2018-01-05 02:49:18,666693.16,1297038.99
"6806",2018-01-05 02:49:18,-630345.83,666693.159999999
"6807",2018-01-05 02:57:56,-666693.16,-1.39698386192322e-09
"6808",2018-01-05 03:26:29,590629.95,590629.949999999
"6809",2018-01-05 03:30:04,-590629.95,-1.39698386192322e-09
"6810",2018-01-05 06:36:32,500953.33,500953.329999999
"6811",2018-01-05 06:42:02,-500953.33,-1.39698386192322e-09
"6812",2018-01-05 09:04:51,777912.26,777912.259999999
"6813",2018-01-05 09:04:51,1759.27,779671.529999999
"6814",2018-01-05 09:04:51,777912.28,1557583.81
"6815",2018-01-05 09:07:22,164801.29,1722385.1
"6816",2018-01-05 09:09:08,-1557583.81,164801.289999999
"6817",2018-01-05 09:17:08,-164801.29,-1.36788003146648e-09
"6818",2018-01-05 10:40:45,734127.3,734127.299999999
"6819",2018-01-05 11:21:56,-734127.3,-1.39698386192322e-09
"6820",2018-01-05 11:38:18,354207.44,354207.439999999
"6821",2018-01-05 11:45:26,777912.43,1132119.87
"6822",2018-01-05 11:48:51,-354207.44,777912.429999999
"6823",2018-01-05 11:54:34,-777912.43,-1.28056854009628e-09
"6824",2018-01-05 14:11:56,336721.85,336721.849999999
"6825",2018-01-05 14:22:40,-336721.85,-1.28056854009628e-09
"6826",2018-01-05 14:32:56,201249.12,201249.119999999
"6827",2018-01-05 14:52:13,-201249.12,-1.28056854009628e-09
"6828",2018-01-05 15:27:08,53584.29,53584.2899999987
"6829",2018-01-05 15:41:25,-53584.29,-1.28056854009628e-09
"6830",2018-01-05 16:03:08,562138.33,562138.329999999
"6831",2018-01-05 16:08:00,-562138.33,-1.28056854009628e-09
"6832",2018-01-05 18:26:56,689583.19,689583.189999999
"6833",2018-01-05 18:31:53,-689583.19,-1.28056854009628e-09
"6834",2018-01-05 22:07:24,297920.17,297920.169999999
"6835",2018-01-05 22:07:24,156106.82,454026.989999999
"6836",2018-01-05 22:07:24,137360.01,591386.999999999
"6837",2018-01-05 22:45:19,42807.54,634194.539999999
"6838",2018-01-05 23:01:47,119328.02,753522.559999999
"6839",2018-01-05 23:01:47,85917.2,839439.759999999
"6840",2018-01-05 23:01:47,190033.8,1029473.56
"6841",2018-01-05 23:01:47,228806.88,1258280.44
"6842",2018-01-05 23:01:47,509498.64,1767779.08
"6843",2018-01-05 23:01:47,-591387,1176392.08
"6844",2018-01-05 23:18:04,-1176392.08,-1.39698386192322e-09
"6845",2018-01-05 23:59:39,31842.1,31842.0999999986
"6846",2018-01-05 23:59:39,78032.58,109874.679999999
"6847",2018-01-06 00:02:40,-109874.68,-1.39698386192322e-09
"6848",2018-01-06 00:28:18,38789.81,38789.8099999986
"6849",2018-01-06 00:28:18,45247.27,84037.0799999986
"6850",2018-01-06 00:51:35,22196.07,106233.149999999
"6851",2018-01-06 00:51:35,112840.9,219074.049999999
"6852",2018-01-06 00:55:06,-84037.08,135036.969999999
"6853",2018-01-06 01:17:36,94915.1,229952.069999999
"6854",2018-01-06 01:36:01,54430.79,284382.859999999
"6855",2018-01-06 01:36:01,193044.19,477427.049999999
"6856",2018-01-06 01:36:01,44311.17,521738.219999999
"6857",2018-01-06 01:36:01,40572.54,562310.759999999
"6858",2018-01-06 01:36:01,16380.73,578691.489999999
"6859",2018-01-06 01:36:01,268096.42,846787.909999999
"6860",2018-01-06 01:36:01,14280.86,861068.769999999
"6861",2018-01-06 01:36:01,403750.46,1264819.23
"6862",2018-01-06 01:44:26,147026.19,1411845.42
"6863",2018-01-06 01:44:26,223325.93,1635171.35
"6864",2018-01-06 01:44:26,444216.83,2079388.18
"6865",2018-01-06 01:44:26,-135036.97,1944351.21
"6866",2018-01-06 01:50:46,171068.78,2115419.99
"6867",2018-01-06 01:50:46,-1944351.21,171068.779999998
"6868",2018-01-06 02:05:16,-171068.78,-1.60071067512035e-09
"6869",2018-01-06 03:09:02,266892.13,266892.129999998
"6870",2018-01-06 03:09:02,59216.16,326108.289999998
"6871",2018-01-06 03:09:02,213609.88,539718.169999998
"6872",2018-01-06 03:09:02,141474.67,681192.839999998
"6873",2018-01-06 03:17:34,305319.73,986512.569999998
"6874",2018-01-06 03:17:34,-681192.84,305319.729999998
"6875",2018-01-06 03:26:11,-305319.73,-1.51339918375015e-09
"6876",2018-01-06 04:08:04,33133.26,33133.2599999985
"6877",2018-01-06 04:08:04,17909.48,51042.7399999985
"6878",2018-01-06 04:08:04,20782.04,71824.7799999985
"6879",2018-01-06 04:08:04,17701.42,89526.1999999985
"6880",2018-01-06 04:08:04,133077.49,222603.689999998
"6881",2018-01-06 04:08:04,20809.07,243412.759999998
"6882",2018-01-06 04:08:04,422910.6,666323.359999998
"6883",2018-01-06 04:08:04,16359.22,682682.579999998
"6884",2018-01-06 04:08:34,17870.11,700552.689999998
"6885",2018-01-06 04:11:40,116841.69,817394.379999998
"6886",2018-01-06 04:11:40,18321.33,835715.709999998
"6887",2018-01-06 04:11:40,-682682.58,153033.129999998
"6888",2018-01-06 04:19:14,369223.14,522256.269999999
"6889",2018-01-06 04:19:14,131400.08,653656.349999998
"6890",2018-01-06 04:19:14,498736.35,1152392.7
"6891",2018-01-06 04:28:36,94272.51,1246665.21
"6892",2018-01-06 04:38:04,-1152392.7,94272.5099999984
"6893",2018-01-06 05:02:16,-94272.51,-1.61526259034872e-09
"6894",2018-01-06 05:15:24,200704.4,200704.399999998
"6895",2018-01-06 05:15:24,268887.83,469592.229999998
"6896",2018-01-06 05:26:32,-469592.23,-1.57160684466362e-09
"6897",2018-01-06 06:55:18,363203.81,363203.809999998
"6898",2018-01-06 06:58:00,-363203.81,-1.57160684466362e-09
"6899",2018-01-06 07:53:44,167156.23,167156.229999998
"6900",2018-01-06 08:07:07,-167156.23,-1.57160684466362e-09
"6901",2018-01-06 08:38:47,395756.38,395756.379999998
"6902",2018-01-06 08:38:47,613532.31,1009288.69
"6903",2018-01-06 08:38:47,164145.37,1173434.06
"6904",2018-01-06 09:04:31,636108.79,1809542.85
"6905",2018-01-06 09:04:31,514747.05,2324289.9
"6906",2018-01-06 09:04:31,-1173434.06,1150855.84
"6907",2018-01-06 09:14:35,573179.13,1724034.97
"6908",2018-01-06 09:14:35,-1150855.84,573179.129999998
"6909",2018-01-06 09:27:14,-573179.13,-1.74622982740402e-09
"6910",2018-01-06 09:46:52,289201.95,289201.949999998
"6911",2018-01-06 09:46:52,226088.29,515290.239999998
"6912",2018-01-06 09:56:57,372824.34,888114.579999998
"6913",2018-01-06 09:56:57,-515290.24,372824.339999998
"6914",2018-01-06 10:08:30,470254.57,843078.909999998
"6915",2018-01-06 10:08:30,-372824.34,470254.569999998
"6916",2018-01-06 10:20:40,378565.93,848820.499999998
"6917",2018-01-06 10:20:40,-470254.57,378565.929999998
"6918",2018-01-06 10:25:07,463834.17,842400.099999998
"6919",2018-01-06 10:27:20,-842400.1,-1.74622982740402e-09
"6920",2018-01-06 11:08:35,546887.67,546887.669999998
"6921",2018-01-06 11:20:21,-546887.67,-1.74622982740402e-09
"6922",2018-01-06 12:06:45,347486.45,347486.449999998
"6923",2018-01-06 12:17:07,-347486.45,-1.74622982740402e-09
"6924",2018-01-06 14:22:05,512947.9,512947.899999998
"6925",2018-01-06 14:28:20,-512947.9,-1.74622982740402e-09
"6926",2018-01-06 15:29:21,451350.25,451350.249999998
"6927",2018-01-06 15:29:21,777915.24,1229265.49
"6928",2018-01-06 15:39:21,-1229265.49,-1.62981450557709e-09
"6929",2018-01-06 17:37:56,47857.22,47857.2199999984
"6930",2018-01-06 17:44:27,-47857.22,-1.62981450557709e-09
"6931",2018-01-06 22:24:34,777915.34,777915.339999998
"6932",2018-01-06 22:24:34,65619.35,843534.689999998
"6933",2018-01-06 22:39:39,-843534.69,-1.62981450557709e-09
"6934",2018-01-06 23:24:31,353828.71,353828.709999998
"6935",2018-01-06 23:45:49,-353828.71,-1.62981450557709e-09
"6936",2018-01-07 00:41:17,663590.79,663590.789999998
"6937",2018-01-07 00:44:52,-663590.79,-1.62981450557709e-09
"6938",2018-01-07 01:32:15,78099.42,78099.4199999984
"6939",2018-01-07 01:36:47,-78099.42,-1.62981450557709e-09
"6940",2018-01-07 04:31:37,192429.73,192429.729999998
"6941",2018-01-07 04:40:52,-192429.73,-1.62981450557709e-09
"6942",2018-01-07 06:07:15,109362.64,109362.639999998
"6943",2018-01-07 06:31:58,19698.07,129060.709999998
"6944",2018-01-07 06:31:58,795787.78,924848.489999998
"6945",2018-01-07 06:40:32,-109362.64,815485.849999998
"6946",2018-01-07 06:58:52,-815485.85,-1.62981450557709e-09
"6947",2018-01-07 08:06:38,179453.98,179453.979999998
"6948",2018-01-07 08:08:58,-179453.98,-1.62981450557709e-09
"6949",2018-01-07 08:53:38,398564.61,398564.609999998
"6950",2018-01-07 08:58:18,-398564.61,-1.62981450557709e-09
"6951",2018-01-07 16:11:00,75092.82,75092.8199999984
"6952",2018-01-07 16:14:40,-75092.82,-1.62981450557709e-09
"6953",2018-01-07 16:16:09,209020.57,209020.569999998
"6954",2018-01-07 16:53:50,-209020.57,-1.62981450557709e-09
"6955",2018-01-07 18:34:11,548995.99,548995.989999998
"6956",2018-01-07 18:48:37,539994.8,1088990.79
"6957",2018-01-07 18:48:37,-548995.99,539994.799999998
"6958",2018-01-07 19:02:55,-539994.8,-1.62981450557709e-09
"6959",2018-01-07 19:30:05,514980.08,514980.079999998
"6960",2018-01-07 19:42:14,-514980.08,-1.62981450557709e-09
"6961",2018-01-07 20:05:57,777916.54,777916.539999998
"6962",2018-01-07 20:07:19,54500.55,832417.089999998
"6963",2018-01-07 20:24:32,-777916.54,54500.5499999984
"6964",2018-01-07 20:38:09,-54500.55,-1.58615875989199e-09
"6965",2018-01-07 21:05:34,205612.98,205612.979999998
"6966",2018-01-07 21:25:54,-205612.98,-1.60071067512035e-09
"6967",2018-01-07 22:31:35,520224.42,520224.419999998
"6968",2018-01-07 22:37:34,-520224.42,-1.57160684466362e-09
"6969",2018-01-08 00:37:45,183146.31,183146.309999998
"6970",2018-01-08 00:45:53,-183146.31,-1.57160684466362e-09
"6971",2018-01-08 04:30:06,421978.27,421978.269999998
"6972",2018-01-08 04:39:23,-421978.27,-1.57160684466362e-09
"6973",2018-01-08 08:04:45,389648.71,389648.709999998
"6974",2018-01-08 08:10:41,-389648.71,-1.57160684466362e-09
"6975",2018-01-08 09:21:47,117288.73,117288.729999998
"6976",2018-01-08 09:41:24,94222.17,211510.899999998
"6977",2018-01-08 09:41:24,55839.9,267350.799999998
"6978",2018-01-08 09:41:24,186749.95,454100.749999998
"6979",2018-01-08 09:41:24,309506.39,763607.139999999
"6980",2018-01-08 09:41:24,15271.74,778878.879999998
"6981",2018-01-08 09:41:24,21781.64,800660.519999999
"6982",2018-01-08 09:41:24,-117288.73,683371.789999999
"6983",2018-01-08 09:49:16,-683371.79,-1.51339918375015e-09
"6984",2018-01-08 10:46:31,777918.48,777918.479999998
"6985",2018-01-08 10:46:31,133947.49,911865.969999998
"6986",2018-01-08 10:57:52,-911865.97,-1.51339918375015e-09
"6987",2018-01-08 11:18:17,286257.83,286257.829999999
"6988",2018-01-08 11:47:06,-286257.83,-1.51339918375015e-09
"6989",2018-01-08 13:54:50,777918.74,777918.739999998
"6990",2018-01-08 13:55:50,230567.75,1008486.49
"6991",2018-01-08 14:02:30,-777918.74,230567.749999998
"6992",2018-01-08 14:04:06,96296.33,326864.079999999
"6993",2018-01-08 14:04:06,22056.67,348920.749999998
"6994",2018-01-08 14:48:30,636720.83,985641.579999998
"6995",2018-01-08 14:48:30,108450.85,1094092.43
"6996",2018-01-08 14:48:30,111936.23,1206028.66
"6997",2018-01-08 14:48:30,777918.84,1983947.5
"6998",2018-01-08 14:48:30,180685.99,2164633.49
"6999",2018-01-08 14:48:30,-348920.75,1815712.74
"7000",2018-01-08 14:57:59,12092.69,1827805.43
"7001",2018-01-08 14:57:59,84655.85,1912461.28
"7002",2018-01-08 14:57:59,77876.43,1990337.71
"7003",2018-01-08 14:57:59,-1815712.74,174624.969999998
"7004",2018-01-08 15:01:15,777919.02,952543.989999998
"7005",2018-01-08 15:29:48,751853.11,1704397.1
"7006",2018-01-08 15:29:48,777919.1,2482316.2
"7007",2018-01-08 15:29:48,777919.08,3260235.28
"7008",2018-01-08 15:29:48,464075.09,3724310.37
"7009",2018-01-08 15:29:48,-952543.99,2771766.38
"7010",2018-01-08 15:38:00,-2771766.38,-1.86264514923096e-09
"7011",2018-01-08 15:40:59,14700.67,14700.6699999981
"7012",2018-01-08 15:55:57,34600.03,49300.6999999981
"7013",2018-01-08 15:55:57,-14700.67,34600.0299999981
"7014",2018-01-08 16:28:57,-34600.03,-1.86264514923096e-09
"7015",2018-01-08 17:25:26,161578.6,161578.599999998
"7016",2018-01-08 17:25:26,23502.28,185080.879999998
"7017",2018-01-08 17:25:26,67959.09,253039.969999998
"7018",2018-01-08 17:29:28,-253039.97,-1.86264514923096e-09
"7019",2018-01-08 18:58:03,360430.53,360430.529999998
"7020",2018-01-08 19:24:56,260823.49,621254.019999998
"7021",2018-01-08 19:24:56,26424.86,647678.879999998
"7022",2018-01-08 19:36:40,65915.01,713593.889999998
"7023",2018-01-08 19:36:40,83516.06,797109.949999998
"7024",2018-01-08 19:36:40,34392.16,831502.109999998
"7025",2018-01-08 19:40:23,-360430.53,471071.579999998
"7026",2018-01-08 19:53:54,-471071.58,-1.92085281014442e-09
"7027",2018-01-08 20:19:34,400587.02,400587.019999998
"7028",2018-01-08 20:35:17,777919.84,1178506.86
"7029",2018-01-08 20:35:17,171232.85,1349739.71
"7030",2018-01-08 20:35:17,-400587.02,949152.689999998
"7031",2018-01-08 20:48:00,-949152.69,-1.86264514923096e-09
"7032",2018-01-09 00:30:43,740491.01,740491.009999998
"7033",2018-01-09 00:30:43,777920,1518411.01
"7034",2018-01-09 00:43:46,-1518411.01,-1.86264514923096e-09
"7035",2018-01-09 01:31:24,960830.19,960830.189999998
"7036",2018-01-09 01:34:45,-960830.19,-1.86264514923096e-09
"7037",2018-01-09 01:49:31,53302.33,53302.3299999981
"7038",2018-01-09 01:49:31,48376.96,101679.289999998
"7039",2018-01-09 01:49:31,777920.1,879599.389999998
"7040",2018-01-09 01:49:31,640681.38,1520280.77
"7041",2018-01-09 01:49:31,238640.11,1758920.88
"7042",2018-01-09 01:49:31,50743.86,1809664.74
"7043",2018-01-09 01:49:31,29265.45,1838930.19
"7044",2018-01-09 01:49:31,727271.19,2566201.38
"7045",2018-01-09 01:49:31,34029.7,2600231.08
"7046",2018-01-09 01:49:31,34074.4,2634305.48
"7047",2018-01-09 01:49:31,16304.96,2650610.44
"7048",2018-01-09 01:58:34,-2650610.44,-1.86264514923096e-09
"7049",2018-01-09 02:12:23,487883.28,487883.279999998
"7050",2018-01-09 02:12:23,926557.75,1414441.03
"7051",2018-01-09 02:17:19,-1414441.03,-1.86264514923096e-09
"7052",2018-01-09 04:22:04,68161.97,68161.9699999981
"7053",2018-01-09 04:27:30,-68161.97,-1.86264514923096e-09
"7054",2018-01-09 04:34:38,185204.68,185204.679999998
"7055",2018-01-09 04:50:36,208837.13,394041.809999998
"7056",2018-01-09 04:50:36,-185204.68,208837.129999998
"7057",2018-01-09 04:59:57,22641.43,231478.559999998
"7058",2018-01-09 04:59:57,94465.01,325943.569999998
"7059",2018-01-09 04:59:57,16240.94,342184.509999998
"7060",2018-01-09 04:59:57,-208837.13,133347.379999998
"7061",2018-01-09 05:16:02,416107.06,549454.439999998
"7062",2018-01-09 05:17:14,-133347.38,416107.059999998
"7063",2018-01-09 05:22:37,343004.28,759111.339999998
"7064",2018-01-09 05:33:49,-416107.06,343004.279999998
"7065",2018-01-09 05:48:15,417465.97,760470.249999998
"7066",2018-01-09 05:48:15,-343004.28,417465.969999998
"7067",2018-01-09 05:53:05,431522.91,848988.879999998
"7068",2018-01-09 06:22:40,139304.62,988293.499999998
"7069",2018-01-09 06:22:40,24563.34,1012856.84
"7070",2018-01-09 06:22:40,217834.87,1230691.71
"7071",2018-01-09 06:22:40,-417465.97,813225.739999998
"7072",2018-01-09 06:33:29,94369.67,907595.409999998
"7073",2018-01-09 06:33:29,-813225.74,94369.6699999982
"7074",2018-01-09 06:45:59,-94369.67,-1.81898940354586e-09
"7075",2018-01-09 07:16:29,269087.15,269087.149999998
"7076",2018-01-09 07:23:57,-269087.15,-1.80443748831749e-09
"7077",2018-01-09 09:39:48,475397.27,475397.269999998
"7078",2018-01-09 09:44:58,-475397.27,-1.80443748831749e-09
"7079",2018-01-09 10:00:22,155467.62,155467.619999998
"7080",2018-01-09 10:06:36,-155467.62,-1.80443748831749e-09
"7081",2018-01-09 10:57:22,1751213.43,1751213.43
"7082",2018-01-09 11:11:10,-1751213.43,-1.86264514923096e-09
"7083",2018-01-09 11:34:07,366086.58,366086.579999998
"7084",2018-01-09 11:38:33,-366086.58,-1.86264514923096e-09
"7085",2018-01-09 12:55:36,158651.91,158651.909999998
"7086",2018-01-09 13:05:37,-158651.91,-1.86264514923096e-09
"7087",2018-01-09 13:25:22,190955.55,190955.549999998
"7088",2018-01-09 13:25:22,20776.24,211731.789999998
"7089",2018-01-09 13:25:22,285369.75,497101.539999998
"7090",2018-01-09 13:30:57,303708.9,800810.439999998
"7091",2018-01-09 13:30:57,339197.07,1140007.51
"7092",2018-01-09 13:30:57,-497101.54,642905.969999998
"7093",2018-01-09 13:34:37,429384.23,1072290.2
"7094",2018-01-09 13:52:21,396578.42,1468868.62
"7095",2018-01-09 13:52:21,-642905.97,825962.649999998
"7096",2018-01-09 14:07:43,91557.73,917520.379999998
"7097",2018-01-09 14:07:43,-825962.65,91557.729999998
"7098",2018-01-09 14:36:39,-91557.73,-1.99361238628626e-09
"7099",2018-01-09 15:21:13,16749.57,16749.569999998
"7100",2018-01-09 15:30:00,-16749.57,-1.99361238628626e-09
"7101",2018-01-09 16:37:57,276376.62,276376.619999998
"7102",2018-01-09 17:44:56,-276376.62,-1.97906047105789e-09
"7103",2018-01-09 20:01:56,40199.84,40199.839999998
"7104",2018-01-09 20:08:12,371867.99,412067.829999998
"7105",2018-01-09 20:11:11,-40199.84,371867.989999998
"7106",2018-01-09 20:27:42,-371867.99,-1.97906047105789e-09
"7107",2018-01-09 22:55:49,772603.06,772603.059999998
"7108",2018-01-09 23:04:38,-772603.06,-1.97906047105789e-09
"7109",2018-01-09 23:34:26,662984.59,662984.589999998
"7110",2018-01-09 23:37:18,-662984.59,-1.97906047105789e-09
"7111",2018-01-10 01:13:49,36196.53,36196.529999998
"7112",2018-01-10 01:13:49,101717.35,137913.879999998
"7113",2018-01-10 01:18:24,-137913.88,-1.97906047105789e-09
"7114",2018-01-10 03:45:53,601452.18,601452.179999998
"7115",2018-01-10 03:58:37,-601452.18,-1.97906047105789e-09
"7116",2018-01-10 05:05:41,566638.61,566638.609999998
"7117",2018-01-10 05:05:41,671299.06,1237937.67
"7118",2018-01-10 05:19:00,656481.82,1894419.49
"7119",2018-01-10 05:19:00,-1237937.67,656481.819999998
"7120",2018-01-10 05:35:29,466263.91,1122745.73
"7121",2018-01-10 05:35:29,-656481.82,466263.909999998
"7122",2018-01-10 05:45:18,469225.77,935489.679999998
"7123",2018-01-10 05:45:18,598751.44,1534241.12
"7124",2018-01-10 05:45:18,-466263.91,1067977.21
"7125",2018-01-10 05:52:48,87142.53,1155119.74
"7126",2018-01-10 05:52:48,-1067977.21,87142.5299999979
"7127",2018-01-10 06:02:30,362809.81,449952.339999998
"7128",2018-01-10 06:02:30,623384.48,1073336.82
"7129",2018-01-10 06:02:30,264815.82,1338152.64
"7130",2018-01-10 06:02:30,202773.26,1540925.9
"7131",2018-01-10 06:02:30,-87142.53,1453783.37
"7132",2018-01-10 06:11:17,413522.04,1867305.41
"7133",2018-01-10 06:11:17,-1453783.37,413522.039999998
"7134",2018-01-10 06:11:32,583513.17,997035.209999998
"7135",2018-01-10 06:22:53,380606.23,1377641.44
"7136",2018-01-10 06:22:53,254527.3,1632168.74
"7137",2018-01-10 06:22:53,-997035.21,635133.529999998
"7138",2018-01-10 06:56:07,-635133.53,-1.86264514923096e-09
"7139",2018-01-10 07:29:58,748606.54,748606.539999998
"7140",2018-01-10 07:29:58,777923.79,1526530.33
"7141",2018-01-10 07:29:58,399004.8,1925535.13
"7142",2018-01-10 07:47:10,-1925535.13,-1.62981450557709e-09
"7143",2018-01-10 08:22:42,464648.19,464648.189999998
"7144",2018-01-10 08:30:23,-464648.19,-1.62981450557709e-09
"7145",2018-01-10 10:51:22,134604.11,134604.109999998
"7146",2018-01-10 11:02:51,-134604.11,-1.62981450557709e-09
"7147",2018-01-10 12:05:17,23904.7,23904.6999999984
"7148",2018-01-10 12:17:54,-23904.7,-1.62981450557709e-09
"7149",2018-01-10 13:13:10,319638.08,319638.079999998
"7150",2018-01-10 13:16:57,53909.6,373547.679999998
"7151",2018-01-10 13:16:57,115773.07,489320.749999998
"7152",2018-01-10 13:16:57,-319638.08,169682.669999998
"7153",2018-01-10 13:20:59,514722.6,684405.269999998
"7154",2018-01-10 13:35:52,-684405.27,-1.62981450557709e-09
"7155",2018-01-10 14:41:38,577748.72,577748.719999998
"7156",2018-01-10 14:54:11,-577748.72,-1.62981450557709e-09
"7157",2018-01-10 15:08:49,395099.95,395099.949999998
"7158",2018-01-10 15:22:21,-395099.95,-1.62981450557709e-09
"7159",2018-01-10 16:20:21,207610.85,207610.849999998
"7160",2018-01-10 16:29:57,-207610.85,-1.62981450557709e-09
"7161",2018-01-10 17:16:14,516155.85,516155.849999998
"7162",2018-01-10 17:22:53,-516155.85,-1.62981450557709e-09
"7163",2018-01-10 18:07:10,89228.19,89228.1899999984
"7164",2018-01-10 18:07:10,29392.3,118620.489999998
"7165",2018-01-10 18:14:33,-118620.49,-1.62981450557709e-09
"7166",2018-01-10 21:18:31,209332.43,209332.429999998
"7167",2018-01-10 21:42:21,-209332.43,-1.62981450557709e-09
"7168",2018-01-10 21:58:27,670528.84,670528.839999998
"7169",2018-01-10 22:12:17,-670528.84,-1.62981450557709e-09
"7170",2018-01-10 22:33:39,491550.31,491550.309999998
"7171",2018-01-10 22:48:50,-491550.31,-1.62981450557709e-09
"7172",2018-01-10 23:06:42,365036.35,365036.349999998
"7173",2018-01-10 23:06:42,346068.65,711104.999999998
"7174",2018-01-10 23:34:00,398328.1,1109433.1
"7175",2018-01-10 23:34:00,-711105,398328.099999998
"7176",2018-01-10 23:51:45,-398328.1,-1.74622982740402e-09
"7177",2018-01-11 00:26:59,490758.94,490758.939999998
"7178",2018-01-11 00:31:02,-490758.94,-1.74622982740402e-09
"7179",2018-01-11 01:06:53,560170.89,560170.889999998
"7180",2018-01-11 01:22:03,-560170.89,-1.74622982740402e-09
"7181",2018-01-11 02:04:09,434365.99,434365.989999998
"7182",2018-01-11 02:12:25,-434365.99,-1.74622982740402e-09
"7183",2018-01-11 02:52:52,754668.73,754668.729999998
"7184",2018-01-11 03:04:48,-754668.73,-1.74622982740402e-09
"7185",2018-01-11 03:36:10,82461.97,82461.9699999983
"7186",2018-01-11 03:36:10,501692.15,584154.119999998
"7187",2018-01-11 03:36:10,794165.54,1378319.66
"7188",2018-01-11 03:45:26,211321.38,1589641.04
"7189",2018-01-11 03:45:26,131392.2,1721033.24
"7190",2018-01-11 03:45:26,136508.13,1857541.37
"7191",2018-01-11 03:45:26,-1378319.66,479221.709999998
"7192",2018-01-11 03:50:15,-479221.71,-1.68802216649055e-09
"7193",2018-01-11 04:05:11,1358976.8,1358976.8
"7194",2018-01-11 04:09:12,777925.51,2136902.31
"7195",2018-01-11 04:09:12,-1358976.8,777925.509999999
"7196",2018-01-11 04:10:22,144547.52,922473.029999999
"7197",2018-01-11 04:21:00,-922473.03,-1.39698386192322e-09
"7198",2018-01-11 04:33:09,777925.58,777925.579999999
"7199",2018-01-11 04:33:09,176228.85,954154.429999999
"7200",2018-01-11 04:33:09,659056.91,1613211.34
"7201",2018-01-11 04:33:09,9171.59,1622382.93
"7202",2018-01-11 04:33:09,41157.77,1663540.7
"7203",2018-01-11 04:33:09,279950.52,1943491.22
"7204",2018-01-11 04:41:33,590163.66,2533654.88
"7205",2018-01-11 04:41:33,777925.65,3311580.53
"7206",2018-01-11 04:41:33,19233.7,3330814.23
"7207",2018-01-11 04:41:33,777925.64,4108739.87
"7208",2018-01-11 04:41:33,-1943491.22,2165248.65
"7209",2018-01-11 05:28:34,98714.55,2263963.2
"7210",2018-01-11 05:28:34,-2165248.65,98714.5499999984
"7211",2018-01-11 05:38:30,462286.64,561001.189999998
"7212",2018-01-11 06:02:41,777925.9,1338927.09
"7213",2018-01-11 06:02:41,777925.89,2116852.98
"7214",2018-01-11 06:02:41,427401.91,2544254.89
"7215",2018-01-11 06:02:41,-561001.19,1983253.7
"7216",2018-01-11 06:08:52,734401.82,2717655.52
"7217",2018-01-11 06:17:24,-1983253.7,734401.819999999
"7218",2018-01-11 06:30:29,-734401.82,-1.28056854009628e-09
"7219",2018-01-11 07:09:39,451150.03,451150.029999999
"7220",2018-01-11 07:15:23,777926.02,1229076.05
"7221",2018-01-11 07:15:23,-451150.03,777926.019999999
"7222",2018-01-11 07:21:49,-777926.02,-1.16415321826935e-09
"7223",2018-01-11 07:33:54,270857.48,270857.479999999
"7224",2018-01-11 07:33:54,152881.47,423738.949999999
"7225",2018-01-11 07:52:14,-423738.95,-1.22236087918282e-09
"7226",2018-01-11 08:43:18,536929.24,536929.239999999
"7227",2018-01-11 08:51:19,-536929.24,-1.16415321826935e-09
"7228",2018-01-11 08:52:37,261527.68,261527.679999999
"7229",2018-01-11 08:57:40,436898.77,698426.449999999
"7230",2018-01-11 08:57:40,340185.64,1038612.09
"7231",2018-01-11 08:57:40,-261527.68,777084.409999999
"7232",2018-01-11 09:08:08,-777084.41,-1.28056854009628e-09
"7233",2018-01-11 12:29:34,563259.58,563259.579999999
"7234",2018-01-11 12:59:23,-563259.58,-1.28056854009628e-09
"7235",2018-01-11 20:00:30,401241.99,401241.989999999
"7236",2018-01-11 20:04:28,320241.76,721483.749999999
"7237",2018-01-11 20:04:28,-401241.99,320241.759999999
"7238",2018-01-11 20:06:36,514018.89,834260.649999999
"7239",2018-01-11 20:06:36,777926.88,1612187.53
"7240",2018-01-11 20:30:38,-320241.76,1291945.77
"7241",2018-01-11 20:42:13,385268.91,1677214.68
"7242",2018-01-11 20:42:13,424093.18,2101307.86
"7243",2018-01-11 20:42:13,-1291945.77,809362.089999999
"7244",2018-01-11 20:42:13,401242.09,1210604.18
"7245",2018-01-11 20:50:12,169311.98,1379916.16
"7246",2018-01-11 20:50:12,180746.72,1560662.88
"7247",2018-01-11 20:50:12,-1210604.18,350058.699999999
"7248",2018-01-11 20:54:14,-350058.7,-9.89530235528946e-10
"7249",2018-01-11 22:23:21,196179.8,196179.799999999
"7250",2018-01-11 22:30:28,-196179.8,-9.89530235528946e-10
"7251",2018-01-11 23:34:15,331714.06,331714.059999999
"7252",2018-01-11 23:34:15,25355.23,357069.289999999
"7253",2018-01-11 23:34:15,412048.95,769118.239999999
"7254",2018-01-11 23:56:21,-769118.24,-9.31322574615479e-10
"7255",2018-01-12 00:03:46,203821.79,203821.789999999
"7256",2018-01-12 00:12:00,-203821.79,-9.31322574615479e-10
"7257",2018-01-12 00:57:25,697361.23,697361.229999999
"7258",2018-01-12 00:57:25,777927.22,1475288.45
"7259",2018-01-12 01:03:56,-1475288.45,-9.31322574615479e-10
"7260",2018-01-12 01:43:52,420836.13,420836.129999999
"7261",2018-01-12 01:47:28,-420836.13,-9.31322574615479e-10
"7262",2018-01-12 02:57:44,1047057.7,1047057.7
"7263",2018-01-12 03:01:43,-1047057.7,-9.31322574615479e-10
"7264",2018-01-12 11:03:32,592859.53,592859.529999999
"7265",2018-01-12 11:08:13,-592859.53,-9.31322574615479e-10
"7266",2018-01-12 13:09:52,416634.3,416634.299999999
"7267",2018-01-12 13:16:23,599425.11,1016059.41
"7268",2018-01-12 13:16:23,-416634.3,599425.109999999
"7269",2018-01-12 13:22:04,-599425.11,-1.04773789644241e-09
"7270",2018-01-12 13:39:33,134268.03,134268.029999999
"7271",2018-01-12 13:39:33,1460066.22,1594334.25
"7272",2018-01-12 13:48:20,-1594334.25,-1.16415321826935e-09
"7273",2018-01-12 16:19:44,643348.15,643348.149999999
"7274",2018-01-12 16:22:58,-643348.15,-1.16415321826935e-09
"7275",2018-01-13 06:47:58,696573.92,696573.919999999
"7276",2018-01-13 06:52:25,-696573.92,-1.16415321826935e-09
"7277",2018-01-13 07:22:20,777927.94,777927.939999999
"7278",2018-01-13 07:22:20,121025.95,898953.889999999
"7279",2018-01-13 07:32:42,-898953.89,-1.28056854009628e-09
"7280",2018-01-13 08:35:05,427032.92,427032.919999999
"7281",2018-01-13 08:47:54,-427032.92,-1.28056854009628e-09
"7282",2018-01-13 08:51:50,463204.76,463204.759999999
"7283",2018-01-13 08:58:12,-463204.76,-1.28056854009628e-09
"7284",2018-01-13 11:05:34,417523.12,417523.119999999
"7285",2018-01-13 11:05:34,777928.11,1195451.23
"7286",2018-01-13 11:10:10,-1195451.23,-1.39698386192322e-09
"7287",2018-01-13 12:27:32,777928.15,777928.149999999
"7288",2018-01-13 12:29:34,685833.16,1463761.31
"7289",2018-01-13 12:53:19,-1463761.31,-1.39698386192322e-09
"7290",2018-01-13 13:27:07,777928.22,777928.219999999
"7291",2018-01-13 13:27:07,777928.21,1555856.43
"7292",2018-01-13 13:27:07,225808.23,1781664.66
"7293",2018-01-13 13:33:54,-1781664.66,-1.39698386192322e-09
"7294",2018-01-13 13:51:31,777928.31,777928.309999999
"7295",2018-01-13 14:12:01,412016.32,1189944.63
"7296",2018-01-13 14:12:01,-777928.31,412016.319999999
"7297",2018-01-13 14:23:21,-412016.32,-1.33877620100975e-09
"7298",2018-01-13 16:11:46,669369.91,669369.909999999
"7299",2018-01-13 16:25:12,-669369.91,-1.28056854009628e-09
"7300",2018-01-13 16:30:55,1162668.13,1162668.13
"7301",2018-01-13 16:37:11,-1162668.13,-1.39698386192322e-09
"7302",2018-01-13 19:05:57,1066001.36,1066001.36
"7303",2018-01-13 19:26:36,-1066001.36,-1.39698386192322e-09
"7304",2018-01-14 00:52:37,612645.85,612645.849999999
"7305",2018-01-14 00:52:37,768204.45,1380850.3
"7306",2018-01-14 00:57:35,-1380850.3,-1.62981450557709e-09
"7307",2018-01-14 05:39:14,1777928.83,1777928.83
"7308",2018-01-14 05:39:14,323087.84,2101016.67
"7309",2018-01-14 05:44:08,-2101016.67,-1.39698386192322e-09
"7310",2018-01-14 12:17:44,814975.24,814975.239999999
"7311",2018-01-14 12:27:47,1170659.48,1985634.72
"7312",2018-01-14 12:27:47,-814975.24,1170659.48
"7313",2018-01-14 12:43:36,996388.28,2167047.76
"7314",2018-01-14 12:43:36,-1170659.48,996388.279999999
"7315",2018-01-14 12:56:44,-996388.28,-1.16415321826935e-09
"7316",2018-01-14 15:40:11,777930.27,777930.269999999
"7317",2018-01-14 15:48:52,-777930.27,-1.16415321826935e-09
"7318",2018-01-14 19:37:58,1777931.93,1777931.93
"7319",2018-01-14 19:37:58,725309.95,2503241.88
"7320",2018-01-14 19:37:58,1777931.94,4281173.82
"7321",2018-01-14 19:40:46,-4281173.82,-1.86264514923096e-09
"7322",2018-01-14 20:34:44,1467511.43,1467511.43
"7323",2018-01-14 20:40:50,-1467511.43,-1.86264514923096e-09
"7324",2018-01-14 23:15:58,335574.42,335574.419999998
"7325",2018-01-14 23:28:36,108249.85,443824.269999998
"7326",2018-01-14 23:28:36,458729.72,902553.989999998
"7327",2018-01-14 23:28:36,-335574.42,566979.569999998
"7328",2018-01-14 23:34:09,-566979.57,-1.74622982740402e-09
"7329",2018-01-15 02:38:58,505200.04,505200.039999998
"7330",2018-01-15 02:51:39,338700.4,843900.439999998
"7331",2018-01-15 02:51:39,-505200.04,338700.399999998
"7332",2018-01-15 03:22:09,-338700.4,-1.68802216649055e-09
"7333",2018-01-15 04:03:12,1179332.93,1179332.93
"7334",2018-01-15 04:46:56,-1179332.93,-1.62981450557709e-09
"7335",2018-01-15 05:35:55,539897.88,539897.879999998
"7336",2018-01-15 06:03:57,-539897.88,-1.62981450557709e-09
"7337",2018-01-15 06:33:22,785749.18,785749.179999998
"7338",2018-01-15 06:40:15,-785749.18,-1.62981450557709e-09
"7339",2018-01-15 07:55:20,1064751.3,1064751.3
"7340",2018-01-15 08:18:29,615254.89,1680006.19
"7341",2018-01-15 08:18:29,633832.06,2313838.25
"7342",2018-01-15 08:18:29,-1064751.3,1249086.95
"7343",2018-01-15 08:22:08,843030.37,2092117.32
"7344",2018-01-15 08:26:59,-2092117.32,-1.62981450557709e-09
"7345",2018-01-15 09:25:36,170795.8,170795.799999998
"7346",2018-01-15 09:28:56,-170795.8,-1.62981450557709e-09
"7347",2018-01-15 11:43:10,889044.14,889044.139999998
"7348",2018-01-15 11:43:10,889044.18,1778088.32
"7349",2018-01-15 11:43:10,889044.19,2667132.51
"7350",2018-01-15 11:55:10,-2667132.51,-1.39698386192322e-09
"7351",2018-01-15 14:09:28,1031187.26,1031187.26
"7352",2018-01-15 14:09:28,1777934.31,2809121.57
"7353",2018-01-15 14:09:28,669385.33,3478506.9
"7354",2018-01-15 14:09:28,1777934.32,5256441.22
"7355",2018-01-15 14:33:33,-5256441.22,-9.31322574615479e-10
"7356",2018-01-15 16:40:07,763007.2,763007.199999999
"7357",2018-01-15 16:52:17,-763007.2,-9.31322574615479e-10
"7358",2018-01-15 17:32:23,734192.74,734192.739999999
"7359",2018-01-15 17:52:07,-734192.74,-9.31322574615479e-10
"7360",2018-01-15 19:21:08,727771.69,727771.689999999
"7361",2018-01-15 19:31:19,-727771.69,-9.31322574615479e-10
"7362",2018-01-15 20:21:18,732909.41,732909.409999999
"7363",2018-01-15 20:41:22,-732909.41,-9.31322574615479e-10
"7364",2018-01-16 00:31:16,1394646.24,1394646.24
"7365",2018-01-16 00:36:03,194581.82,1589228.06
"7366",2018-01-16 00:36:03,-1394646.24,194581.819999999
"7367",2018-01-16 01:08:38,1652225.35,1846807.17
"7368",2018-01-16 01:08:38,-194581.82,1652225.35
"7369",2018-01-16 01:18:53,-1652225.35,-9.31322574615479e-10
"7370",2018-01-16 02:42:34,1439408.78,1439408.78
"7371",2018-01-16 02:57:40,-1439408.78,-9.31322574615479e-10
"7372",2018-01-16 06:25:50,910217.45,910217.449999999
"7373",2018-01-16 07:08:40,1020991.24,1931208.69
"7374",2018-01-16 07:08:40,-910217.45,1020991.24
"7375",2018-01-16 07:18:27,-1020991.24,-9.31322574615479e-10
"7376",2018-01-16 08:14:37,1214887.22,1214887.22
"7377",2018-01-16 09:08:53,553705.02,1768592.24
"7378",2018-01-16 09:08:53,215960.82,1984553.06
"7379",2018-01-16 09:08:53,25833.1,2010386.16
"7380",2018-01-16 09:08:53,24529.64,2034915.8
"7381",2018-01-16 09:08:53,806913.24,2841829.04
"7382",2018-01-16 09:08:53,-1214887.22,1626941.82
"7383",2018-01-16 10:02:36,28272.92,1655214.74
"7384",2018-01-16 10:02:36,1777935.17,3433149.91
"7385",2018-01-16 10:02:36,468399.18,3901549.09
"7386",2018-01-16 10:02:36,-1626941.82,2274607.27
"7387",2018-01-16 10:25:55,-2274607.27,-4.65661287307739e-10
"7388",2018-01-16 10:59:01,191839.38,191839.38
"7389",2018-01-16 11:09:17,-191839.38,-4.65661287307739e-10
"7390",2018-01-16 12:33:48,498884.98,498884.98
"7391",2018-01-16 13:04:38,457332.67,956217.649999999
"7392",2018-01-16 13:04:38,446189.38,1402407.03
"7393",2018-01-16 13:04:38,-498884.98,903522.049999999
"7394",2018-01-16 13:12:27,-903522.05,-6.98491930961609e-10
"7395",2018-01-16 13:39:07,749012.56,749012.559999999
"7396",2018-01-16 13:58:13,1552356.25,2301368.81
"7397",2018-01-16 13:58:13,-749012.56,1552356.25
"7398",2018-01-16 14:09:38,-1552356.25,-4.65661287307739e-10
"7399",2018-01-16 14:38:20,1777935.64,1777935.64
"7400",2018-01-16 14:38:20,191707.65,1969643.29
"7401",2018-01-16 14:39:55,840106.62,2809749.91
"7402",2018-01-16 14:43:33,-1969643.29,840106.619999999
"7403",2018-01-16 14:54:22,-840106.62,-8.14907252788544e-10
"7404",2018-01-16 17:04:19,522526.93,522526.929999999
"7405",2018-01-16 17:04:19,129610.98,652137.909999999
"7406",2018-01-16 17:06:59,16121.23,668259.139999999
"7407",2018-01-16 17:09:45,-652137.91,16121.2299999992
"7408",2018-01-16 17:17:30,-16121.23,-8.33097146824002e-10
"7409",2018-01-16 17:31:16,971882.79,971882.789999999
"7410",2018-01-16 17:37:32,-971882.79,-8.14907252788544e-10
"7411",2018-01-16 18:01:01,277107.92,277107.919999999
"7412",2018-01-16 18:01:01,1777935.91,2055043.83
"7413",2018-01-16 18:05:38,-2055043.83,-9.31322574615479e-10
"7414",2018-01-16 18:20:38,55401.96,55401.9599999991
"7415",2018-01-16 18:20:38,1777935.95,1833337.91
"7416",2018-01-16 18:22:16,24999.47,1858337.38
"7417",2018-01-16 18:32:03,913133.32,2771470.7
"7418",2018-01-16 18:32:03,15660.25,2787130.95
"7419",2018-01-16 18:32:03,504101.85,3291232.8
"7420",2018-01-16 18:32:03,-1833337.91,1457894.89
"7421",2018-01-16 18:40:45,1334220.33,2792115.22
"7422",2018-01-16 18:40:45,-1457894.89,1334220.33
"7423",2018-01-16 18:49:23,-1334220.33,-1.16415321826935e-09
"7424",2018-01-16 19:08:51,984840.03,984840.029999999
"7425",2018-01-16 19:12:42,881269.26,1866109.29
"7426",2018-01-16 19:12:42,-984840.03,881269.259999999
"7427",2018-01-16 19:33:00,995155.02,1876424.28
"7428",2018-01-16 19:33:00,-881269.26,995155.019999999
"7429",2018-01-16 19:45:02,-995155.02,-1.16415321826935e-09
"7430",2018-01-16 21:55:24,889048.33,889048.329999999
"7431",2018-01-16 23:07:20,889049.15,1778097.48
"7432",2018-01-16 23:21:40,943167.5,2721264.98
"7433",2018-01-16 23:56:37,1777938.23,4499203.21
"7434",2018-01-16 23:56:37,1777938.22,6277141.43
"7435",2018-01-16 23:56:37,129931.24,6407072.67
"7436",2018-01-17 00:25:14,1198733.23,7605805.9
"7437",2018-01-17 08:53:55,-7605805.9,-1.86264514923096e-09
"7438",2018-01-17 17:03:41,3485547.15,3485547.15
"7439",2018-01-17 17:13:33,900786.58,4386333.73
"7440",2018-01-17 17:13:33,-3485547.15,900786.579999998
"7441",2018-01-17 17:19:00,-900786.58,-2.21189111471176e-09
"7442",2018-01-17 20:37:10,1777940.95,1777940.95
"7443",2018-01-17 20:37:10,1777940.94,3555881.89
"7444",2018-01-17 20:37:10,608309.96,4164191.85
"7445",2018-01-17 20:58:16,-4164191.85,-2.3283064365387e-09
"7446",2018-01-17 23:06:11,4524934.48,4524934.48
"7447",2018-01-17 23:12:13,-4524934.48,-1.86264514923096e-09
"7448",2018-01-17 23:18:32,1308440.87,1308440.87
"7449",2018-01-17 23:24:38,715760.13,2024201
"7450",2018-01-17 23:24:38,1777941.12,3802142.12
"7451",2018-01-17 23:24:38,-1308440.87,2493701.25
"7452",2018-01-17 23:37:38,-2493701.25,-1.86264514923096e-09
"7453",2018-01-18 02:05:37,1777941.21,1777941.21
"7454",2018-01-18 02:05:37,797863.22,2575804.43
"7455",2018-01-18 02:16:54,-2575804.43,-2.3283064365387e-09
"7456",2018-01-18 02:59:52,919920.26,919920.259999998
"7457",2018-01-18 02:59:52,1777941.25,2697861.51
"7458",2018-01-18 03:03:02,-2697861.51,-1.86264514923096e-09
"7459",2018-01-18 03:47:44,486087.28,486087.279999998
"7460",2018-01-18 03:47:44,1777941.27,2264028.55
"7461",2018-01-18 03:55:25,-2264028.55,-1.86264514923096e-09
"7462",2018-01-18 04:15:33,1777941.34,1777941.34
"7463",2018-01-18 04:15:33,472093.36,2250034.7
"7464",2018-01-18 04:15:33,1777941.35,4027976.05
"7465",2018-01-18 04:22:47,-4027976.05,-1.39698386192322e-09
"7466",2018-01-18 04:51:15,1777941.37,1777941.37
"7467",2018-01-18 04:51:15,1777941.38,3555882.75
"7468",2018-01-18 04:57:03,-3555882.75,-1.39698386192322e-09
"7469",2018-01-18 05:13:12,90076.39,90076.3899999986
"7470",2018-01-18 05:34:55,1777941.43,1868017.82
"7471",2018-01-18 05:34:55,1777941.44,3645959.26
"7472",2018-01-18 05:34:55,272475.45,3918434.71
"7473",2018-01-18 05:34:55,-90076.39,3828358.32
"7474",2018-01-18 05:42:02,-3828358.32,-1.39698386192322e-09
"7475",2018-01-18 06:14:15,1777941.52,1777941.52
"7476",2018-01-18 06:15:55,365811.53,2143753.05
"7477",2018-01-18 06:27:58,-1777941.52,365811.529999999
"7478",2018-01-18 06:57:49,-365811.53,-1.16415321826935e-09
"7479",2018-01-18 07:53:53,1777941.56,1777941.56
"7480",2018-01-18 07:58:53,1139747.57,2917689.13
"7481",2018-01-18 07:58:53,-1777941.56,1139747.57
"7482",2018-01-18 08:08:27,-1139747.57,-1.16415321826935e-09
"7483",2018-01-18 08:37:44,1759063.6,1759063.6
"7484",2018-01-18 08:37:44,1777941.59,3537005.19
"7485",2018-01-18 08:56:24,-3537005.19,-9.31322574615479e-10
"7486",2018-01-18 11:11:23,1777941.75,1777941.75
"7487",2018-01-18 11:11:23,1641324.76,3419266.51
"7488",2018-01-18 11:18:11,-3419266.51,-9.31322574615479e-10
"7489",2018-01-18 12:12:07,1777941.84,1777941.84
"7490",2018-01-18 12:12:07,1767381.85,3545323.69
"7491",2018-01-18 12:27:22,-3545323.69,-4.65661287307739e-10
"7492",2018-01-18 15:40:30,68850.35,68850.3499999995
"7493",2018-01-18 15:44:45,-68850.35,-4.65661287307739e-10
"7494",2018-01-18 17:07:34,1777942.95,1777942.95
"7495",2018-01-18 17:07:34,1777942.96,3555885.91
"7496",2018-01-18 17:07:34,1777942.97,5333828.88
"7497",2018-01-18 17:08:45,1777942.94,7111771.82
"7498",2018-01-18 17:17:13,1777942.93,8889714.75
"7499",2018-01-18 17:17:13,-5333828.88,3555885.87
"7500",2018-01-18 17:37:50,280318.98,3836204.85
"7501",2018-01-18 17:37:50,-3555885.87,280318.979999998
"7502",2018-01-18 17:51:55,-280318.98,-1.86264514923096e-09
"7503",2018-01-18 18:43:09,1431311.06,1431311.06
"7504",2018-01-18 18:43:09,1777943.05,3209254.11
"7505",2018-01-18 18:48:24,-3209254.11,-1.39698386192322e-09
"7506",2018-01-18 19:05:16,1777943.1,1777943.1
"7507",2018-01-18 19:05:16,790448.11,2568391.21
"7508",2018-01-18 19:25:23,-2568391.21,-1.39698386192322e-09
"7509",2018-01-18 20:24:39,1777943.18,1777943.18
"7510",2018-01-18 20:24:39,966379.19,2744322.37
"7511",2018-01-18 20:30:07,-2744322.37,-1.86264514923096e-09
"7512",2018-01-18 21:44:52,765317.17,765317.169999998
"7513",2018-01-18 21:44:52,445787.82,1211104.99
"7514",2018-01-18 21:44:52,777942.83,1989047.82
"7515",2018-01-18 21:44:52,150395.89,2139443.71
"7516",2018-01-18 21:53:29,-2139443.71,-1.86264514923096e-09
"7517",2018-01-18 22:20:04,2664670.37,2664670.37
"7518",2018-01-18 22:34:15,-2664670.37,-1.86264514923096e-09
"7519",2018-01-18 23:29:20,1777943.28,1777943.28
"7520",2018-01-18 23:29:20,1584417.29,3362360.57
"7521",2018-01-18 23:34:12,-3362360.57,-1.39698386192322e-09
"7522",2018-01-18 23:36:14,1777943.32,1777943.32
"7523",2018-01-18 23:46:51,129763.33,1907706.65
"7524",2018-01-18 23:46:51,-1777943.32,129763.329999999
"7525",2018-01-19 00:11:22,-129763.33,-1.32422428578138e-09
"7526",2018-01-19 06:04:12,1777944.91,1777944.91
"7527",2018-01-19 06:30:45,777944.99,2555889.9
"7528",2018-01-19 06:30:45,777945,3333834.9
"7529",2018-01-19 06:30:45,-1777944.91,1555889.99
"7530",2018-01-19 06:52:25,-1555889.99,-1.39698386192322e-09
"7531",2018-01-19 14:49:33,1111285.67,1111285.67
"7532",2018-01-19 15:36:58,1777948.63,2889234.3
"7533",2018-01-19 15:36:58,1374591.24,4263825.54
"7534",2018-01-19 15:36:58,1161227.03,5425052.57
"7535",2018-01-19 15:36:58,1777777.01,7202829.58
"7536",2018-01-19 15:36:58,1777948.66,8980778.24
"7537",2018-01-19 15:36:58,1777948.62,10758726.86
"7538",2018-01-19 15:36:58,1777948.65,12536675.51
"7539",2018-01-19 15:36:58,1777777.02,14314452.53
"7540",2018-01-19 15:36:58,1777948.64,16092401.17
"7541",2018-01-19 15:36:58,-1111285.67,14981115.5
"7542",2018-01-19 15:52:56,1386298.83,16367414.33
"7543",2018-01-19 15:52:56,-14981115.5,1386298.83
"7544",2018-01-19 16:11:14,-1386298.83,0
"7545",2018-01-19 20:28:23,499999.16,499999.16
"7546",2018-01-19 20:52:34,-499999.16,0
"7547",2018-01-19 21:12:06,1999990.17,1999990.17
"7548",2018-01-19 21:12:06,326278.18,2326268.35
"7549",2018-01-19 21:16:48,-2326268.35,0
"7550",2018-01-19 23:27:25,122504.2,122504.2
"7551",2018-01-19 23:27:25,1999990.19,2122494.39
"7552",2018-01-19 23:41:19,-2122494.39,0
"7553",2018-01-20 01:08:17,1999990.21,1999990.21
"7554",2018-01-20 01:08:17,6306.22,2006296.43
"7555",2018-01-20 01:13:00,-2006296.43,0
"7556",2018-01-20 03:49:48,1999990.23,1999990.23
"7557",2018-01-20 03:49:48,134227.24,2134217.47
"7558",2018-01-20 03:56:16,-2134217.47,-4.65661287307739e-10
"7559",2018-01-20 11:58:38,888895.18,888895.18
"7560",2018-01-20 12:08:31,-888895.18,-4.65661287307739e-10
"7561",2018-01-20 20:38:13,499999.42,499999.42
"7562",2018-01-20 20:50:18,-499999.42,-4.65661287307739e-10
"7563",2018-01-21 04:50:45,1999990.64,1999990.64
"7564",2018-01-21 04:50:45,1592322.65,3592313.29
"7565",2018-01-21 04:54:19,-3592313.29,-9.31322574615479e-10
"7566",2018-01-21 05:16:23,1999990.73,1999990.73
"7567",2018-01-21 05:16:23,1586043.74,3586034.47
"7568",2018-01-21 05:23:32,-3586034.47,-1.39698386192322e-09
"7569",2018-01-21 06:41:42,1915667.84,1915667.84
"7570",2018-01-21 06:41:42,1999990.83,3915658.67
"7571",2018-01-21 06:46:30,-3915658.67,-9.31322574615479e-10
"7572",2018-01-21 07:58:17,1768428.9,1768428.9
"7573",2018-01-21 07:58:17,1999990.89,3768419.79
"7574",2018-01-21 08:14:02,-3768419.79,-9.31322574615479e-10
"7575",2018-01-21 08:48:42,206227.12,206227.119999999
"7576",2018-01-21 08:58:07,-206227.12,-9.31322574615479e-10
"7577",2018-01-21 09:16:46,2622782.46,2622782.46
"7578",2018-01-21 09:35:47,-2622782.46,-9.31322574615479e-10
"7579",2018-01-21 10:08:42,1999991.38,1999991.38
"7580",2018-01-21 10:08:42,1810468.39,3810459.77
"7581",2018-01-21 10:14:22,-3810459.77,-1.39698386192322e-09
"7582",2018-01-21 16:29:07,1999991.47,1999991.47
"7583",2018-01-21 16:35:18,-1999991.47,-1.39698386192322e-09
"7584",2018-01-21 16:43:13,1999991.49,1999991.49
"7585",2018-01-21 16:43:13,247837.5,2247828.99
"7586",2018-01-21 16:49:16,-2247828.99,-1.86264514923096e-09
"7587",2018-01-21 17:43:48,1999991.54,1999991.54
"7588",2018-01-21 17:46:41,1826929.55,3826921.09
"7589",2018-01-21 17:52:17,-1999991.54,1826929.55
"7590",2018-01-21 17:58:08,-1826929.55,-2.09547579288483e-09
"7591",2018-01-21 21:45:41,1999991.62,1999991.62
"7592",2018-01-21 21:45:41,408755.63,2408747.25
"7593",2018-01-21 21:54:27,-2408747.25,-1.86264514923096e-09
"7594",2018-01-21 23:25:11,201958.48,201958.479999998
"7595",2018-01-21 23:39:13,-201958.48,-1.86264514923096e-09
"7596",2018-01-22 00:05:49,1999991.64,1999991.64
"7597",2018-01-22 00:05:49,347073.65,2347065.29
"7598",2018-01-22 00:13:33,-2347065.29,-1.86264514923096e-09
"7599",2018-01-22 16:21:40,1999991.82,1999991.82
"7600",2018-01-22 16:46:00,-1999991.82,-1.86264514923096e-09
"7601",2018-01-22 20:03:20,1999991.88,1999991.88
"7602",2018-01-22 20:03:20,1965002.89,3964994.77
"7603",2018-01-22 20:17:08,-3964994.77,-2.3283064365387e-09
"7604",2018-01-22 22:14:04,1999991.94,1999991.94
"7605",2018-01-22 22:18:35,1273622.95,3273614.89
"7606",2018-01-22 22:18:35,-1999991.94,1273622.95
"7607",2018-01-22 22:26:30,-1273622.95,-2.09547579288483e-09
"7608",2018-01-23 13:28:21,1999994.17,1999994.17
"7609",2018-01-23 13:28:21,1999994.18,3999988.35
"7610",2018-01-23 13:28:21,1999994.19,5999982.54
"7611",2018-01-23 13:28:21,1146997.2,7146979.74
"7612",2018-01-23 13:40:47,-7146979.74,-2.79396772384644e-09
"7613",2018-01-23 16:48:15,834456.71,834456.709999997
"7614",2018-01-23 16:48:15,177420.05,1011876.76
"7615",2018-01-23 16:48:15,279672.28,1291549.04
"7616",2018-01-23 16:48:15,2244646.74,3536195.78
"7617",2018-01-23 16:51:37,51637.36,3587833.14
"7618",2018-01-23 16:51:37,-3536195.78,51637.3599999975
"7619",2018-01-23 16:57:53,-51637.36,-2.459273673594e-09
"7620",2018-01-23 17:07:25,130004.3,130004.299999998
"7621",2018-01-23 17:13:22,-130004.3,-2.459273673594e-09
"7622",2018-01-23 20:00:27,1999994.36,1999994.36
"7623",2018-01-23 20:23:35,1308737.37,3308731.73
"7624",2018-01-23 20:23:35,-1999994.36,1308737.37
"7625",2018-01-23 20:27:45,-1308737.37,-2.56113708019257e-09
"7626",2018-01-25 08:36:04,497781.47,497781.469999997
"7627",2018-01-25 08:54:45,-497781.47,-2.56113708019257e-09
"7628",2018-01-25 09:00:06,777781.78,777781.779999997
"7629",2018-01-25 09:05:16,-777781.78,-2.56113708019257e-09
"7630",2018-01-25 12:34:12,777781.8,777781.799999997
"7631",2018-01-25 12:46:37,-777781.8,-2.56113708019257e-09
"7632",2018-01-26 21:11:42,777782.23,777782.229999997
"7633",2018-01-26 21:19:13,-777782.23,-2.56113708019257e-09
"7634",2018-01-27 01:54:15,777782.53,777782.529999997
"7635",2018-01-27 01:58:34,-777782.53,-2.56113708019257e-09
"7636",2018-01-27 09:12:14,777782.58,777782.579999997
"7637",2018-01-27 09:26:05,-777782.58,-2.56113708019257e-09
"7638",2018-01-27 12:07:50,497782.05,497782.049999997
"7639",2018-01-27 12:12:36,-497782.05,-2.56113708019257e-09
"7640",2018-01-28 09:08:31,777782.31,777782.309999997
"7641",2018-01-28 09:13:22,-777782.31,-2.56113708019257e-09
"7642",2018-01-28 12:44:51,497782.67,497782.669999997
"7643",2018-01-28 12:52:12,-497782.67,-2.56113708019257e-09
"7644",2018-01-28 16:35:34,888893.58,888893.579999997
"7645",2018-01-28 16:50:23,-888893.58,-2.56113708019257e-09
"7646",2018-01-29 09:31:05,777782.11,777782.109999997
"7647",2018-01-29 09:39:03,-777782.11,-2.56113708019257e-09
"7648",2018-01-29 13:50:45,498005.27,498005.269999997
"7649",2018-01-29 13:53:43,-498005.27,-2.56113708019257e-09
"7650",2018-01-30 13:59:17,497783.6,497783.599999997
"7651",2018-01-30 14:06:45,-497783.6,-2.56113708019257e-09
"7652",2018-02-01 01:35:57,888897.43,888897.429999997
"7653",2018-02-01 01:42:11,-888897.43,-2.56113708019257e-09
"7654",2018-02-02 06:56:35,4001925.91,4001925.91
"7655",2018-02-02 07:18:16,-4001925.91,-2.79396772384644e-09
"7656",2018-02-02 21:50:50,267171.55,267171.549999997
"7657",2018-02-02 21:50:50,308908.08,576079.629999997
"7658",2018-02-02 21:56:40,-576079.63,-2.79396772384644e-09
"7659",2018-02-03 07:57:47,630580.37,630580.369999997
"7660",2018-02-03 07:57:47,1999998.36,2630578.73
"7661",2018-02-03 08:02:01,-2630578.73,-2.79396772384644e-09
"7662",2018-02-03 10:27:26,1999998.39,1999998.39
"7663",2018-02-03 10:30:27,1434653.4,3434651.79
"7664",2018-02-03 10:30:27,-1999998.39,1434653.4
"7665",2018-02-03 10:48:17,-1434653.4,-2.56113708019257e-09
"7666",2018-02-03 16:37:33,1249587.17,1249587.17
"7667",2018-02-03 16:53:33,-1249587.17,-2.56113708019257e-09
"7668",2018-02-04 05:22:39,639902.5,639902.499999997
"7669",2018-02-04 05:22:39,452287.43,1092189.93
"7670",2018-02-04 05:55:05,330768.1,1422958.03
"7671",2018-02-04 05:55:05,560738.48,1983696.51
"7672",2018-02-04 05:55:05,546081.58,2529778.09
"7673",2018-02-04 05:55:05,-1092189.93,1437588.16
"7674",2018-02-04 06:07:20,-1437588.16,-2.3283064365387e-09
"7675",2018-02-04 06:49:50,1595578.76,1595578.76
"7676",2018-02-04 06:54:09,-1595578.76,-2.3283064365387e-09
"7677",2018-02-04 08:56:56,193553.98,193553.979999998
"7678",2018-02-04 09:15:11,1999998.65,2193552.63
"7679",2018-02-04 09:15:11,159834.66,2353387.29
"7680",2018-02-04 09:15:11,-193553.98,2159833.31
"7681",2018-02-04 09:42:48,-2159833.31,-2.3283064365387e-09
"7682",2018-02-04 18:13:37,1251836.87,1251836.87
"7683",2018-02-04 18:32:55,-1251836.87,-2.3283064365387e-09
"7684",2018-02-04 22:34:18,268187.69,268187.689999998
"7685",2018-02-04 22:51:02,-268187.69,-2.3283064365387e-09
"7686",2018-02-04 23:07:26,888896.88,888896.879999998
"7687",2018-02-04 23:11:41,-888896.88,-2.3283064365387e-09
"7688",2018-02-05 02:23:46,1999998.96,1999998.96
"7689",2018-02-05 02:23:46,600328.97,2600327.93
"7690",2018-02-05 02:32:31,-2600327.93,-2.3283064365387e-09
"7691",2018-02-05 04:03:57,777785.95,777785.949999998
"7692",2018-02-05 04:07:53,-777785.95,-2.3283064365387e-09
"7693",2018-02-05 05:02:57,1467887.04,1467887.04
"7694",2018-02-05 05:02:57,1999999.03,3467886.07
"7695",2018-02-05 05:11:45,-3467886.07,-2.3283064365387e-09
"7696",2018-02-05 12:04:24,1489619.12,1489619.12
"7697",2018-02-05 12:43:39,1999999.11,3489618.23
"7698",2018-02-05 12:43:39,-1489619.12,1999999.11
"7699",2018-02-05 12:58:13,-1999999.11,-2.56113708019257e-09
"7700",2018-02-05 14:43:43,1999999.13,1999999.13
"7701",2018-02-05 14:43:43,1710859.14,3710858.27
"7702",2018-02-05 14:54:38,-3710858.27,-2.79396772384644e-09
"7703",2018-02-05 16:06:06,1999999.2,1999999.2
"7704",2018-02-05 16:06:06,1999999.21,3999998.41
"7705",2018-02-05 16:06:06,664640.22,4664638.63
"7706",2018-02-05 16:10:07,-4664638.63,-2.79396772384644e-09
"7707",2018-02-05 19:41:05,1999999.52,1999999.52
"7708",2018-02-05 19:45:36,1999999.51,3999999.03
"7709",2018-02-05 19:45:36,742658.53,4742657.56
"7710",2018-02-05 19:45:36,1999999.5,6742657.06
"7711",2018-02-05 19:45:36,-1999999.52,4742657.54
"7712",2018-02-05 20:02:58,-4742657.54,-2.79396772384644e-09
"7713",2018-02-05 20:42:13,497009.56,497009.559999997
"7714",2018-02-05 20:48:04,-497009.56,-2.79396772384644e-09
"7715",2018-02-06 08:35:45,1999999.58,1999999.58
"7716",2018-02-06 08:35:45,1999999.57,3999999.15
"7717",2018-02-06 08:35:45,414877.59,4414876.74
"7718",2018-02-06 08:51:08,-4414876.74,-2.79396772384644e-09
"7719",2018-02-06 10:06:43,1999999.6,1999999.6
"7720",2018-02-06 10:06:43,1999999.62,3999999.22
"7721",2018-02-06 10:06:43,624355.63,4624354.85
"7722",2018-02-06 10:06:43,1999999.61,6624354.46
"7723",2018-02-06 10:17:35,-6624354.46,-1.86264514923096e-09
"7724",2018-02-06 16:10:24,1238059.23,1238059.23
"7725",2018-02-06 16:18:43,-1238059.23,-1.86264514923096e-09
"7726",2018-02-06 20:39:00,25605.91,25605.9099999981
"7727",2018-02-06 20:39:00,10560.36,36166.2699999981
"7728",2018-02-06 20:46:37,-36166.27,-1.85536919161677e-09
"7729",2018-02-07 19:56:25,91568.45,91568.4499999981
"7730",2018-02-07 19:56:25,26472.39,118040.839999998
"7731",2018-02-07 19:56:25,777777.24,895818.079999998
"7732",2018-02-07 20:06:08,-895818.08,-1.86264514923096e-09
"7733",2018-02-07 21:06:13,236881.44,236881.439999998
"7734",2018-02-07 21:22:41,-236881.44,-1.86264514923096e-09
"7735",2018-02-07 21:51:30,1916407.13,1916407.13
"7736",2018-02-07 21:57:29,-1916407.13,-1.86264514923096e-09
"7737",2018-02-07 22:13:36,2021076.9,2021076.9
"7738",2018-02-07 22:17:03,-2021076.9,-1.86264514923096e-09
"7739",2018-02-07 23:27:04,1030554.99,1030554.99
"7740",2018-02-07 23:42:34,-1030554.99,-1.86264514923096e-09
"7741",2018-02-08 01:50:32,1777884.56,1777884.56
"7742",2018-02-08 02:03:39,-1777884.56,-1.86264514923096e-09
"7743",2018-02-08 15:57:07,140678.44,140678.439999998
"7744",2018-02-08 16:02:08,-140678.44,-1.86264514923096e-09
"7745",2018-02-08 16:44:45,1420601.93,1420601.93
"7746",2018-02-08 16:49:34,-1420601.93,-1.86264514923096e-09
"7747",2018-02-08 17:52:38,1382467.84,1382467.84
"7748",2018-02-08 19:17:34,-1382467.84,-1.86264514923096e-09
"7749",2018-02-09 08:03:04,4414552.66,4414552.66
"7750",2018-02-09 08:16:00,-4414552.66,-1.86264514923096e-09
"7751",2018-02-09 12:54:55,1601310.36,1601310.36
"7752",2018-02-09 13:01:12,-1601310.36,-1.86264514923096e-09
"7753",2018-02-09 15:05:40,1729252.78,1729252.78
"7754",2018-02-09 15:15:22,-1729252.78,-1.86264514923096e-09
"7755",2018-02-09 17:10:39,958921.68,958921.679999998
"7756",2018-02-09 17:10:39,1999990.67,2958912.35
"7757",2018-02-09 17:21:39,-2958912.35,-1.86264514923096e-09
"7758",2018-02-10 05:33:09,2500786.78,2500786.78
"7759",2018-02-10 05:40:42,-2500786.78,-1.86264514923096e-09
"7760",2018-02-10 07:10:30,429607.03,429607.029999998
"7761",2018-02-10 07:26:48,-429607.03,-1.86264514923096e-09
"7762",2018-02-10 08:54:17,733250.24,733250.239999998
"7763",2018-02-10 09:03:20,275431.57,1008681.81
"7764",2018-02-10 09:03:20,-733250.24,275431.569999998
"7765",2018-02-10 09:11:07,-275431.57,-1.80443748831749e-09
"7766",2018-02-10 11:45:31,222096.44,222096.439999998
"7767",2018-02-10 11:52:29,-222096.44,-1.80443748831749e-09
"7768",2018-02-10 14:28:41,412903.73,412903.729999998
"7769",2018-02-10 14:31:45,-412903.73,-1.80443748831749e-09
"7770",2018-02-10 15:44:28,315616.73,315616.729999998
"7771",2018-02-10 16:09:16,574593.18,890209.909999998
"7772",2018-02-10 16:09:16,671640.97,1561850.88
"7773",2018-02-10 16:09:16,-315616.73,1246234.15
"7774",2018-02-10 17:31:42,888159.56,2134393.71
"7775",2018-02-10 17:42:59,499778.37,2634172.08
"7776",2018-02-10 17:42:59,-1246234.15,1387937.93
"7777",2018-02-10 17:54:20,-1387937.93,-1.62981450557709e-09
"7778",2018-02-10 18:51:15,25410.19,25410.1899999984
"7779",2018-02-10 18:51:15,75153.39,100563.579999998
"7780",2018-02-10 18:51:15,332807.54,433371.119999998
"7781",2018-02-10 18:55:27,-433371.12,-1.62981450557709e-09
"7782",2018-02-10 19:15:41,337523.06,337523.059999998
"7783",2018-02-10 19:22:48,567374.37,904897.429999998
"7784",2018-02-10 19:22:48,-337523.06,567374.369999998
"7785",2018-02-10 19:28:14,-567374.37,-1.74622982740402e-09
"7786",2018-02-10 19:50:52,402893.44,402893.439999998
"7787",2018-02-10 20:04:35,-402893.44,-1.74622982740402e-09
"7788",2018-02-10 20:58:34,707059.46,707059.459999998
"7789",2018-02-10 21:08:02,530214.7,1237274.16
"7790",2018-02-10 21:08:02,-707059.46,530214.699999998
"7791",2018-02-10 21:14:01,-530214.7,-1.62981450557709e-09
"7792",2018-02-10 22:11:28,453034.49,453034.489999998
"7793",2018-02-10 22:11:28,682304.33,1135338.82
"7794",2018-02-10 22:18:00,446985.06,1582323.88
"7795",2018-02-10 22:18:00,-1135338.82,446985.059999998
"7796",2018-02-10 22:31:23,-446985.06,-1.57160684466362e-09
"7797",2018-02-11 00:08:08,270926.22,270926.219999998
"7798",2018-02-11 00:17:00,-270926.22,-1.57160684466362e-09
"7799",2018-02-11 00:59:32,1000633.65,1000633.65
"7800",2018-02-11 01:13:55,-1000633.65,-1.51339918375015e-09
"7801",2018-02-11 02:37:40,38939.44,38939.4399999985
"7802",2018-02-11 02:37:40,171531.02,210470.459999998
"7803",2018-02-11 02:37:40,316779.8,527250.259999998
"7804",2018-02-11 02:37:40,239552.83,766803.089999998
"7805",2018-02-11 02:37:40,373524.58,1140327.67
"7806",2018-02-11 02:54:05,-1140327.67,-1.39698386192322e-09
"7807",2018-02-11 04:17:02,487932.68,487932.679999999
"7808",2018-02-11 04:25:22,-487932.68,-1.39698386192322e-09
"7809",2018-02-11 05:11:31,329652.15,329652.149999999
"7810",2018-02-11 05:25:29,-329652.15,-1.39698386192322e-09
"7811",2018-02-11 05:51:10,196140.9,196140.899999999
"7812",2018-02-11 05:51:10,249975.06,446115.959999999
"7813",2018-02-11 05:51:10,500001.98,946117.939999999
"7814",2018-02-11 05:51:10,555576.99,1501694.93
"7815",2018-02-11 06:09:36,-1501694.93,-1.39698386192322e-09
"7816",2018-02-11 12:08:38,888890.21,888890.209999999
"7817",2018-02-11 12:08:38,499002.22,1387892.43
"7818",2018-02-11 12:14:56,-1387892.43,-1.39698386192322e-09
"7819",2018-02-11 12:53:01,777779.26,777779.259999999
"7820",2018-02-11 12:53:01,777779.24,1555558.5
"7821",2018-02-11 12:53:01,777779.25,2333337.75
"7822",2018-02-11 12:53:01,777779.27,3111117.02
"7823",2018-02-11 12:58:17,-3111117.02,-1.39698386192322e-09
"7824",2018-02-11 14:43:25,486494.16,486494.159999999
"7825",2018-02-11 15:10:12,-486494.16,-1.39698386192322e-09
"7826",2018-02-11 17:06:14,517711.5,517711.499999999
"7827",2018-02-11 17:19:31,-517711.5,-1.39698386192322e-09
"7828",2018-02-11 23:30:32,5490080.84,5490080.84
"7829",2018-02-11 23:30:32,1777785.9,7267866.74
"7830",2018-02-11 23:48:33,-7267866.74,-1.86264514923096e-09
"7831",2018-02-12 01:48:38,1989257.02,1989257.02
"7832",2018-02-12 01:51:54,-1989257.02,-1.86264514923096e-09
"7833",2018-02-12 08:34:04,77159.5,77159.4999999981
"7834",2018-02-12 08:34:04,1999992.49,2077151.99
"7835",2018-02-12 08:48:23,-2077151.99,-1.86264514923096e-09
"7836",2018-02-13 20:33:46,505267.15,505267.149999998
"7837",2018-02-13 20:37:39,-505267.15,-1.86264514923096e-09
"7838",2018-02-14 04:39:32,410961.33,410961.329999998
"7839",2018-02-14 04:43:29,-410961.33,-1.86264514923096e-09
"7840",2018-02-14 12:36:08,1888896.97,1888896.97
"7841",2018-02-14 12:44:10,-1888896.97,-1.86264514923096e-09
"7842",2018-02-15 01:04:28,820872.99,820872.989999998
"7843",2018-02-15 01:33:12,-820872.99,-1.86264514923096e-09
"7844",2018-02-15 07:51:24,381413.79,381413.789999998
"7845",2018-02-15 08:10:51,-381413.79,-1.86264514923096e-09
"7846",2018-02-15 09:42:05,196391.7,196391.699999998
"7847",2018-02-15 09:45:57,-196391.7,-1.86264514923096e-09
"7848",2018-02-15 10:08:28,356677.23,356677.229999998
"7849",2018-02-15 10:20:05,806878.41,1163555.64
"7850",2018-02-15 10:20:05,918518.08,2082073.72
"7851",2018-02-15 10:20:05,-356677.23,1725396.49
"7852",2018-02-15 10:27:03,1038105.34,2763501.83
"7853",2018-02-15 10:27:03,-1725396.49,1038105.34
"7854",2018-02-15 10:42:02,-1038105.34,-1.74622982740402e-09
"7855",2018-02-15 11:24:00,1098448.36,1098448.36
"7856",2018-02-15 11:33:29,-1098448.36,-1.62981450557709e-09
"7857",2018-02-15 12:44:55,933401.65,933401.649999998
"7858",2018-02-15 12:47:14,-933401.65,-1.62981450557709e-09
"7859",2018-02-15 14:46:41,802382.78,802382.779999998
"7860",2018-02-15 15:02:41,-802382.78,-1.62981450557709e-09
"7861",2018-02-15 19:12:25,831164.64,831164.639999998
"7862",2018-02-15 19:36:44,-831164.64,-1.62981450557709e-09
"7863",2018-02-16 05:31:22,548242.28,548242.279999998
"7864",2018-02-16 05:46:54,-548242.28,-1.62981450557709e-09
"7865",2018-02-16 07:26:19,518555.57,518555.569999998
"7866",2018-02-16 07:38:24,-518555.57,-1.62981450557709e-09
"7867",2018-02-16 08:20:09,722482.93,722482.929999998
"7868",2018-02-16 08:35:50,-722482.93,-1.62981450557709e-09
"7869",2018-02-16 10:45:08,858093.79,858093.789999998
"7870",2018-02-16 10:54:30,-858093.79,-1.62981450557709e-09
"7871",2018-02-16 16:14:41,957905.87,957905.869999998
"7872",2018-02-16 16:18:41,-957905.87,-1.62981450557709e-09
"7873",2018-02-16 20:33:59,824598.77,824598.769999998
"7874",2018-02-16 20:37:47,-824598.77,-1.62981450557709e-09
"7875",2018-02-16 23:36:30,388912.92,388912.919999998
"7876",2018-02-16 23:39:12,-388912.92,-1.62981450557709e-09
"7877",2018-02-17 01:49:59,1128990.56,1128990.56
"7878",2018-02-17 01:59:15,-1128990.56,-1.62981450557709e-09
"7879",2018-02-17 07:12:57,1767339.36,1767339.36
"7880",2018-02-17 07:18:13,-1767339.36,-1.62981450557709e-09
"7881",2018-02-18 04:56:06,721377.15,721377.149999998
"7882",2018-02-18 05:07:56,-721377.15,-1.62981450557709e-09
"7883",2018-02-18 10:03:06,1534079.44,1534079.44
"7884",2018-02-18 10:08:33,1672167.96,3206247.4
"7885",2018-02-18 10:08:33,-1534079.44,1672167.96
"7886",2018-02-18 10:13:30,-1672167.96,-1.39698386192322e-09
"7887",2018-02-18 16:55:03,1186773.2,1186773.2
"7888",2018-02-18 16:58:48,-1186773.2,-1.39698386192322e-09
"7889",2018-02-18 19:08:13,1183173.52,1183173.52
"7890",2018-02-18 19:11:42,-1183173.52,-1.39698386192322e-09
"7891",2018-02-18 22:01:03,760138.95,760138.949999999
"7892",2018-02-18 22:05:36,-760138.95,-1.39698386192322e-09
"7893",2018-02-18 22:41:19,428766.06,428766.059999999
"7894",2018-02-18 22:56:39,-428766.06,-1.39698386192322e-09
"7895",2018-02-19 00:39:35,750640.23,750640.229999999
"7896",2018-02-19 00:41:58,-750640.23,-1.39698386192322e-09
"7897",2018-02-19 08:52:20,998501.49,998501.489999999
"7898",2018-02-19 08:57:17,-998501.49,-1.39698386192322e-09
"7899",2018-02-19 15:15:23,100182.84,100182.839999999
"7900",2018-02-19 15:15:23,601718.9,701901.739999999
"7901",2018-02-19 15:15:23,478873.03,1180774.77
"7902",2018-02-19 15:22:20,-1180774.77,-1.39698386192322e-09
"7903",2018-02-19 15:31:57,1340433.73,1340433.73
"7904",2018-02-19 15:41:29,-1340433.73,-1.39698386192322e-09
"7905",2018-02-19 16:47:43,499005.11,499005.109999999
"7906",2018-02-19 16:52:16,-499005.11,-1.39698386192322e-09
"7907",2018-02-19 18:44:56,446875.21,446875.209999999
"7908",2018-02-19 19:06:34,942296.56,1389171.77
"7909",2018-02-19 19:06:34,-446875.21,942296.559999999
"7910",2018-02-19 19:34:07,-942296.56,-1.39698386192322e-09
"7911",2018-02-19 20:48:42,1262240.76,1262240.76
"7912",2018-02-19 21:06:16,-1262240.76,-1.39698386192322e-09
"7913",2018-02-20 00:22:08,624831.84,624831.839999999
"7914",2018-02-20 00:38:52,684876.83,1309708.67
"7915",2018-02-20 00:38:52,-624831.84,684876.829999999
"7916",2018-02-20 00:50:37,-684876.83,-1.39698386192322e-09
"7917",2018-02-20 01:18:30,1342047.55,1342047.55
"7918",2018-02-20 01:25:49,-1342047.55,-1.39698386192322e-09
"7919",2018-02-20 02:37:12,1871203.23,1871203.23
"7920",2018-02-20 03:02:07,-1871203.23,-1.39698386192322e-09
"7921",2018-02-20 23:14:05,32052.53,32052.5299999986
"7922",2018-02-20 23:14:05,1435052.96,1467105.49
"7923",2018-02-20 23:14:05,52417.82,1519523.31
"7924",2018-02-20 23:14:05,499995.81,2019519.12
"7925",2018-02-20 23:17:09,-2019519.12,-1.39698386192322e-09
"7926",2018-02-21 00:29:18,1552124.84,1552124.84
"7927",2018-02-21 00:29:18,885243.52,2437368.36
"7928",2018-02-21 00:41:03,-2437368.36,-1.39698386192322e-09
"7929",2018-02-21 03:34:57,247620.07,247620.069999999
"7930",2018-02-21 03:34:57,499996.06,747616.129999999
"7931",2018-02-21 04:01:56,-747616.13,-1.39698386192322e-09
"7932",2018-02-21 04:36:45,417124.9,417124.899999999
"7933",2018-02-21 04:44:57,620950.68,1038075.58
"7934",2018-02-21 04:44:57,-417124.9,620950.679999999
"7935",2018-02-21 04:51:06,-620950.68,-1.39698386192322e-09
"7936",2018-02-21 09:09:52,375707.06,375707.059999999
"7937",2018-02-21 09:11:30,-375707.06,-1.39698386192322e-09
"7938",2018-02-21 12:07:30,608103.99,608103.989999999
"7939",2018-02-21 12:23:31,-608103.99,-1.39698386192322e-09
"7940",2018-02-21 14:40:44,416149.05,416149.049999999
"7941",2018-02-21 14:40:44,459858.19,876007.239999999
"7942",2018-02-21 14:48:39,-876007.24,-1.39698386192322e-09
"7943",2018-02-21 14:51:01,492187.08,492187.079999999
"7944",2018-02-21 15:11:03,-492187.08,-1.39698386192322e-09
"7945",2018-02-21 15:44:57,499996.72,499996.719999999
"7946",2018-02-21 15:44:57,100924.73,600921.449999999
"7947",2018-02-21 16:02:48,-600921.45,-1.39698386192322e-09
"7948",2018-02-21 16:48:21,892957.26,892957.259999999
"7949",2018-02-21 16:48:21,599006.76,1491964.02
"7950",2018-02-21 16:50:46,-1491964.02,-1.39698386192322e-09
"7951",2018-02-21 17:29:17,325510.09,325510.089999999
"7952",2018-02-21 17:31:58,-325510.09,-1.39698386192322e-09
"7953",2018-02-21 21:01:42,650808.3,650808.299999999
"7954",2018-02-21 21:21:39,-650808.3,-1.39698386192322e-09
"7955",2018-02-21 23:54:13,383266.56,383266.559999999
"7956",2018-02-22 00:05:40,-383266.56,-1.39698386192322e-09
"7957",2018-02-22 04:56:54,270256.6,270256.599999999
"7958",2018-02-22 04:59:23,-270256.6,-1.39698386192322e-09
"7959",2018-02-22 08:58:03,499997.21,499997.209999999
"7960",2018-02-22 08:58:03,62863.22,562860.429999999
"7961",2018-02-22 09:10:11,-562860.43,-1.39698386192322e-09
"7962",2018-02-22 12:54:02,462292.48,462292.479999999
"7963",2018-02-22 12:56:24,-462292.48,-1.39698386192322e-09
"7964",2018-02-22 13:05:49,754703.61,754703.609999999
"7965",2018-02-22 13:23:14,562333.32,1317036.93
"7966",2018-02-22 13:23:14,708652.73,2025689.66
"7967",2018-02-22 13:23:14,-754703.61,1270986.05
"7968",2018-02-22 13:32:34,-1270986.05,-1.62981450557709e-09
"7969",2018-02-22 14:44:36,599732.97,599732.969999998
"7970",2018-02-22 14:44:36,547957.07,1147690.04
"7971",2018-02-22 14:50:09,-1147690.04,-1.86264514923096e-09
"7972",2018-02-22 14:52:19,379028.5,379028.499999998
"7973",2018-02-22 14:52:19,499997.49,879025.989999998
"7974",2018-02-22 15:22:06,-879025.99,-1.86264514923096e-09
"7975",2018-02-22 15:56:31,1335550.83,1335550.83
"7976",2018-02-22 16:24:17,-1335550.83,-1.86264514923096e-09
"7977",2018-02-22 17:25:59,1404321.46,1404321.46
"7978",2018-02-22 17:29:38,-1404321.46,-1.86264514923096e-09
"7979",2018-02-22 18:11:44,73722.89,73722.8899999981
"7980",2018-02-22 18:28:57,-73722.89,-1.86264514923096e-09
"7981",2018-02-22 20:55:31,1433585.85,1433585.85
"7982",2018-02-22 20:59:41,-1433585.85,-1.86264514923096e-09
"7983",2018-02-23 01:00:15,728693.43,728693.429999998
"7984",2018-02-23 01:25:14,-728693.43,-1.86264514923096e-09
"7985",2018-02-23 03:56:50,686025.6,686025.599999998
"7986",2018-02-23 08:19:51,-686025.6,-1.86264514923096e-09
"7987",2018-02-23 12:08:31,866888.18,866888.179999998
"7988",2018-02-23 12:17:52,-866888.18,-1.86264514923096e-09
"7989",2018-02-23 20:21:27,491944.84,491944.839999998
"7990",2018-02-23 20:25:49,499998.11,991942.949999998
"7991",2018-02-23 20:25:49,160906.12,1152849.07
"7992",2018-02-23 20:25:49,98401.08,1251250.15
"7993",2018-02-23 20:25:49,599998.07,1851248.22
"7994",2018-02-23 20:25:49,-491944.84,1359303.38
"7995",2018-02-23 20:37:45,-1359303.38,-2.09547579288483e-09
"7996",2018-02-23 22:22:38,714908.46,714908.459999998
"7997",2018-02-23 22:30:18,-714908.46,-2.09547579288483e-09
"7998",2018-02-24 00:56:33,1295309.01,1295309.01
"7999",2018-02-24 02:33:52,599998.21,1895307.22
"8000",2018-02-24 02:33:52,16452.22,1911759.44
"8001",2018-02-24 06:14:03,777805.12,2689564.56
"8002",2018-02-24 06:14:03,-1295309.01,1394255.55
"8003",2018-02-24 06:22:16,-1394255.55,-2.3283064365387e-09
"8004",2018-02-24 15:24:05,169751.17,169751.169999998
"8005",2018-02-24 15:46:01,-169751.17,-2.3283064365387e-09
"8006",2018-02-24 16:44:39,599999.46,599999.459999998
"8007",2018-02-24 16:44:39,204473.49,804472.949999998
"8008",2018-02-24 16:58:04,599009.66,1403482.61
"8009",2018-02-24 16:58:04,-804472.95,599009.659999998
"8010",2018-02-24 17:07:42,-599009.66,-2.44472175836563e-09
"8011",2018-02-24 17:20:58,555564.72,555564.719999998
"8012",2018-02-24 17:40:05,-555564.72,-2.44472175836563e-09
"8013",2018-02-24 21:06:27,204965.96,204965.959999998
"8014",2018-02-24 21:14:30,-204965.96,-2.44472175836563e-09
"8015",2018-02-24 23:20:36,777789.94,777789.939999997
"8016",2018-02-24 23:39:21,-777789.94,-2.44472175836563e-09
"8017",2018-02-25 03:38:01,431831.36,431831.359999998
"8018",2018-02-25 03:44:56,-431831.36,-2.44472175836563e-09
"8019",2018-02-25 13:46:06,777790.66,777790.659999998
"8020",2018-02-25 13:52:03,-777790.66,-2.44472175836563e-09
"8021",2018-02-26 18:11:51,499991,499990.999999998
"8022",2018-02-26 18:11:51,110310.01,610301.009999998
"8023",2018-02-26 18:30:55,-610301.01,-2.44472175836563e-09
"8024",2018-02-27 05:50:56,599991.15,599991.149999998
"8025",2018-02-27 05:50:56,599991.17,1199982.32
"8026",2018-02-27 05:50:56,599991.16,1799973.48
"8027",2018-02-27 05:50:56,339247.18,2139220.66
"8028",2018-02-27 06:03:41,-2139220.66,-2.3283064365387e-09
"8029",2018-02-27 13:42:00,563076.25,563076.249999998
"8030",2018-02-27 13:42:00,1999991.24,2563067.49
"8031",2018-02-27 13:47:16,-2563067.49,-2.79396772384644e-09
"8032",2018-02-28 02:02:15,1777790.71,1777790.71
"8033",2018-02-28 02:15:31,-1777790.71,-2.79396772384644e-09
"8034",2018-03-05 09:01:46,1777792.91,1777792.91
"8035",2018-03-05 09:12:28,-1777792.91,-2.79396772384644e-09
"8036",2018-03-05 09:31:52,599004.82,599004.819999997
"8037",2018-03-05 09:37:07,-599004.82,-2.79396772384644e-09
"8038",2018-03-08 13:40:53,599996.56,599996.559999997
"8039",2018-03-08 13:40:53,9289.57,609286.129999997
"8040",2018-03-08 13:48:22,-609286.13,-2.79396772384644e-09
"8041",2018-03-08 21:15:22,1222469.61,1222469.61
"8042",2018-03-08 21:41:47,-1222469.61,-2.79396772384644e-09
"8043",2018-03-08 22:28:37,1658843.1,1658843.1
"8044",2018-03-08 22:48:19,-1658843.1,-2.79396772384644e-09
"8045",2018-03-09 00:47:41,1909316.33,1909316.33
"8046",2018-03-09 00:55:01,-1909316.33,-2.79396772384644e-09
"8047",2018-03-09 02:44:18,1492660.25,1492660.25
"8048",2018-03-09 02:52:23,-1492660.25,-2.79396772384644e-09
"8049",2018-03-09 03:09:43,1579444.63,1579444.63
"8050",2018-03-09 03:21:54,-1579444.63,-2.79396772384644e-09
"8051",2018-03-09 06:48:35,179002.27,179002.269999997
"8052",2018-03-09 06:48:35,499997.26,678999.529999997
"8053",2018-03-09 07:10:28,-678999.53,-2.79396772384644e-09
"8054",2018-03-09 11:45:08,163087.38,163087.379999997
"8055",2018-03-09 11:45:08,599997.37,763084.749999997
"8056",2018-03-09 11:53:34,-763084.75,-2.79396772384644e-09
"8057",2018-03-09 16:37:02,1643862.29,1643862.29
"8058",2018-03-09 16:42:54,-1643862.29,-2.79396772384644e-09
"8059",2018-03-09 21:02:53,860661.01,860661.009999997
"8060",2018-03-09 21:15:30,1769576.61,2630237.62
"8061",2018-03-09 21:15:30,-860661.01,1769576.61
"8062",2018-03-09 21:24:06,-1769576.61,-2.79396772384644e-09
"8063",2018-03-09 21:29:17,694575.72,694575.719999997
"8064",2018-03-09 21:29:17,231719.01,926294.729999997
"8065",2018-03-09 21:34:07,-926294.73,-2.79396772384644e-09
"8066",2018-03-09 23:20:22,1215540.88,1215540.88
"8067",2018-03-09 23:26:53,-1215540.88,-2.79396772384644e-09
"8068",2018-03-10 19:27:46,599998.05,599998.049999997
"8069",2018-03-10 19:27:46,567664.06,1167662.11
"8070",2018-03-10 19:35:34,-1167662.11,-2.79396772384644e-09
"8071",2018-03-10 22:20:38,435901.21,435901.209999997
"8072",2018-03-10 22:20:38,499998.2,935899.409999997
"8073",2018-03-10 22:20:38,499998.19,1435897.6
"8074",2018-03-10 22:32:14,-1435897.6,-2.79396772384644e-09
"8075",2018-03-11 14:24:14,1805874.04,1805874.04
"8076",2018-03-11 15:02:03,-1805874.04,-2.79396772384644e-09
"8077",2018-03-11 16:07:27,1989752.3,1989752.3
"8078",2018-03-11 16:19:11,-1989752.3,-2.79396772384644e-09
"8079",2018-03-11 17:34:23,289304.67,289304.669999997
"8080",2018-03-11 17:34:23,1999998.66,2289303.33
"8081",2018-03-11 17:47:30,-2289303.33,-2.79396772384644e-09
"8082",2018-03-11 18:00:46,1999998.7,1999998.7
"8083",2018-03-11 18:00:46,86482.71,2086481.41
"8084",2018-03-11 18:16:28,-2086481.41,-2.79396772384644e-09
"8085",2018-03-13 06:36:30,1134434.45,1134434.45
"8086",2018-03-13 06:41:42,-1134434.45,-2.79396772384644e-09
"8087",2018-03-13 14:19:09,112735.36,112735.359999997
"8088",2018-03-13 14:31:50,-112735.36,-2.79396772384644e-09
"8089",2018-03-13 14:45:29,790679.44,790679.439999997
"8090",2018-03-13 14:53:18,-790679.44,-2.79396772384644e-09
"8091",2018-03-13 14:53:18,599999.44,599999.439999997
"8092",2018-03-13 14:53:18,163957.45,763956.889999997
"8093",2018-03-13 15:04:44,-763956.89,-2.91038304567337e-09
"8094",2018-03-13 16:57:19,743061.61,743061.609999997
"8095",2018-03-13 17:14:31,-743061.61,-2.91038304567337e-09
"8096",2018-03-13 18:12:58,599843.18,599843.179999997
"8097",2018-03-13 18:38:30,-599843.18,-2.91038304567337e-09
"8098",2018-03-14 02:15:04,244098.61,244098.609999997
"8099",2018-03-14 02:15:04,1999999.6,2244098.21
"8100",2018-03-14 02:17:31,-2244098.21,-2.79396772384644e-09
"8101",2018-03-14 07:53:24,599999.65,599999.649999997
"8102",2018-03-14 07:53:24,599999.66,1199999.31
"8103",2018-03-14 07:53:24,133433.67,1333432.98
"8104",2018-03-14 07:58:26,-1333432.98,-2.79396772384644e-09
"8105",2018-03-14 16:20:09,599990.04,599990.039999997
"8106",2018-03-14 16:20:09,599990.03,1199980.07
"8107",2018-03-14 16:20:09,529776.05,1729756.12
"8108",2018-03-14 16:20:09,599990.01,2329746.13
"8109",2018-03-14 16:20:09,599990.02,2929736.15
"8110",2018-03-14 16:29:31,-2929736.15,-2.79396772384644e-09
"8111",2018-03-14 20:48:01,499990.3,499990.299999997
"8112",2018-03-14 20:48:01,94359.31,594349.609999997
"8113",2018-03-14 20:52:36,-594349.61,-2.79396772384644e-09
"8114",2018-03-15 01:10:42,293225.79,293225.789999997
"8115",2018-03-15 01:14:53,-293225.79,-2.79396772384644e-09
"8116",2018-03-15 01:37:52,341456.96,341456.959999997
"8117",2018-03-15 01:52:57,1165447.77,1506904.73
"8118",2018-03-15 01:52:57,-341456.96,1165447.77
"8119",2018-03-15 02:05:40,-1165447.77,-2.79396772384644e-09
"8120",2018-03-15 03:51:13,37762.43,37762.4299999972
"8121",2018-03-15 03:51:13,348172.11,385934.539999997
"8122",2018-03-15 04:03:19,-385934.54,-2.79396772384644e-09
"8123",2018-03-15 04:57:26,403065.31,403065.309999997
"8124",2018-03-15 05:02:08,375752.38,778817.689999997
"8125",2018-03-15 05:02:08,-403065.31,375752.379999997
"8126",2018-03-15 05:13:23,-375752.38,-2.8521753847599e-09
"8127",2018-03-15 06:35:53,467441.45,467441.449999997
"8128",2018-03-15 06:46:58,172756.48,640197.929999997
"8129",2018-03-15 06:46:58,-467441.45,172756.479999997
"8130",2018-03-15 07:03:29,-172756.48,-2.88127921521664e-09
"8131",2018-03-15 07:17:02,18526.61,18526.6099999971
"8132",2018-03-15 07:39:04,190228.31,208754.919999997
"8133",2018-03-15 07:39:04,102221.68,310976.599999997
"8134",2018-03-15 07:39:04,-18526.61,292449.989999997
"8135",2018-03-15 07:46:11,-292449.99,-2.8521753847599e-09
"8136",2018-03-15 07:52:41,147858.67,147858.669999997
"8137",2018-03-15 07:58:46,-147858.67,-2.8521753847599e-09
"8138",2018-03-15 10:14:17,176840.67,176840.669999997
"8139",2018-03-15 10:19:01,-176840.67,-2.8521753847599e-09
"8140",2018-03-15 10:51:56,66731.69,66731.6899999972
"8141",2018-03-15 10:56:25,-66731.69,-2.8521753847599e-09
"8142",2018-03-15 11:05:21,465840.21,465840.209999997
"8143",2018-03-15 11:14:52,-465840.21,-2.8521753847599e-09
"8144",2018-03-15 11:18:28,24412.57,24412.5699999971
"8145",2018-03-15 11:39:53,-24412.57,-2.8521753847599e-09
"8146",2018-03-15 11:57:58,195798.94,195798.939999997
"8147",2018-03-15 12:11:26,-195798.94,-2.8521753847599e-09
"8148",2018-03-15 13:20:21,300001.5,300001.499999997
"8149",2018-03-15 13:43:42,54382.02,354383.519999997
"8150",2018-03-15 13:43:42,-300001.5,54382.0199999972
"8151",2018-03-15 13:52:17,-54382.02,-2.83034751191735e-09
"8152",2018-03-15 14:00:47,88092.58,88092.5799999972
"8153",2018-03-15 14:00:47,850478.12,938570.699999997
"8154",2018-03-15 14:09:13,-938570.7,-2.79396772384644e-09
"8155",2018-03-15 14:47:56,383805.19,383805.189999997
"8156",2018-03-15 15:07:50,-383805.19,-2.79396772384644e-09
"8157",2018-03-15 16:29:24,575577.23,575577.229999997
"8158",2018-03-15 16:29:24,575577.29,1151154.52
"8159",2018-03-15 16:29:24,575577.21,1726731.73
"8160",2018-03-15 16:29:24,575577.19,2302308.92
"8161",2018-03-15 16:29:24,575577.15,2877886.07
"8162",2018-03-15 16:29:24,575577.27,3453463.34
"8163",2018-03-15 16:34:11,-3453463.34,-2.79396772384644e-09
"8164",2018-03-15 16:48:47,189509.25,189509.249999997
"8165",2018-03-15 16:48:47,16120.23,205629.479999997
"8166",2018-03-15 16:48:47,159368.6,364998.079999997
"8167",2018-03-15 17:13:36,206709.51,571707.589999997
"8168",2018-03-15 17:13:36,203868.22,775575.809999997
"8169",2018-03-15 17:13:36,599992.37,1375568.18
"8170",2018-03-15 17:13:36,-364998.08,1010570.1
"8171",2018-03-15 17:24:28,-1010570.1,-2.6775524020195e-09
"8172",2018-03-15 17:36:27,1261763.6,1261763.6
"8173",2018-03-15 17:45:43,-1261763.6,-2.79396772384644e-09
"8174",2018-03-15 21:49:15,188707.98,188707.979999997
"8175",2018-03-15 21:54:36,-188707.98,-2.79396772384644e-09
"8176",2018-03-15 22:47:32,578779.66,578779.659999997
"8177",2018-03-15 22:49:17,-578779.66,-2.79396772384644e-09
"8178",2018-03-16 08:22:06,599992.9,599992.899999997
"8179",2018-03-16 08:22:06,599992.85,1199985.75
"8180",2018-03-16 08:22:06,599992.92,1799978.67
"8181",2018-03-16 08:22:06,599992.86,2399971.53
"8182",2018-03-16 08:22:06,599992.93,2999964.46
"8183",2018-03-16 08:22:06,316668.96,3316633.42
"8184",2018-03-16 08:22:06,599992.87,3916626.29
"8185",2018-03-16 08:22:06,599992.89,4516619.18
"8186",2018-03-16 08:22:06,599992.95,5116612.13
"8187",2018-03-16 08:22:06,599992.91,5716605.04
"8188",2018-03-16 08:22:06,599992.94,6316597.98
"8189",2018-03-16 08:22:06,599992.88,6916590.86
"8190",2018-03-16 08:22:06,262764.71,7179355.57
"8191",2018-03-16 08:28:02,-7179355.57,-3.72529029846191e-09
"8192",2018-03-16 14:01:37,33219.18,33219.1799999963
"8193",2018-03-16 14:01:37,1999993.17,2033212.35
"8194",2018-03-16 14:05:00,-2033212.35,-3.95812094211578e-09
"8195",2018-03-16 16:24:54,599993.35,599993.349999996
"8196",2018-03-16 16:24:54,599993.36,1199986.71
"8197",2018-03-16 16:24:54,599993.34,1799980.05
"8198",2018-03-16 16:24:54,393445.38,2193425.43
"8199",2018-03-16 16:24:54,599993.37,2793418.8
"8200",2018-03-16 16:41:58,-2793418.8,-3.72529029846191e-09
"8201",2018-03-16 22:29:42,238930.47,238930.469999996
"8202",2018-03-16 22:34:19,-238930.47,-3.72529029846191e-09
"8203",2018-03-17 05:15:54,1232475.3,1232475.3
"8204",2018-03-17 05:23:10,-1232475.3,-3.72529029846191e-09
"8205",2018-03-17 20:37:12,193992.75,193992.749999996
"8206",2018-03-17 20:37:12,599993.74,793986.489999996
"8207",2018-03-17 20:37:12,599993.71,1393980.2
"8208",2018-03-17 20:37:12,599993.73,1993973.93
"8209",2018-03-17 20:37:12,599993.72,2593967.65
"8210",2018-03-17 20:57:21,-2593967.65,-3.72529029846191e-09
"8211",2018-03-19 10:09:16,499994.68,499994.679999996
"8212",2018-03-19 10:09:16,499994.69,999989.369999996
"8213",2018-03-19 10:15:18,-999989.37,-3.72529029846191e-09
"8214",2018-03-19 10:27:02,499994.67,499994.669999996
"8215",2018-03-19 10:31:45,-499994.67,-3.72529029846191e-09
"8216",2018-03-19 14:09:40,483519.87,483519.869999996
"8217",2018-03-19 14:26:45,-483519.87,-3.72529029846191e-09
"8218",2018-03-20 16:27:12,540348.09,540348.089999996
"8219",2018-03-20 16:27:12,599996.08,1140344.17
"8220",2018-03-20 16:27:12,599996.07,1740340.24
"8221",2018-03-20 16:34:13,-1740340.24,-3.95812094211578e-09
"8222",2018-03-21 02:24:56,40408.14,40408.139999996
"8223",2018-03-21 02:39:34,-40408.14,-3.95812094211578e-09
"8224",2018-03-21 03:22:58,161313.34,161313.339999996
"8225",2018-03-21 03:38:24,-161313.34,-3.95812094211578e-09
"8226",2018-03-21 04:23:43,261565.26,261565.259999996
"8227",2018-03-21 04:39:00,-261565.26,-3.95812094211578e-09
"8228",2018-03-21 05:35:29,154255.86,154255.859999996
"8229",2018-03-21 05:39:35,-154255.86,-3.95812094211578e-09
"8230",2018-03-21 07:21:22,777797.78,777797.779999996
"8231",2018-03-21 07:24:38,-777797.78,-3.95812094211578e-09
"8232",2018-03-21 07:42:42,777783.93,777783.929999996
"8233",2018-03-21 07:47:21,-777783.93,-3.95812094211578e-09
"8234",2018-03-21 08:41:58,12793.16,12793.159999996
"8235",2018-03-21 08:41:58,279329.67,292122.829999996
"8236",2018-03-21 08:55:21,366005.62,658128.449999996
"8237",2018-03-21 08:55:21,-292122.83,366005.619999996
"8238",2018-03-21 09:15:06,-366005.62,-4.01632860302925e-09
"8239",2018-03-21 09:40:10,252639.67,252639.669999996
"8240",2018-03-21 09:47:07,-252639.67,-4.01632860302925e-09
"8241",2018-03-21 17:31:51,163100.51,163100.509999996
"8242",2018-03-21 17:31:51,599997.5,763098.009999996
"8243",2018-03-21 18:05:50,569191.36,1332289.37
"8244",2018-03-21 18:10:13,-763098.01,569191.359999996
"8245",2018-03-21 18:21:27,-569191.36,-4.07453626394272e-09
"8246",2018-03-22 02:00:11,452558.86,452558.859999996
"8247",2018-03-22 02:00:11,599997.85,1052556.71
"8248",2018-03-22 02:51:58,-1052556.71,-4.19095158576965e-09
"8249",2018-03-22 08:04:51,1819330.33,1819330.33
"8250",2018-03-22 08:16:26,-1819330.33,-4.19095158576965e-09
"8251",2018-03-22 16:34:30,288443.53,288443.529999996
"8252",2018-03-22 16:37:15,-288443.53,-4.19095158576965e-09
"8253",2018-03-22 18:04:26,777777.59,777777.589999996
"8254",2018-03-22 19:22:36,-777777.59,-4.19095158576965e-09
"8255",2018-03-22 23:33:50,777779.57,777779.569999996
"8256",2018-03-22 23:44:28,-777779.57,-4.19095158576965e-09
"8257",2018-03-23 02:54:01,1210653.5,1210653.5
"8258",2018-03-23 02:56:46,-1210653.5,-4.19095158576965e-09
"8259",2018-03-23 08:55:01,1357780.23,1357780.23
"8260",2018-03-23 09:10:21,-1357780.23,-4.19095158576965e-09
"8261",2018-03-23 10:10:20,201704.14,201704.139999996
"8262",2018-03-23 10:26:00,-201704.14,-4.19095158576965e-09
"8263",2018-03-23 12:33:16,17403.48,17403.4799999958
"8264",2018-03-23 12:41:50,186299.49,203702.969999996
"8265",2018-03-23 12:41:50,-17403.48,186299.489999996
"8266",2018-03-23 12:56:41,-186299.49,-4.19095158576965e-09
"8267",2018-03-23 13:40:38,118819.71,118819.709999996
"8268",2018-03-23 13:45:41,-118819.71,-4.19095158576965e-09
"8269",2018-03-23 14:44:06,99895.97,99895.9699999958
"8270",2018-03-23 14:49:35,16110.8,116006.769999996
"8271",2018-03-23 14:49:35,-99895.97,16110.7999999958
"8272",2018-03-23 15:16:43,140192.06,156302.859999996
"8273",2018-03-23 15:16:43,599994.04,756296.899999996
"8274",2018-03-23 15:16:43,599994.05,1356290.95
"8275",2018-03-23 15:16:43,599994.03,1956284.98
"8276",2018-03-23 15:16:43,599994.02,2556279
"8277",2018-03-23 15:16:43,-16110.8,2540168.2
"8278",2018-03-23 15:38:53,-2540168.2,-3.72529029846191e-09
"8279",2018-03-24 03:53:30,1020144.67,1020144.67
"8280",2018-03-24 04:02:10,-1020144.67,-3.72529029846191e-09
"8281",2018-03-24 18:13:36,361800.28,361800.279999996
"8282",2018-03-24 18:15:21,-361800.28,-3.72529029846191e-09
"8283",2018-03-25 04:34:53,675809.33,675809.329999996
"8284",2018-03-25 04:36:22,-675809.33,-3.72529029846191e-09
"8285",2018-03-26 10:50:55,769001.79,769001.789999996
"8286",2018-03-26 11:19:33,-769001.79,-3.72529029846191e-09
"8287",2018-03-26 17:07:41,793526.95,793526.949999996
"8288",2018-03-26 17:12:07,-793526.95,-3.72529029846191e-09
"8289",2018-03-26 18:22:59,1172832.13,1172832.13
"8290",2018-03-26 18:45:21,-1172832.13,-3.72529029846191e-09
"8291",2018-03-27 02:27:27,680008.59,680008.589999996
"8292",2018-03-27 02:36:43,-680008.59,-3.72529029846191e-09
"8293",2018-03-27 05:44:42,73080.06,73080.0599999963
"8294",2018-03-27 05:44:42,599996.05,673076.109999996
"8295",2018-03-27 05:49:03,-673076.11,-3.60887497663498e-09
"8296",2018-03-27 12:49:11,37322.09,37322.0899999964
"8297",2018-03-27 13:22:18,599996.23,637318.319999996
"8298",2018-03-27 13:43:19,-37322.09,599996.229999996
"8299",2018-03-27 14:03:35,-599996.23,-3.60887497663498e-09
"8300",2018-03-28 06:25:41,629572.79,629572.789999996
"8301",2018-03-28 07:08:27,-629572.79,-3.60887497663498e-09
"8302",2018-03-28 07:27:52,151419.79,151419.789999996
"8303",2018-03-28 07:27:52,599996.77,751416.559999996
"8304",2018-03-28 07:27:52,599996.78,1351413.34
"8305",2018-03-28 07:51:51,-1351413.34,-3.49245965480804e-09
"8306",2018-03-28 12:59:34,590122.72,590122.719999996
"8307",2018-03-28 13:01:34,-590122.72,-3.49245965480804e-09
"8308",2018-03-29 01:05:30,599997.12,599997.119999997
"8309",2018-03-29 01:05:30,308781.13,908778.249999997
"8310",2018-03-29 01:09:39,-908778.25,-3.49245965480804e-09
"8311",2018-03-29 23:43:18,580008.23,580008.229999996
"8312",2018-03-29 23:43:18,570008.22,1150016.45
"8313",2018-03-29 23:43:18,585008.24,1735024.69
"8314",2018-03-30 00:05:17,-1735024.69,-3.49245965480804e-09
"8315",2018-03-30 16:23:43,599998.84,599998.839999996
"8316",2018-03-30 16:23:43,231922.86,831921.699999996
"8317",2018-03-30 16:23:43,599998.85,1431920.55
"8318",2018-03-30 16:38:05,488288.89,1920209.44
"8319",2018-03-30 16:38:05,599998.88,2520208.32
"8320",2018-03-30 16:38:05,599998.87,3120207.19
"8321",2018-03-30 16:43:42,-1431920.55,1688286.64
"8322",2018-03-30 16:52:12,-1688286.64,-3.25962901115417e-09
"8323",2018-03-30 22:27:09,3578434.46,3578434.46
"8324",2018-03-30 22:29:59,-3578434.46,-3.25962901115417e-09
"8325",2018-03-31 11:05:05,903624.69,903624.689999997
"8326",2018-03-31 11:16:38,-903624.69,-3.25962901115417e-09
"8327",2018-04-01 01:51:34,1491452.69,1491452.69
"8328",2018-04-01 01:58:55,-1491452.69,-3.25962901115417e-09
"8329",2018-04-02 21:35:59,599999.85,599999.849999997
"8330",2018-04-02 21:35:59,591795.86,1191795.71
"8331",2018-04-02 21:50:26,-1191795.71,-3.25962901115417e-09
"8332",2018-04-04 03:28:23,1218269.67,1218269.67
"8333",2018-04-04 03:53:40,-1218269.67,-3.25962901115417e-09
"8334",2018-04-04 13:57:49,520232.09,520232.089999997
"8335",2018-04-04 13:57:49,599990.08,1120222.17
"8336",2018-04-04 14:43:14,-1120222.17,-3.25962901115417e-09
"8337",2018-04-04 14:55:11,599990.15,599990.149999997
"8338",2018-04-04 14:55:11,599990.16,1199980.31
"8339",2018-04-04 14:55:11,233326.17,1433306.48
"8340",2018-04-04 15:15:33,-1199980.31,233326.169999997
"8341",2018-04-04 15:24:27,-233326.17,-3.34694050252438e-09
"8342",2018-04-05 17:29:32,551665.13,551665.129999997
"8343",2018-04-05 17:43:05,-551665.13,-3.37604433298111e-09
"8344",2018-04-05 22:26:23,1375432.92,1375432.92
"8345",2018-04-05 22:35:16,-1375432.92,-3.25962901115417e-09
"8346",2018-04-06 11:35:09,599990.67,599990.669999997
"8347",2018-04-06 11:35:09,599990.66,1199981.33
"8348",2018-04-06 11:35:09,323302.68,1523284.01
"8349",2018-04-06 11:54:23,-1523284.01,-3.25962901115417e-09
"8350",2018-04-06 17:09:28,599990.74,599990.739999997
"8351",2018-04-06 17:09:28,255150.75,855141.489999997
"8352",2018-04-06 17:14:28,-855141.49,-3.25962901115417e-09
"8353",2018-04-06 23:54:08,1297719.41,1297719.41
"8354",2018-04-07 00:18:25,-1297719.41,-3.25962901115417e-09
"8355",2018-04-07 04:14:40,783320.63,783320.629999997
"8356",2018-04-07 04:28:47,-783320.63,-3.25962901115417e-09
"8357",2018-04-07 11:48:07,1101743.67,1101743.67
"8358",2018-04-07 11:52:28,-1101743.67,-3.25962901115417e-09
"8359",2018-04-07 16:39:16,1191488.57,1191488.57
"8360",2018-04-07 16:51:45,-1191488.57,-3.25962901115417e-09
"8361",2018-04-10 00:02:02,1320237.78,1320237.78
"8362",2018-04-10 00:17:36,-1320237.78,-3.25962901115417e-09
"8363",2018-04-12 03:57:24,599991.67,599991.669999997
"8364",2018-04-12 03:57:24,599991.66,1199983.33
"8365",2018-04-12 03:57:24,33851.68,1233835.01
"8366",2018-04-12 04:12:54,-1233835.01,-3.25962901115417e-09
"8367",2018-04-12 08:29:35,2099713.34,2099713.34
"8368",2018-04-12 08:45:17,-2099713.34,-3.25962901115417e-09
"8369",2018-04-12 12:17:30,1042364.86,1042364.86
"8370",2018-04-12 12:17:30,1999991.85,3042356.71
"8371",2018-04-12 12:17:30,1818319.38,4860676.09
"8372",2018-04-12 12:31:44,1081377.54,5942053.63
"8373",2018-04-12 12:31:44,-4860676.09,1081377.54
"8374",2018-04-12 12:45:29,-1081377.54,-3.72529029846191e-09
"8375",2018-04-12 14:30:54,1870430.96,1870430.96
"8376",2018-04-12 14:51:36,1999991.95,3870422.91
"8377",2018-04-12 15:18:15,1999991.97,5870414.88
"8378",2018-04-12 15:18:15,984656.98,6855071.86
"8379",2018-04-12 15:18:15,-1870430.96,4984640.9
"8380",2018-04-12 15:51:26,1467656.9,6452297.8
"8381",2018-04-12 16:59:28,600254.03,7052551.83
"8382",2018-04-12 16:59:28,1999992.02,9052543.85
"8383",2018-04-12 16:59:28,1899306.28,10951850.13
"8384",2018-04-12 16:59:31,-4984640.9,5967209.22999999
"8385",2018-04-12 17:11:55,-5967209.23,-5.58793544769287e-09
"8386",2018-04-13 01:38:52,1549679.78,1549679.77999999
"8387",2018-04-13 01:43:19,-1549679.78,-5.58793544769287e-09
"8388",2018-04-13 21:07:28,599992.38,599992.379999994
"8389",2018-04-13 21:07:28,599992.35,1199984.72999999
"8390",2018-04-13 21:07:28,599992.36,1799977.08999999
"8391",2018-04-13 21:07:28,599992.37,2399969.45999999
"8392",2018-04-13 21:07:28,78612.39,2478581.84999999
"8393",2018-04-13 21:21:43,-2478581.85,-5.58793544769287e-09
"8394",2018-04-13 21:24:01,237268.41,237268.409999994
"8395",2018-04-13 21:30:32,1999992.4,2237260.80999999
"8396",2018-04-13 21:30:32,-237268.41,1999992.39999999
"8397",2018-04-13 21:53:38,-1999992.4,-5.355104804039e-09
"8398",2018-04-14 00:33:33,1139386.51,1139386.50999999
"8399",2018-04-14 00:46:54,-1139386.51,-5.355104804039e-09
"8400",2018-04-20 05:30:35,264223.78,264223.779999995
"8401",2018-04-20 05:30:35,1999993.77,2264217.54999999
"8402",2018-04-20 05:35:38,-2264217.55,-5.12227416038513e-09
"8403",2018-04-21 11:18:04,108401.12,108401.119999995
"8404",2018-04-21 11:18:04,1999994.11,2108395.22999999
"8405",2018-04-21 11:22:55,-2108395.23,-5.12227416038513e-09
"8406",2018-04-21 11:30:20,740405.37,740405.369999995
"8407",2018-04-21 11:34:57,-740405.37,-5.12227416038513e-09
"8408",2018-04-21 12:29:03,1182564.21,1182564.20999999
"8409",2018-04-21 12:33:15,-1182564.21,-5.12227416038513e-09
"8410",2018-04-22 13:11:09,661769.06,661769.059999995
"8411",2018-04-22 13:15:10,-661769.06,-5.12227416038513e-09
"8412",2018-04-22 14:42:32,1116293.27,1116293.26999999
"8413",2018-04-22 15:04:12,-1116293.27,-5.12227416038513e-09
"8414",2018-04-23 10:33:48,1337148.3,1337148.29999999
"8415",2018-04-23 10:41:08,-1337148.3,-5.12227416038513e-09
"8416",2018-04-24 11:21:28,963510.93,963510.929999995
"8417",2018-04-24 11:21:28,1999994.92,2963505.84999999
"8418",2018-04-24 11:35:26,-2963505.85,-5.12227416038513e-09
"8419",2018-04-24 21:14:06,599995.1,599995.099999995
"8420",2018-04-24 21:14:06,599995.09,1199990.18999999
"8421",2018-04-24 21:14:06,599995.08,1799985.26999999
"8422",2018-04-24 21:14:06,537399.11,2337384.37999999
"8423",2018-04-24 21:16:46,-2337384.38,-5.12227416038513e-09
"8424",2018-04-25 06:19:59,419927.31,419927.309999995
"8425",2018-04-25 06:26:42,219021.31,638948.619999995
"8426",2018-04-25 07:25:25,-419927.31,219021.309999995
"8427",2018-04-25 07:30:02,1999996.41,2219017.71999999
"8428",2018-04-25 07:30:02,1999996.4,4219014.11999999
"8429",2018-04-25 07:30:02,1999996.39,6219010.50999999
"8430",2018-04-25 07:30:02,1045315.42,7264325.92999999
"8431",2018-04-25 07:53:53,-7264325.93,-5.58793544769287e-09
"8432",2018-04-25 08:22:03,2282833.12,2282833.11999999
"8433",2018-04-25 08:22:03,599996.52,2882829.63999999
"8434",2018-04-25 08:22:03,599996.5,3482826.13999999
"8435",2018-04-25 08:22:03,23377.53,3506203.66999999
"8436",2018-04-25 08:22:03,599996.51,4106200.17999999
"8437",2018-04-25 08:39:00,-4106200.18,-6.05359673500061e-09
"8438",2018-04-25 13:31:46,358056.73,358056.729999994
"8439",2018-04-25 14:09:53,1338230.19,1696286.91999999
"8440",2018-04-25 14:37:10,-358056.73,1338230.18999999
"8441",2018-04-25 14:48:20,-1338230.19,-6.05359673500061e-09
"8442",2018-04-25 16:47:51,1656009.51,1656009.50999999
"8443",2018-04-25 16:47:51,1999997.49,3656006.99999999
"8444",2018-04-25 16:47:51,1999997.5,5656004.49999999
"8445",2018-04-25 16:47:51,1999997.48,7656001.97999999
"8446",2018-04-25 17:47:30,280707.68,7936709.65999999
"8447",2018-04-25 17:47:30,1061451.79,8998161.45
"8448",2018-04-25 17:47:30,1999997.67,10998159.12
"8449",2018-04-25 18:57:36,-7656001.98,3342157.14
"8450",2018-04-25 19:05:20,-3342157.14,-5.12227416038513e-09
"8451",2018-04-25 20:05:27,599997.34,599997.339999995
"8452",2018-04-25 20:05:27,437195.35,1037192.68999999
"8453",2018-04-25 20:17:54,-1037192.69,-5.12227416038513e-09
"8454",2018-04-25 20:18:54,361299.06,361299.059999995
"8455",2018-04-25 20:38:13,-361299.06,-5.12227416038513e-09
"8456",2018-05-03 03:40:13,599990.17,599990.169999995
"8457",2018-05-03 03:40:13,34050.2,634040.369999995
"8458",2018-05-03 03:40:13,599990.18,1234030.54999999
"8459",2018-05-03 03:40:13,599990.16,1834020.70999999
"8460",2018-05-03 03:40:13,599990.19,2434010.89999999
"8461",2018-05-03 03:40:13,599990.14,3034001.03999999
"8462",2018-05-03 03:40:13,599990.15,3633991.18999999
"8463",2018-05-03 04:16:02,-3633991.19,-5.12227416038513e-09
"8464",2018-05-03 19:49:38,599990.59,599990.589999995
"8465",2018-05-03 19:49:38,599990.58,1199981.16999999
"8466",2018-05-03 19:49:38,599990.6,1799971.76999999
"8467",2018-05-03 19:49:38,599990.62,2399962.39
"8468",2018-05-03 19:49:38,599990.61,2999952.99999999
"8469",2018-05-03 19:49:38,29559.64,3029512.64
"8470",2018-05-03 19:49:38,599990.63,3629503.26999999
"8471",2018-05-03 20:30:26,-3629503.27,-5.12227416038513e-09
"8472",2018-05-05 03:55:52,1295774.86,1295774.85999999
"8473",2018-05-05 04:01:59,-1295774.86,-5.12227416038513e-09
"8474",2018-05-05 21:52:49,2976321.92,2976321.91999999
"8475",2018-05-05 22:21:45,-2976321.92,-5.12227416038513e-09
"8476",2018-05-08 12:57:30,3000020.9,3000020.89999999
"8477",2018-05-08 14:12:57,159882.82,3159903.71999999
"8478",2018-05-08 14:12:57,1999992.81,5159896.52999999
"8479",2018-05-08 14:25:15,-3000020.9,2159875.62999999
"8480",2018-05-08 14:59:06,-2159875.63,-5.12227416038513e-09
"8481",2018-05-09 14:51:13,3777798.36,3777798.35999999
"8482",2018-05-09 15:07:29,-3777798.36,-5.12227416038513e-09
"8483",2018-05-10 15:42:26,3000021.69,3000021.68999999
"8484",2018-05-10 15:48:57,-3000021.69,-5.12227416038513e-09
"8485",2018-05-12 01:39:43,1615522.27,1615522.26999999
"8486",2018-05-12 02:11:05,-1615522.27,-5.12227416038513e-09
"8487",2018-05-12 16:15:55,1999996.13,1999996.12999999
"8488",2018-05-12 16:21:40,94377.78,2094373.90999999
"8489",2018-05-12 16:21:40,431671.14,2526045.04999999
"8490",2018-05-12 16:21:40,-1999996.13,526048.919999995
"8491",2018-05-12 16:31:33,541975.45,1068024.36999999
"8492",2018-05-12 16:31:33,-526048.92,541975.449999995
"8493",2018-05-12 16:37:22,-541975.45,-5.23868948221207e-09
"8494",2018-05-14 17:23:58,599997.17,599997.169999995
"8495",2018-05-14 17:23:58,226065.18,826062.349999995
"8496",2018-05-14 17:28:25,-826062.35,-5.23868948221207e-09
"8497",2018-05-14 17:43:25,599997.37,599997.369999995
"8498",2018-05-14 17:43:25,99916.38,699913.749999995
"8499",2018-05-14 17:43:25,599997.36,1299911.10999999
"8500",2018-05-14 17:43:25,599997.35,1899908.45999999
"8501",2018-05-14 17:46:05,-1899908.46,-5.12227416038513e-09
"8502",2018-05-14 22:16:03,1249651.93,1249651.92999999
"8503",2018-05-14 22:19:40,-1249651.93,-5.12227416038513e-09
"8504",2018-05-15 02:01:23,1128186.85,1128186.84999999
"8505",2018-05-15 02:04:28,-1128186.85,-5.12227416038513e-09
"8506",2018-05-15 20:08:52,599997.94,599997.939999995
"8507",2018-05-15 20:08:52,447304.95,1047302.88999999
"8508",2018-05-15 20:21:10,-1047302.89,-5.23868948221207e-09
"8509",2018-05-15 22:09:20,1305559.88,1305559.87999999
"8510",2018-05-15 22:35:11,-1305559.88,-5.12227416038513e-09
"8511",2018-05-15 23:24:30,1146153.32,1146153.31999999
"8512",2018-05-15 23:33:46,-1146153.32,-5.12227416038513e-09
"8513",2018-05-16 14:33:40,442407.09,442407.089999995
"8514",2018-05-16 14:33:40,599998.08,1042405.16999999
"8515",2018-05-16 14:39:31,-1042405.17,-5.23868948221207e-09
"8516",2018-05-16 22:58:25,1385747.07,1385747.06999999
"8517",2018-05-16 23:09:05,-1385747.07,-5.355104804039e-09
"8518",2018-05-18 04:43:55,599999.94,599999.939999995
"8519",2018-05-18 04:43:55,68599.95,668599.889999995
"8520",2018-05-18 04:43:55,599999.93,1268599.81999999
"8521",2018-05-18 04:47:40,-1268599.82,-5.355104804039e-09
"8522",2018-05-18 14:21:33,302408.08,302408.079999995
"8523",2018-05-18 14:21:33,599990.07,902398.149999995
"8524",2018-05-18 14:21:33,599990.06,1502388.20999999
"8525",2018-05-18 14:21:33,599990.05,2102378.25999999
"8526",2018-05-18 14:42:41,-2102378.26,-5.12227416038513e-09
"8527",2018-05-18 14:51:31,135100.12,135100.119999995
"8528",2018-05-18 14:51:31,599990.1,735090.219999995
"8529",2018-05-18 14:51:31,599990.11,1335080.32999999
"8530",2018-05-18 15:59:47,-1335080.33,-5.12227416038513e-09
"8531",2018-05-19 00:07:52,1999990.13,1999990.12999999
"8532",2018-05-19 00:33:21,92825.14,2092815.26999999
"8533",2018-05-19 00:33:21,-1999990.13,92825.1399999948
"8534",2018-05-19 00:48:11,-92825.14,-5.2241375669837e-09
"8535",2018-05-20 03:13:34,599990.22,599990.219999995
"8536",2018-05-20 03:13:34,599990.21,1199980.42999999
"8537",2018-05-20 03:13:34,483423.23,1683403.65999999
"8538",2018-05-20 03:24:51,-1683403.66,-5.355104804039e-09
"8539",2018-05-23 07:57:29,97330.61,97330.6099999946
"8540",2018-05-23 08:08:02,-97330.61,-5.355104804039e-09
"8541",2018-05-23 08:15:52,1009647.42,1009647.41999999
"8542",2018-05-23 08:35:05,-1009647.42,-5.355104804039e-09
"8543",2018-05-23 16:24:18,704419.81,704419.809999995
"8544",2018-05-23 16:40:30,-704419.81,-5.355104804039e-09
"8545",2018-05-23 16:42:03,599993.88,599993.879999995
"8546",2018-05-23 16:42:03,439350.89,1039344.76999999
"8547",2018-05-23 16:47:59,-1039344.77,-5.355104804039e-09
"8548",2018-05-24 09:46:25,555559.43,555559.429999995
"8549",2018-05-24 09:58:41,-555559.43,-5.355104804039e-09
"8550",2018-05-24 18:21:29,686171.7,686171.699999995
"8551",2018-05-24 18:25:48,-686171.7,-5.355104804039e-09
"8552",2018-05-25 06:59:18,619500.01,619500.009999995
"8553",2018-05-25 07:05:22,-619500.01,-5.355104804039e-09
"8554",2018-05-25 11:37:22,625410.51,625410.509999995
"8555",2018-05-25 11:46:02,-625410.51,-5.355104804039e-09
"8556",2018-05-26 01:06:15,290950.12,290950.119999995
"8557",2018-05-26 01:06:15,599995.11,890945.229999995
"8558",2018-05-26 01:12:42,-890945.23,-5.355104804039e-09
"8559",2018-05-26 07:44:07,787782.48,787782.479999995
"8560",2018-05-26 07:48:13,-787782.48,-5.355104804039e-09
"8561",2018-05-26 17:36:18,702962.83,702962.829999995
"8562",2018-05-26 17:39:36,-702962.83,-5.355104804039e-09
"8563",2018-05-27 01:35:38,431200.45,431200.449999995
"8564",2018-05-27 01:35:38,599995.44,1031195.88999999
"8565",2018-05-27 01:41:36,-1031195.89,-5.47152012586594e-09
"8566",2018-05-27 08:10:31,1195074.55,1195074.54999999
"8567",2018-05-27 08:15:36,-1195074.55,-5.355104804039e-09
"8568",2018-05-27 09:55:23,233821.05,233821.049999995
"8569",2018-05-27 10:03:30,-233821.05,-5.355104804039e-09
"8570",2018-05-27 11:15:15,332599.54,332599.539999995
"8571",2018-05-27 11:22:38,-332599.54,-5.355104804039e-09
"8572",2018-05-27 12:02:21,135122.9,135122.899999995
"8573",2018-05-27 12:14:37,-135122.9,-5.355104804039e-09
"8574",2018-05-27 13:27:39,117103.56,117103.559999995
"8575",2018-05-27 13:40:37,-117103.56,-5.355104804039e-09
"8576",2018-05-27 14:19:30,11521.43,11521.4299999946
"8577",2018-05-27 14:22:05,-11521.43,-5.355104804039e-09
"8578",2018-05-27 15:10:56,37603.08,37603.0799999946
"8579",2018-05-27 15:13:50,-37603.08,-5.355104804039e-09
"8580",2018-05-27 16:20:19,377783.66,377783.659999995
"8581",2018-05-27 16:43:47,-377783.66,-5.355104804039e-09
"8582",2018-05-27 17:01:48,21302.73,21302.7299999946
"8583",2018-05-27 17:05:13,-21302.73,-5.355104804039e-09
"8584",2018-05-27 17:23:07,777784.06,777784.059999995
"8585",2018-05-27 17:34:53,-777784.06,-5.355104804039e-09
"8586",2018-05-27 19:14:45,101149.44,101149.439999995
"8587",2018-05-27 19:24:10,-101149.44,-5.355104804039e-09
"8588",2018-05-27 19:38:38,246658.24,246658.239999995
"8589",2018-05-27 19:45:02,-246658.24,-5.355104804039e-09
"8590",2018-05-27 21:34:29,112611.06,112611.059999995
"8591",2018-05-27 21:45:05,-112611.06,-5.355104804039e-09
"8592",2018-05-27 23:20:34,87677.9,87677.8999999946
"8593",2018-05-27 23:37:49,-87677.9,-5.355104804039e-09
"8594",2018-05-28 03:51:27,377786.19,377786.189999995
"8595",2018-05-28 04:03:09,-377786.19,-5.355104804039e-09
"8596",2018-05-28 04:47:53,17714.34,17714.3399999946
"8597",2018-05-28 05:00:31,377786.66,395500.999999995
"8598",2018-05-28 05:00:31,-17714.34,377786.659999995
"8599",2018-05-28 05:07:11,-377786.66,-5.355104804039e-09
"8600",2018-05-28 05:11:10,777786.87,777786.869999995
"8601",2018-05-28 05:27:19,-777786.87,-5.355104804039e-09
"8602",2018-05-28 05:39:07,15361.68,15361.6799999946
"8603",2018-05-28 06:17:42,33170.08,48531.7599999946
"8604",2018-05-28 06:17:42,12821.52,61353.2799999946
"8605",2018-05-28 06:17:42,-15361.68,45991.5999999946
"8606",2018-05-28 06:24:23,115610.55,161602.149999995
"8607",2018-05-28 06:24:23,-45991.6,115610.549999995
"8608",2018-05-28 07:51:36,-115610.55,-5.36965671926737e-09
"8609",2018-05-28 08:49:08,852600.73,852600.729999995
"8610",2018-05-28 09:01:00,-852600.73,-5.355104804039e-09
"8611",2018-05-28 09:56:06,599990.79,599990.789999995
"8612",2018-05-28 09:56:06,599990.78,1199981.56999999
"8613",2018-05-28 09:56:06,569346.82,1769328.38999999
"8614",2018-05-28 09:56:06,599990.8,2369319.18999999
"8615",2018-05-28 09:56:06,599990.81,2969309.99999999
"8616",2018-05-28 09:56:06,599990.77,3569300.76999999
"8617",2018-05-28 10:09:37,-3569300.77,-5.12227416038513e-09
"8618",2018-05-29 05:58:03,1724757.14,1724757.13999999
"8619",2018-05-29 06:04:32,-1724757.14,-5.12227416038513e-09
"8620",2018-05-29 20:46:14,77329.43,77329.4299999949
"8621",2018-05-29 21:10:00,-77329.43,-5.12227416038513e-09
"8622",2018-05-31 12:33:15,599991.5,599991.499999995
"8623",2018-05-31 12:33:15,599991.51,1199983.00999999
"8624",2018-05-31 12:33:15,499070.52,1699053.52999999
"8625",2018-05-31 12:41:25,-1699053.53,-5.12227416038513e-09
"8626",2018-06-02 17:28:28,599992.65,599992.649999995
"8627",2018-06-02 17:36:29,-599992.65,-5.12227416038513e-09
"8628",2018-06-02 17:36:29,599992.66,599992.659999995
"8629",2018-06-02 17:36:29,599992.67,1199985.32999999
"8630",2018-06-02 17:36:29,497350.68,1697336.00999999
"8631",2018-06-02 17:39:58,-1697336.01,-5.12227416038513e-09
"8632",2018-06-04 17:16:25,1999993.06,1999993.05999999
"8633",2018-06-04 17:16:25,203407.07,2203400.12999999
"8634",2018-06-04 17:29:10,-2203400.13,-5.12227416038513e-09
"8635",2018-06-10 08:48:07,412707.32,412707.319999995
"8636",2018-06-10 09:15:38,-412707.32,-5.12227416038513e-09
"8637",2018-06-11 07:11:50,19883.28,19883.2799999949
"8638",2018-06-11 07:23:36,39873.69,59756.9699999949
"8639",2018-06-11 07:23:36,-19883.28,39873.6899999949
"8640",2018-06-11 07:42:37,-39873.69,-5.12227416038513e-09
"8641",2018-06-11 08:37:51,12413.06,12413.0599999949
"8642",2018-06-11 08:37:51,397031.62,409444.679999995
"8643",2018-06-11 08:50:09,-409444.68,-5.12227416038513e-09
"8644",2018-06-11 09:23:44,42352.54,42352.5399999949
"8645",2018-06-11 09:29:37,-42352.54,-5.12227416038513e-09
"8646",2018-06-11 12:13:31,125255.71,125255.709999995
"8647",2018-06-11 12:21:46,-125255.71,-5.12227416038513e-09
"8648",2018-06-11 15:57:02,131205.22,131205.219999995
"8649",2018-06-11 16:07:40,90164.59,221369.809999995
"8650",2018-06-11 16:07:40,-131205.22,90164.5899999949
"8651",2018-06-11 16:27:56,74243.67,164408.259999995
"8652",2018-06-11 16:27:56,-90164.59,74243.6699999949
"8653",2018-06-11 16:38:51,-74243.67,-5.10772224515676e-09
"8654",2018-06-11 16:57:22,74527.46,74527.4599999949
"8655",2018-06-11 17:01:55,73575,148102.459999995
"8656",2018-06-11 17:01:55,-74527.46,73574.9999999949
"8657",2018-06-11 17:11:07,-73575,-5.10772224515676e-09
"8658",2018-06-11 17:11:07,599995.65,599995.649999995
"8659",2018-06-11 17:11:07,599995.66,1199991.30999999
"8660",2018-06-11 17:11:07,494498.67,1694489.97999999
"8661",2018-06-11 17:23:40,706597.44,2401087.41999999
"8662",2018-06-11 17:23:40,-1694489.98,706597.439999995
"8663",2018-06-11 17:33:27,-706597.44,-5.12227416038513e-09
"8664",2018-06-11 23:43:32,409054.03,409054.029999995
"8665",2018-06-12 00:11:41,-409054.03,-5.12227416038513e-09
"8666",2018-06-12 00:15:40,273007,273006.999999995
"8667",2018-06-12 00:25:32,-273007,-5.12227416038513e-09
"8668",2018-06-12 05:51:44,657907.99,657907.989999995
"8669",2018-06-12 05:56:29,-657907.99,-5.12227416038513e-09
"8670",2018-06-12 13:09:10,735574.03,735574.029999995
"8671",2018-06-12 13:21:04,-735574.03,-5.12227416038513e-09
"8672",2018-06-12 17:49:23,599996.63,599996.629999995
"8673",2018-06-12 18:10:05,-599996.63,-5.12227416038513e-09
"8674",2018-06-12 20:44:04,41844.95,41844.9499999949
"8675",2018-06-12 21:24:31,29464.76,71309.7099999949
"8676",2018-06-12 21:24:31,-41844.95,29464.7599999949
"8677",2018-06-12 21:34:46,-29464.76,-5.12591213919222e-09
"8678",2018-06-12 22:04:05,599996.78,599996.779999995
"8679",2018-06-12 22:11:10,-599996.78,-5.12227416038513e-09
"8680",2018-06-12 22:26:54,711940.33,711940.329999995
"8681",2018-06-12 22:26:54,55562.41,767502.739999995
"8682",2018-06-12 22:31:23,-767502.74,-5.12227416038513e-09
"8683",2018-06-12 22:36:47,570601.51,570601.509999995
"8684",2018-06-12 22:43:01,-570601.51,-5.12227416038513e-09
"8685",2018-06-12 22:58:40,599997.53,599997.529999995
"8686",2018-06-12 23:05:48,-599997.53,-5.12227416038513e-09
"8687",2018-06-13 08:40:42,219960.72,219960.719999995
"8688",2018-06-13 08:43:02,-219960.72,-5.12227416038513e-09
"8689",2018-06-13 09:56:08,274448.4,274448.399999995
"8690",2018-06-13 10:02:37,129777.38,404225.779999995
"8691",2018-06-13 10:26:27,148409.57,552635.349999995
"8692",2018-06-13 10:26:27,394271.79,946907.139999995
"8693",2018-06-13 10:26:27,-274448.4,672458.739999995
"8694",2018-06-13 11:04:23,135390.29,807849.029999995
"8695",2018-06-13 11:04:23,-672458.74,135390.289999995
"8696",2018-06-13 11:13:22,291967.11,427357.399999995
"8697",2018-06-13 11:13:22,-135390.29,291967.109999995
"8698",2018-06-13 11:36:36,-291967.11,-5.0058588385582e-09
"8699",2018-06-13 12:28:11,339488.27,339488.269999995
"8700",2018-06-13 12:32:52,-339488.27,-5.0058588385582e-09
"8701",2018-06-13 14:56:18,422503.66,422503.659999995
"8702",2018-06-13 15:24:55,-422503.66,-5.0058588385582e-09
"8703",2018-06-13 15:55:13,359350.73,359350.729999995
"8704",2018-06-13 16:08:18,-359350.73,-5.0058588385582e-09
"8705",2018-06-13 16:53:38,226038.73,226038.729999995
"8706",2018-06-13 17:13:20,-226038.73,-5.0058588385582e-09
"8707",2018-06-13 17:25:26,555564.4,555564.399999995
"8708",2018-06-13 17:30:38,-555564.4,-5.0058588385582e-09
"8709",2018-06-13 17:40:53,315559.82,315559.819999995
"8710",2018-06-13 17:46:23,-315559.82,-5.0058588385582e-09
"8711",2018-06-13 17:47:07,599999.49,599999.489999995
"8712",2018-06-13 17:55:08,-599999.49,-5.0058588385582e-09
"8713",2018-06-13 19:23:53,354941.06,354941.059999995
"8714",2018-06-13 19:55:37,-354941.06,-5.0058588385582e-09
"8715",2018-06-13 21:08:51,599999.59,599999.589999995
"8716",2018-06-13 21:37:37,-599999.59,-5.0058588385582e-09
"8717",2018-06-14 17:00:32,599990.05,599990.049999995
"8718",2018-06-14 17:04:23,-599990.05,-5.0058588385582e-09
"8719",2018-06-14 17:14:20,599990.12,599990.119999995
"8720",2018-06-14 17:19:41,-599990.12,-5.0058588385582e-09
"8721",2018-06-16 10:40:13,599990.62,599990.619999995
"8722",2018-06-16 10:59:32,-599990.62,-5.0058588385582e-09
"8723",2018-06-16 16:29:49,599990.75,599990.749999995
"8724",2018-06-16 16:39:17,-599990.75,-5.0058588385582e-09
"8725",2018-06-16 16:47:13,599990.81,599990.809999995
"8726",2018-06-16 16:52:15,-599990.81,-5.0058588385582e-09
"8727",2018-06-17 07:55:48,599990.85,599990.849999995
"8728",2018-06-17 08:30:28,-599990.85,-5.0058588385582e-09
"8729",2018-06-18 16:59:11,939665.87,939665.869999995
"8730",2018-06-18 17:13:27,-939665.87,-5.0058588385582e-09
"8731",2018-06-19 10:06:02,153714.27,153714.269999995
"8732",2018-06-19 10:12:17,-153714.27,-5.0058588385582e-09
"8733",2018-06-19 11:43:14,599991.18,599991.179999995
"8734",2018-06-19 12:16:07,-599991.18,-5.0058588385582e-09
"8735",2018-06-20 02:59:33,1034700.67,1034700.67
"8736",2018-06-20 03:37:38,-1034700.67,-5.0058588385582e-09
"8737",2018-06-20 03:55:43,559472.9,559472.899999995
"8738",2018-06-20 03:55:43,808584.7,1368057.59999999
"8739",2018-06-20 04:19:46,599991.31,1968048.91
"8740",2018-06-20 04:19:46,-1368057.6,599991.309999995
"8741",2018-06-20 04:47:22,-599991.31,-5.12227416038513e-09
"8742",2018-06-21 14:15:56,3000003.38,3000003.37999999
"8743",2018-06-21 14:21:51,-3000003.38,-5.12227416038513e-09
"8744",2018-06-24 16:54:30,599993.34,599993.339999995
"8745",2018-06-24 16:58:54,-599993.34,-5.12227416038513e-09
"8746",2018-06-24 17:53:10,1047071.63,1047071.62999999
"8747",2018-06-24 18:16:59,-1047071.63,-5.12227416038513e-09
"8748",2018-06-26 05:42:04,944054.94,944054.939999995
"8749",2018-06-26 05:48:48,-944054.94,-5.12227416038513e-09
"8750",2018-06-26 15:59:23,599994.05,599994.049999995
"8751",2018-06-26 16:07:27,-599994.05,-5.12227416038513e-09
"8752",2018-06-26 16:11:08,599994.09,599994.089999995
"8753",2018-06-26 16:17:48,-599994.09,-5.12227416038513e-09
"8754",2018-06-27 11:11:18,599994.18,599994.179999995
"8755",2018-06-27 11:29:29,-599994.18,-5.12227416038513e-09
"8756",2018-06-27 22:13:08,599994.25,599994.249999995
"8757",2018-06-27 22:20:21,-599994.25,-5.12227416038513e-09
"8758",2018-06-28 12:59:02,599994.3,599994.299999995
"8759",2018-06-28 13:28:22,-599994.3,-5.12227416038513e-09
"8760",2018-06-28 22:22:49,599994.34,599994.339999995
"8761",2018-06-28 22:40:09,-599994.34,-5.12227416038513e-09
"8762",2018-06-29 12:09:32,599994.44,599994.439999995
"8763",2018-06-29 12:14:13,-599994.44,-5.12227416038513e-09
"8764",2018-06-30 02:02:29,1545235.71,1545235.70999999
"8765",2018-06-30 02:11:09,-1545235.71,-5.12227416038513e-09
"8766",2018-06-30 18:52:10,1620803.47,1620803.46999999
"8767",2018-06-30 18:55:06,-1620803.47,-5.12227416038513e-09
"8768",2018-07-01 21:53:52,555559.81,555559.809999995
"8769",2018-07-01 21:53:52,588892.83,1144452.64
"8770",2018-07-01 21:53:52,577781.82,1722234.45999999
"8771",2018-07-01 21:59:18,-1722234.46,-5.12227416038513e-09
"8772",2018-07-02 14:47:29,1581115.73,1581115.72999999
"8773",2018-07-02 15:25:07,-1581115.73,-5.12227416038513e-09
"8774",2018-07-02 17:16:50,7e+05,699999.999999995
"8775",2018-07-02 17:27:30,-7e+05,-5.12227416038513e-09
"8776",2018-07-03 01:04:43,1108025.22,1108025.21999999
"8777",2018-07-03 01:09:02,-1108025.22,-5.12227416038513e-09
"8778",2018-07-03 13:57:40,7e+05,699999.999999995
"8779",2018-07-03 14:13:45,-7e+05,-5.12227416038513e-09
"8780",2018-07-03 22:36:33,599995.22,599995.219999995
"8781",2018-07-03 22:42:04,-599995.22,-5.12227416038513e-09
"8782",2018-07-04 01:14:56,599995.25,599995.249999995
"8783",2018-07-04 01:26:22,-599995.25,-5.12227416038513e-09
"8784",2018-07-04 05:00:12,628525.17,628525.169999995
"8785",2018-07-04 05:34:32,-628525.17,-5.12227416038513e-09
"8786",2018-07-04 08:29:08,599995.27,599995.269999995
"8787",2018-07-04 08:51:01,-599995.27,-5.12227416038513e-09
"8788",2018-07-08 16:34:32,735671.24,735671.239999995
"8789",2018-07-08 16:42:33,-735671.24,-5.12227416038513e-09
"8790",2018-07-10 08:39:30,336369.61,336369.609999995
"8791",2018-07-10 08:44:48,-336369.61,-5.12227416038513e-09
"8792",2018-07-12 10:04:27,7e+05,699999.999999995
"8793",2018-07-12 10:30:44,-7e+05,-5.12227416038513e-09
"8794",2018-07-13 04:23:08,599996.84,599996.839999995
"8795",2018-07-13 04:52:28,-599996.84,-5.12227416038513e-09
"8796",2018-07-13 19:52:04,599996.88,599996.879999995
"8797",2018-07-13 19:58:04,-599996.88,-5.12227416038513e-09
"8798",2018-07-13 20:02:58,147372,147371.999999995
"8799",2018-07-13 20:10:03,-147372,-5.12227416038513e-09
"8800",2018-07-13 20:20:13,599996.91,599996.909999995
"8801",2018-07-13 20:53:42,-599996.91,-5.12227416038513e-09
"8802",2018-07-15 11:52:34,599997.13,599997.129999995
"8803",2018-07-15 12:01:12,-599997.13,-5.12227416038513e-09
"8804",2018-07-15 12:14:34,599997.14,599997.139999995
"8805",2018-07-15 12:31:06,-599997.14,-5.12227416038513e-09
"8806",2018-07-16 16:13:44,1049756.12,1049756.11999999
"8807",2018-07-16 16:21:44,-1049756.12,-5.12227416038513e-09
"8808",2018-07-16 23:01:48,774936.26,774936.259999995
"8809",2018-07-16 23:10:26,-774936.26,-5.12227416038513e-09
"8810",2018-07-17 18:37:48,589833.15,589833.149999995
"8811",2018-07-17 18:43:42,99171.35,689004.499999995
"8812",2018-07-17 18:43:42,-589833.15,99171.3499999949
"8813",2018-07-17 18:47:41,424204.72,523376.069999995
"8814",2018-07-17 18:55:12,674441.58,1197817.64999999
"8815",2018-07-17 18:55:12,449931.38,1647749.02999999
"8816",2018-07-17 18:55:12,-99171.35,1548577.67999999
"8817",2018-07-17 19:31:41,174944.94,1723522.61999999
"8818",2018-07-17 19:31:41,-1548577.68,174944.939999995
"8819",2018-07-17 19:41:29,-174944.94,-5.41331246495247e-09
"8820",2018-07-17 20:20:49,413624.14,413624.139999995
"8821",2018-07-17 20:25:58,-413624.14,-5.41331246495247e-09
"8822",2018-07-17 20:27:52,521935.37,521935.369999995
"8823",2018-07-17 20:52:33,-521935.37,-5.41331246495247e-09
"8824",2018-07-17 21:05:14,592884.27,592884.269999995
"8825",2018-07-17 21:42:30,-592884.27,-5.355104804039e-09
"8826",2018-07-17 21:51:58,581146.18,581146.179999995
"8827",2018-07-17 21:58:22,-581146.18,-5.355104804039e-09
"8828",2018-07-17 23:30:08,599997.73,599997.729999995
"8829",2018-07-17 23:49:36,-599997.73,-5.355104804039e-09
"8830",2018-07-18 00:47:30,448851.55,448851.549999995
"8831",2018-07-18 01:39:53,661154.93,1110006.47999999
"8832",2018-07-18 01:50:12,-448851.55,661154.929999995
"8833",2018-07-18 01:56:10,-661154.93,-5.47152012586594e-09
"8834",2018-07-18 09:37:38,324359.96,324359.959999995
"8835",2018-07-18 09:48:14,-324359.96,-5.47152012586594e-09
"8836",2018-07-18 16:56:43,599998.49,599998.489999995
"8837",2018-07-18 17:13:06,-599998.49,-5.47152012586594e-09
"8838",2018-07-18 20:53:03,599998.57,599998.569999994
"8839",2018-07-18 21:02:09,-599998.57,-5.47152012586594e-09
"8840",2018-07-23 16:50:01,657186.88,657186.879999995
"8841",2018-07-23 17:14:47,-657186.88,-5.47152012586594e-09
"8842",2018-07-24 03:52:18,377777.01,377777.009999995
"8843",2018-07-24 04:06:07,-377777.01,-5.47152012586594e-09
"8844",2018-07-24 08:52:35,377777,377776.999999995
"8845",2018-07-24 09:00:23,-377777,-5.47152012586594e-09
"8846",2018-07-24 09:40:55,122000,121999.999999995
"8847",2018-07-24 10:05:36,-122000,-5.47152012586594e-09
"8848",2018-07-24 14:19:33,599990.4,599990.399999995
"8849",2018-07-24 14:34:26,-599990.4,-5.47152012586594e-09
"8850",2018-07-24 15:04:18,846277.21,846277.209999994
"8851",2018-07-24 15:06:46,-846277.21,-5.47152012586594e-09
"8852",2018-07-24 18:09:09,833585.79,833585.789999995
"8853",2018-07-24 18:20:50,-833585.79,-5.47152012586594e-09
"8854",2018-07-25 11:37:11,5e+05,499999.999999995
"8855",2018-07-25 11:51:09,-5e+05,-5.47152012586594e-09
"8856",2018-07-26 22:05:33,599991.04,599991.039999995
"8857",2018-07-26 22:11:05,-599991.04,-5.47152012586594e-09
"8858",2018-07-27 04:01:29,830959.99,830959.989999995
"8859",2018-07-27 04:38:55,-830959.99,-5.47152012586594e-09
"8860",2018-07-27 10:44:05,5e+05,499999.999999995
"8861",2018-07-27 10:51:57,-5e+05,-5.47152012586594e-09
"8862",2018-07-28 20:30:17,5e+05,499999.999999995
"8863",2018-07-28 20:39:38,-5e+05,-5.47152012586594e-09
"8864",2018-07-30 18:09:51,599993.3,599993.299999995
"8865",2018-07-30 18:44:30,-599993.3,-5.47152012586594e-09
"8866",2018-08-01 03:13:39,213907.85,213907.849999995
"8867",2018-08-01 03:19:27,-213907.85,-5.47152012586594e-09
"8868",2018-08-02 01:24:52,599993.93,599993.929999995
"8869",2018-08-02 01:51:32,-599993.93,-5.47152012586594e-09
"8870",2018-08-02 13:16:26,680742.44,680742.439999994
"8871",2018-08-02 13:43:37,-680742.44,-5.47152012586594e-09
"8872",2018-08-03 08:41:50,599995.06,599995.059999995
"8873",2018-08-03 08:59:08,-599995.06,-5.47152012586594e-09
"8874",2018-08-04 14:58:13,599995.32,599995.319999994
"8875",2018-08-04 15:02:11,-599995.32,-5.47152012586594e-09
"8876",2018-08-05 02:30:19,5e+05,499999.999999995
"8877",2018-08-05 02:38:54,-5e+05,-5.47152012586594e-09
"8878",2018-08-07 02:53:32,599995.61,599995.609999995
"8879",2018-08-07 03:04:40,-599995.61,-5.47152012586594e-09
"8880",2018-08-07 21:59:09,599995.83,599995.829999994
"8881",2018-08-07 22:02:25,-599995.83,-5.47152012586594e-09
"8882",2018-08-08 04:44:05,359132.25,359132.249999995
"8883",2018-08-08 04:46:59,-359132.25,-5.47152012586594e-09
"8884",2018-08-08 06:30:57,7e+05,699999.999999995
"8885",2018-08-08 06:54:09,5e+05,1199999.99999999
"8886",2018-08-08 06:54:09,-7e+05,499999.999999994
"8887",2018-08-08 07:24:20,-5e+05,-5.58793544769287e-09
"8888",2018-08-08 15:35:08,225230.66,225230.659999994
"8889",2018-08-08 15:48:33,-225230.66,-5.58793544769287e-09
"8890",2018-08-08 16:30:01,599996.76,599996.759999994
"8891",2018-08-08 16:32:47,-599996.76,-5.58793544769287e-09
"8892",2018-08-08 17:47:51,599996.86,599996.859999994
"8893",2018-08-08 17:57:51,-599996.86,-5.58793544769287e-09
"8894",2018-08-08 18:11:31,599996.9,599996.899999994
"8895",2018-08-08 18:30:54,-599996.9,-5.58793544769287e-09
"8896",2018-08-09 15:02:23,1217041.68,1217041.67999999
"8897",2018-08-09 15:21:28,-1217041.68,-5.58793544769287e-09
"8898",2018-08-10 05:09:15,495228.84,495228.839999994
"8899",2018-08-10 05:28:21,-495228.84,-5.58793544769287e-09
"8900",2018-08-10 12:18:24,497619.58,497619.579999994
"8901",2018-08-10 12:21:36,-497619.58,-5.58793544769287e-09
"8902",2018-08-10 21:19:12,599997.49,599997.489999994
"8903",2018-08-10 21:31:35,-599997.49,-5.58793544769287e-09
"8904",2018-08-12 16:04:21,340822.46,340822.459999994
"8905",2018-08-12 16:32:34,-340822.46,-5.58793544769287e-09
"8906",2018-08-12 23:44:38,444508.38,444508.379999994
"8907",2018-08-13 00:14:44,-444508.38,-5.58793544769287e-09
"8908",2018-08-13 16:33:15,347543.86,347543.859999994
"8909",2018-08-13 16:44:58,-347543.86,-5.58793544769287e-09
"8910",2018-08-13 18:42:13,599998.44,599998.439999994
"8911",2018-08-13 19:10:18,-599998.44,-5.58793544769287e-09
"8912",2018-08-14 02:01:11,515168.74,515168.739999994
"8913",2018-08-14 02:14:09,-515168.74,-5.58793544769287e-09
"8914",2018-08-14 02:55:23,618619.97,618619.969999994
"8915",2018-08-14 03:10:59,-618619.97,-5.58793544769287e-09
"8916",2018-08-14 08:29:39,537007.61,537007.609999994
"8917",2018-08-14 08:39:51,-537007.61,-5.58793544769287e-09
"8918",2018-08-14 13:18:01,691883.13,691883.129999994
"8919",2018-08-14 13:44:29,-691883.13,-5.58793544769287e-09
"8920",2018-08-14 15:20:12,319420.58,319420.579999994
"8921",2018-08-14 15:30:16,-319420.58,-5.58793544769287e-09
"8922",2018-08-14 16:36:47,602054.04,602054.039999994
"8923",2018-08-14 16:52:31,-602054.04,-5.58793544769287e-09
"8924",2018-08-14 23:13:54,550867.97,550867.969999994
"8925",2018-08-14 23:24:39,-550867.97,-5.58793544769287e-09
"8926",2018-08-14 23:52:16,581066.2,581066.199999994
"8927",2018-08-15 00:15:41,-581066.2,-5.58793544769287e-09
"8928",2018-08-15 08:04:13,102243.72,102243.719999994
"8929",2018-08-15 08:10:08,312836.19,415079.909999994
"8930",2018-08-15 08:10:08,-102243.72,312836.189999994
"8931",2018-08-15 08:40:19,-312836.19,-5.5297277867794e-09
"8932",2018-08-15 17:47:21,1228588.35,1228588.34999999
"8933",2018-08-15 18:16:05,-1228588.35,-5.58793544769287e-09
"8934",2018-08-15 19:44:50,558923.82,558923.819999994
"8935",2018-08-15 19:57:19,-558923.82,-5.58793544769287e-09
"8936",2018-08-16 00:04:27,539443.07,539443.069999994
"8937",2018-08-16 00:08:16,-539443.07,-5.58793544769287e-09
"8938",2018-08-16 04:43:56,256888.75,256888.749999994
"8939",2018-08-16 04:57:49,-256888.75,-5.58793544769287e-09
"8940",2018-08-16 18:02:46,571330.34,571330.339999994
"8941",2018-08-16 18:05:48,-571330.34,-5.58793544769287e-09
"8942",2018-08-17 02:59:26,446180.25,446180.249999994
"8943",2018-08-17 03:01:31,-446180.25,-5.58793544769287e-09
"8944",2018-08-17 07:47:51,627559.19,627559.189999994
"8945",2018-08-17 07:51:58,-627559.19,-5.58793544769287e-09
"8946",2018-08-17 23:15:41,653559.2,653559.199999994
"8947",2018-08-17 23:27:09,-653559.2,-5.58793544769287e-09
"8948",2018-08-19 00:23:52,3e+05,299999.999999994
"8949",2018-08-19 00:42:30,-3e+05,-5.58793544769287e-09
"8950",2018-08-19 00:42:30,456996.87,456996.869999994
"8951",2018-08-19 01:01:10,-456996.87,-5.58793544769287e-09
"8952",2018-08-20 22:46:15,674366.38,674366.379999994
"8953",2018-08-20 23:09:24,-674366.38,-5.58793544769287e-09
"8954",2018-08-22 01:14:45,647745.77,647745.769999994
"8955",2018-08-22 01:17:57,734892.9,1382638.66999999
"8956",2018-08-22 01:25:45,-647745.77,734892.899999994
"8957",2018-08-22 01:50:47,1000866.93,1735759.82999999
"8958",2018-08-22 01:50:47,-734892.9,1000866.92999999
"8959",2018-08-22 01:57:46,418908.24,1419775.16999999
"8960",2018-08-22 01:57:46,-1000866.93,418908.239999994
"8961",2018-08-22 02:16:36,299583.51,718491.749999994
"8962",2018-08-22 02:16:36,337811.03,1056302.77999999
"8963",2018-08-22 02:16:36,-418908.24,637394.539999994
"8964",2018-08-22 02:28:33,35201.09,672595.629999994
"8965",2018-08-22 02:28:33,-637394.54,35201.0899999941
"8966",2018-08-22 02:59:14,336459.52,371660.609999994
"8967",2018-08-22 02:59:14,-35201.09,336459.519999994
"8968",2018-08-22 03:18:31,-336459.52,-5.82076609134674e-09
"8969",2018-08-22 20:31:04,599996.19,599996.189999994
"8970",2018-08-22 20:39:55,-599996.19,-5.82076609134674e-09
"8971",2018-08-23 22:42:54,220511.64,220511.639999994
"8972",2018-08-23 23:02:30,-220511.64,-5.82076609134674e-09
"8973",2018-08-25 03:14:31,480484.82,480484.819999994
"8974",2018-08-25 03:23:08,-480484.82,-5.82076609134674e-09
"8975",2018-08-25 06:41:52,775077.2,775077.199999994
"8976",2018-08-25 07:04:25,-775077.2,-5.82076609134674e-09
"8977",2018-08-26 00:34:13,756979.3,756979.299999994
"8978",2018-08-26 00:37:58,-756979.3,-5.82076609134674e-09
"8979",2018-08-27 08:07:15,798649.39,798649.389999994
"8980",2018-08-27 08:34:18,-798649.39,-5.82076609134674e-09
"8981",2018-08-28 01:52:00,805764.35,805764.349999994
"8982",2018-08-28 02:04:07,-805764.35,-5.82076609134674e-09
"8983",2018-08-28 15:25:49,448934.37,448934.369999994
"8984",2018-08-28 15:51:56,-448934.37,-5.82076609134674e-09
"8985",2018-08-28 17:00:10,599996.92,599996.919999994
"8986",2018-08-28 17:03:47,-599996.92,-5.82076609134674e-09
"8987",2018-08-28 19:36:41,599996.97,599996.969999994
"8988",2018-08-28 19:52:59,-599996.97,-5.82076609134674e-09
"8989",2018-08-29 00:25:30,351360.48,351360.479999994
"8990",2018-08-29 01:00:53,-351360.48,-5.82076609134674e-09
"8991",2018-08-29 05:50:09,783903.21,783903.209999994
"8992",2018-08-29 06:02:23,-783903.21,-5.82076609134674e-09
"8993",2018-08-29 14:13:28,599997.11,599997.109999994
"8994",2018-08-29 14:29:44,-599997.11,-5.82076609134674e-09
"8995",2018-08-29 16:32:45,599997.19,599997.189999994
"8996",2018-08-29 16:43:41,-599997.19,-5.82076609134674e-09
"8997",2018-08-29 23:10:46,599997.25,599997.249999994
"8998",2018-08-29 23:14:30,-599997.25,-5.82076609134674e-09
"8999",2018-08-30 03:30:02,599997.27,599997.269999994
"9000",2018-08-30 03:45:44,-599997.27,-5.82076609134674e-09
"9001",2018-09-02 00:14:19,347783.81,347783.809999994
"9002",2018-09-02 00:30:32,-347783.81,-5.82076609134674e-09
"9003",2018-09-02 01:29:58,839009.57,839009.569999994
"9004",2018-09-02 01:56:48,-839009.57,-5.82076609134674e-09
"9005",2018-09-02 16:26:43,839683.86,839683.859999994
"9006",2018-09-02 16:38:43,-839683.86,-5.82076609134674e-09
"9007",2018-09-03 04:41:27,599997.71,599997.709999994
"9008",2018-09-03 04:47:41,-599997.71,-5.82076609134674e-09
"9009",2018-09-05 16:48:24,63353.77,63353.7699999942
"9010",2018-09-05 16:48:24,599999.99,663353.759999994
"9011",2018-09-05 16:55:29,-663353.76,-5.82076609134674e-09
"9012",2018-09-07 00:09:50,830963.4,830963.399999994
"9013",2018-09-07 00:28:56,-830963.4,-5.82076609134674e-09
"9014",2018-09-09 18:08:54,569008.43,569008.429999994
"9015",2018-09-09 18:14:14,-569008.43,-5.82076609134674e-09
"9016",2018-09-10 11:54:33,599992.66,599992.659999994
"9017",2018-09-10 12:26:16,-599992.66,-5.82076609134674e-09
"9018",2018-09-11 15:13:44,529231.51,529231.509999994
"9019",2018-09-11 15:24:03,-529231.51,-5.82076609134674e-09
"9020",2018-09-11 16:14:56,768524.44,768524.439999994
"9021",2018-09-11 16:36:32,-768524.44,-5.82076609134674e-09
"9022",2018-09-11 23:11:36,408882.59,408882.589999994
"9023",2018-09-11 23:20:18,-408882.59,-5.82076609134674e-09
"9024",2018-09-12 19:48:49,647676.51,647676.509999994
"9025",2018-09-12 20:02:12,-647676.51,-5.82076609134674e-09
"9026",2018-09-13 14:29:38,559811.76,559811.759999994
"9027",2018-09-13 14:39:00,-559811.76,-5.82076609134674e-09
"9028",2018-09-13 18:07:30,599993.27,599993.269999994
"9029",2018-09-13 18:23:47,-599993.27,-5.82076609134674e-09
"9030",2018-09-14 02:31:01,383296.39,383296.389999994
"9031",2018-09-14 02:59:17,-383296.39,-5.82076609134674e-09
"9032",2018-09-14 07:10:37,160329.2,160329.199999994
"9033",2018-09-14 07:17:09,-160329.2,-5.82076609134674e-09
"9034",2018-09-14 09:19:33,76232.03,76232.0299999942
"9035",2018-09-14 09:31:45,-76232.03,-5.82076609134674e-09
"9036",2018-09-14 09:55:38,60066.71,60066.7099999942
"9037",2018-09-14 09:58:54,-60066.71,-5.82076609134674e-09
"9038",2018-09-14 13:32:31,1340422.74,1340422.73999999
"9039",2018-09-14 13:34:52,-1340422.74,-5.82076609134674e-09
"9040",2018-09-15 05:10:05,24691.91,24691.9099999942
"9041",2018-09-15 05:18:54,511220.12,535912.029999994
"9042",2018-09-15 05:18:54,-24691.91,511220.119999994
"9043",2018-09-15 05:36:33,-511220.12,-5.76255843043327e-09
"9044",2018-09-15 13:40:51,544215.93,544215.929999994
"9045",2018-09-15 13:47:43,-544215.93,-5.70435076951981e-09
"9046",2018-09-15 16:34:05,250594.16,250594.159999994
"9047",2018-09-15 16:45:03,-250594.16,-5.70435076951981e-09
"9048",2018-09-15 21:03:21,96879.39,96879.3899999943
"9049",2018-09-15 21:06:39,-96879.39,-5.70435076951981e-09
"9050",2018-09-15 22:20:09,447044.83,447044.829999994
"9051",2018-09-15 22:36:49,-447044.83,-5.70435076951981e-09
"9052",2018-09-17 00:30:20,570304.5,570304.499999994
"9053",2018-09-17 00:55:33,-570304.5,-5.70435076951981e-09
"9054",2018-09-18 00:29:26,599994.3,599994.299999994
"9055",2018-09-18 00:36:47,-599994.3,-5.70435076951981e-09
"9056",2018-09-18 06:09:55,599994.35,599994.349999994
"9057",2018-09-18 06:23:24,-599994.35,-5.70435076951981e-09
"9058",2018-09-18 18:06:23,495392.24,495392.239999994
"9059",2018-09-18 18:25:38,-495392.24,-5.70435076951981e-09
"9060",2018-09-20 08:33:19,645391.79,645391.789999994
"9061",2018-09-20 08:40:57,-645391.79,-5.70435076951981e-09
"9062",2018-09-21 03:22:50,715201.64,715201.639999994
"9063",2018-09-21 03:53:13,-715201.64,-5.70435076951981e-09
"9064",2018-09-21 08:02:02,755376.98,755376.979999994
"9065",2018-09-21 08:05:58,-755376.98,-5.70435076951981e-09
"9066",2018-09-21 09:12:16,77443.85,77443.8499999943
"9067",2018-09-21 09:12:16,755666.04,833109.889999994
"9068",2018-09-21 09:13:25,717768.59,1550878.47999999
"9069",2018-09-21 09:32:12,-833109.89,717768.589999994
"9070",2018-09-21 09:44:23,-717768.59,-5.58793544769287e-09
"9071",2018-09-21 12:57:53,699287.93,699287.929999994
"9072",2018-09-21 13:25:07,-699287.93,-5.58793544769287e-09
"9073",2018-09-21 16:28:47,599995.26,599995.259999994
"9074",2018-09-21 16:33:52,-599995.26,-5.58793544769287e-09
"9075",2018-09-21 19:25:13,730580.73,730580.729999994
"9076",2018-09-21 19:34:15,-730580.73,-5.58793544769287e-09
"9077",2018-09-21 21:44:39,764697.36,764697.359999994
"9078",2018-09-21 21:49:03,-764697.36,-5.58793544769287e-09
"9079",2018-09-21 22:52:59,599995.45,599995.449999994
"9080",2018-09-21 23:25:52,-599995.45,-5.58793544769287e-09
"9081",2018-09-22 02:21:52,128848.75,128848.749999994
"9082",2018-09-22 02:49:51,-128848.75,-5.58793544769287e-09
"9083",2018-09-22 04:47:53,599995.63,599995.629999994
"9084",2018-09-22 04:58:15,-599995.63,-5.58793544769287e-09
"9085",2018-09-22 07:40:25,734147.46,734147.459999994
"9086",2018-09-22 07:47:16,-734147.46,-5.58793544769287e-09
"9087",2018-09-22 12:47:38,277849.31,277849.309999994
"9088",2018-09-22 12:54:16,-277849.31,-5.58793544769287e-09
"9089",2018-09-22 15:51:02,712859.04,712859.039999994
"9090",2018-09-22 15:55:19,-712859.04,-5.58793544769287e-09
"9091",2018-09-24 09:11:58,537944.86,537944.859999994
"9092",2018-09-24 09:29:25,-537944.86,-5.58793544769287e-09
"9093",2018-09-25 01:27:46,599996.36,599996.359999994
"9094",2018-09-25 01:35:59,-599996.36,-5.58793544769287e-09
"9095",2018-09-25 20:16:06,380000,379999.999999994
"9096",2018-09-25 20:21:27,-380000,-5.58793544769287e-09
"9097",2018-09-26 16:39:15,484832.79,484832.789999994
"9098",2018-09-26 17:33:11,-484832.79,-5.58793544769287e-09
"9099",2018-09-27 22:40:53,374541.81,374541.809999994
"9100",2018-09-27 22:46:33,-374541.81,-5.58793544769287e-09
"9101",2018-09-28 00:14:19,561093.58,561093.579999994
"9102",2018-09-28 00:38:16,-561093.58,-5.58793544769287e-09
"9103",2018-09-28 03:46:10,697851.45,697851.449999994
"9104",2018-09-28 03:53:24,-697851.45,-5.58793544769287e-09
"9105",2018-09-28 06:43:25,710686.48,710686.479999994
"9106",2018-09-28 06:51:11,-710686.48,-5.58793544769287e-09
"9107",2018-09-28 18:08:53,495312.24,495312.239999994
"9108",2018-09-28 18:12:17,-495312.24,-5.58793544769287e-09
"9109",2018-09-29 03:03:05,67479.7,67479.6999999944
"9110",2018-09-29 03:12:29,-67479.7,-5.58793544769287e-09
"9111",2018-09-30 05:37:51,647140.93,647140.929999994
"9112",2018-09-30 05:51:29,-647140.93,-5.58793544769287e-09
"9113",2018-09-30 15:45:58,166680.62,166680.619999994
"9114",2018-09-30 15:49:42,-166680.62,-5.58793544769287e-09
"9115",2018-10-09 00:32:10,762208.14,762208.139999994
"9116",2018-10-09 01:00:58,-762208.14,-5.58793544769287e-09
"9117",2018-10-10 15:19:13,599991.26,599991.259999994
"9118",2018-10-10 15:23:36,-599991.26,-5.58793544769287e-09
"9119",2018-10-11 01:33:31,130255.96,130255.959999994
"9120",2018-10-11 01:36:27,-130255.96,-5.58793544769287e-09
"9121",2018-10-15 05:50:48,599993.65,599993.649999994
"9122",2018-10-15 05:59:56,-599993.65,-5.58793544769287e-09
"9123",2018-10-15 06:11:04,599993.76,599993.759999994
"9124",2018-10-15 06:27:55,658533.16,1258526.91999999
"9125",2018-10-15 06:27:55,732800.22,1991327.13999999
"9126",2018-10-15 06:27:55,-599993.76,1391333.37999999
"9127",2018-10-15 06:42:33,-1391333.38,-5.58793544769287e-09
"9128",2018-10-15 06:47:30,411304.8,411304.799999994
"9129",2018-10-15 06:49:08,-411304.8,-5.58793544769287e-09
"9130",2018-10-15 07:00:20,713038.2,713038.199999994
"9131",2018-10-15 07:09:12,777781.15,1490819.34999999
"9132",2018-10-15 07:09:12,-713038.2,777781.149999995
"9133",2018-10-15 07:36:29,418620.22,1196401.36999999
"9134",2018-10-15 07:36:29,-777781.15,418620.219999995
"9135",2018-10-15 07:56:34,432139.97,850760.189999994
"9136",2018-10-15 07:56:34,-418620.22,432139.969999995
"9137",2018-10-15 08:08:09,-432139.97,-5.47152012586594e-09
"9138",2018-10-15 08:34:27,1207902.14,1207902.13999999
"9139",2018-10-15 08:34:27,407004.13,1614906.26999999
"9140",2018-10-15 08:43:23,-1614906.27,-5.58793544769287e-09
"9141",2018-10-15 13:45:27,579439.13,579439.129999994
"9142",2018-10-15 13:53:10,40172.38,619611.509999994
"9143",2018-10-15 13:53:10,-579439.13,40172.3799999944
"9144",2018-10-15 13:56:41,132329.97,172502.349999994
"9145",2018-10-15 14:07:12,-40172.38,132329.969999994
"9146",2018-10-15 14:13:49,-132329.97,-5.58793544769287e-09
"9147",2018-10-15 14:35:40,372889.27,372889.269999994
"9148",2018-10-15 14:43:22,-372889.27,-5.58793544769287e-09
"9149",2018-10-15 18:03:22,551547.21,551547.209999994
"9150",2018-10-15 18:14:15,-551547.21,-5.58793544769287e-09
"9151",2018-10-15 21:38:30,789411.73,789411.729999994
"9152",2018-10-15 21:44:00,-789411.73,-5.58793544769287e-09
"9153",2018-10-16 20:57:32,2e+05,199999.999999994
"9154",2018-10-16 21:00:25,-2e+05,-5.58793544769287e-09
"9155",2018-10-29 17:33:59,2e+05,199999.999999994
"9156",2018-10-29 17:45:28,-2e+05,-5.58793544769287e-09
"9157",2018-10-30 14:51:24,2e+05,199999.999999994
"9158",2018-10-30 15:10:45,-2e+05,-5.58793544769287e-09
"9159",2018-10-31 09:11:33,84289.77,84289.7699999944
"9160",2018-10-31 09:30:24,-84289.77,-5.58793544769287e-09
"9161",2018-10-31 13:09:34,380000,379999.999999994
"9162",2018-10-31 13:16:47,-380000,-5.58793544769287e-09
"9163",2018-11-04 17:01:53,294248.33,294248.329999994
"9164",2018-11-04 17:23:22,-294248.33,-5.58793544769287e-09
"9165",2018-11-06 10:31:05,406839.92,406839.919999994
"9166",2018-11-06 10:38:50,-406839.92,-5.58793544769287e-09
"9167",2018-11-06 23:18:08,389288.98,389288.979999994
"9168",2018-11-06 23:31:55,-389288.98,-5.58793544769287e-09
"9169",2018-11-07 00:44:27,258814.51,258814.509999994
"9170",2018-11-07 01:05:40,-258814.51,-5.58793544769287e-09
"9171",2018-11-07 08:09:16,190153.43,190153.429999994
"9172",2018-11-07 08:15:10,-190153.43,-5.58793544769287e-09
"9173",2018-11-07 10:13:52,431149,431148.999999994
"9174",2018-11-07 10:19:55,-431149,-5.58793544769287e-09
"9175",2018-11-07 10:37:00,202251.62,202251.619999994
"9176",2018-11-07 10:47:52,-202251.62,-5.58793544769287e-09
"9177",2018-11-07 17:48:52,218922.58,218922.579999994
"9178",2018-11-07 17:59:55,-218922.58,-5.58793544769287e-09
"9179",2018-11-14 20:56:35,24536.01,24536.0099999944
"9180",2018-11-14 20:56:35,65920.71,90456.7199999944
"9181",2018-11-14 21:28:49,-90456.72,-5.58793544769287e-09
"9182",2018-11-14 23:06:33,85165.79,85165.7899999944
"9183",2018-11-14 23:10:17,-85165.79,-5.58793544769287e-09
"9184",2018-11-14 23:27:59,212103.58,212103.579999994
"9185",2018-11-14 23:50:16,-212103.58,-5.58793544769287e-09
"9186",2018-11-15 01:46:46,18488.87,18488.8699999944
"9187",2018-11-15 01:55:06,-18488.87,-5.58793544769287e-09
"9188",2018-11-15 02:02:40,56303.9,56303.8999999944
"9189",2018-11-15 02:07:12,-56303.9,-5.58793544769287e-09
"9190",2018-11-15 03:26:45,126050.24,126050.239999994
"9191",2018-11-15 03:26:45,242120.97,368171.209999994
"9192",2018-11-15 03:37:07,-368171.21,-5.58793544769287e-09
"9193",2018-11-15 03:56:51,292758.51,292758.509999994
"9194",2018-11-15 04:03:08,-292758.51,-5.58793544769287e-09
"9195",2018-11-15 05:53:37,192802.69,192802.689999994
"9196",2018-11-15 05:55:42,-192802.69,-5.58793544769287e-09
"9197",2018-11-15 10:41:19,188255.56,188255.559999994
"9198",2018-11-15 10:59:12,-188255.56,-5.58793544769287e-09
"9199",2018-11-15 17:33:29,322163,322162.999999994
"9200",2018-11-15 17:33:29,639297.92,961460.919999994
"9201",2018-11-15 17:33:29,345501.37,1306962.28999999
"9202",2018-11-15 17:56:50,-1306962.29,-5.58793544769287e-09
"9203",2018-11-15 18:35:05,464760.32,464760.319999994
"9204",2018-11-15 19:02:08,-464760.32,-5.58793544769287e-09
"9205",2018-11-16 22:29:32,250843.68,250843.679999994
"9206",2018-11-16 22:31:37,-250843.68,-5.58793544769287e-09
"9207",2018-11-17 07:27:38,347356.83,347356.829999994
"9208",2018-11-17 07:59:24,-347356.83,-5.58793544769287e-09
"9209",2018-11-19 03:26:09,199434.77,199434.769999994
"9210",2018-11-19 03:32:25,-199434.77,-5.58793544769287e-09
"9211",2018-11-19 09:29:29,302957.37,302957.369999994
"9212",2018-11-19 09:45:04,-302957.37,-5.58793544769287e-09
"9213",2018-11-19 10:17:08,379556.09,379556.089999994
"9214",2018-11-19 10:25:39,-379556.09,-5.58793544769287e-09
"9215",2018-11-19 14:37:51,322549.58,322549.579999994
"9216",2018-11-19 16:08:55,-322549.58,-5.58793544769287e-09
"9217",2018-11-19 18:42:54,377782.75,377782.749999994
"9218",2018-11-19 19:02:20,177782.89,555565.639999994
"9219",2018-11-19 19:32:26,449730.86,1005296.49999999
"9220",2018-11-19 19:32:26,266550.1,1271846.59999999
"9221",2018-11-19 19:53:11,-377782.75,894063.849999995
"9222",2018-11-19 20:04:24,-894063.85,-5.47152012586594e-09
"9223",2018-11-19 21:42:32,270516.99,270516.989999995
"9224",2018-11-19 21:49:24,-270516.99,-5.47152012586594e-09
"9225",2018-11-19 23:28:31,131176.4,131176.399999995
"9226",2018-11-19 23:28:31,223862.56,355038.959999994
"9227",2018-11-19 23:40:59,-355038.96,-5.5297277867794e-09
"9228",2018-11-20 00:34:10,287459.34,287459.339999994
"9229",2018-11-20 00:42:26,-287459.34,-5.5297277867794e-09
"9230",2018-11-20 04:38:32,226972.93,226972.929999994
"9231",2018-11-20 04:38:32,233774.91,460747.839999994
"9232",2018-11-20 04:38:32,231814.48,692562.319999994
"9233",2018-11-20 04:44:30,-692562.32,-5.47152012586594e-09
"9234",2018-11-20 07:07:49,161312.64,161312.639999995
"9235",2018-11-20 07:42:13,-161312.64,-5.47152012586594e-09
"9236",2018-11-20 09:21:39,300006.89,300006.889999995
"9237",2018-11-20 09:38:18,-300006.89,-5.47152012586594e-09
"9238",2018-11-20 13:52:42,300007.1,300007.099999995
"9239",2018-11-20 14:17:04,377784.06,677791.159999995
"9240",2018-11-20 15:08:24,377784.12,1055575.27999999
"9241",2018-11-20 15:27:41,-300007.1,755568.179999995
"9242",2018-11-20 15:49:41,-755568.18,-5.355104804039e-09
"9243",2018-11-21 00:35:40,255976.2,255976.199999995
"9244",2018-11-21 00:42:28,-255976.2,-5.355104804039e-09
"9245",2018-11-21 04:48:39,329910.17,329910.169999995
"9246",2018-11-21 05:07:06,-329910.17,-5.355104804039e-09
"9247",2018-11-21 08:37:29,151009.33,151009.329999995
"9248",2018-11-21 08:42:21,-151009.33,-5.355104804039e-09
"9249",2018-11-22 22:10:40,343377.42,343377.419999995
"9250",2018-11-22 22:43:20,280601.9,623979.319999995
"9251",2018-11-22 22:43:20,-343377.42,280601.899999995
"9252",2018-11-22 22:54:13,-280601.9,-5.29689714312553e-09
"9253",2018-11-23 02:36:47,318494.86,318494.859999995
"9254",2018-11-23 02:51:36,-318494.86,-5.29689714312553e-09
"9255",2018-11-23 05:54:12,249773.79,249773.789999995
"9256",2018-11-23 06:20:38,-249773.79,-5.29689714312553e-09
"9257",2018-11-23 09:21:27,350928.34,350928.339999995
"9258",2018-11-23 09:37:14,-350928.34,-5.29689714312553e-09
"9259",2018-11-23 13:39:12,321292.74,321292.739999995
"9260",2018-11-23 13:58:22,-321292.74,-5.29689714312553e-09
"9261",2018-11-23 14:15:24,274760.27,274760.269999995
"9262",2018-11-23 14:26:53,-274760.27,-5.29689714312553e-09
"9263",2018-11-23 15:52:13,288037.36,288037.359999995
"9264",2018-11-23 16:09:00,-288037.36,-5.29689714312553e-09
"9265",2018-11-24 01:23:09,311380.07,311380.069999995
"9266",2018-11-24 01:26:29,-311380.07,-5.29689714312553e-09
"9267",2018-11-24 19:48:32,418063.13,418063.129999995
"9268",2018-11-24 20:02:21,-418063.13,-5.29689714312553e-09
"9269",2018-11-25 00:04:31,569832.04,569832.039999995
"9270",2018-11-25 00:12:55,-569832.04,-5.355104804039e-09
"9271",2018-11-25 10:38:52,296553.59,296553.589999995
"9272",2018-11-25 10:55:04,-296553.59,-5.355104804039e-09
"9273",2018-11-25 11:22:03,334574.87,334574.869999995
"9274",2018-11-25 11:49:47,-334574.87,-5.355104804039e-09
"9275",2018-11-25 12:02:16,561042.41,561042.409999995
"9276",2018-11-25 12:12:13,-561042.41,-5.355104804039e-09
"9277",2018-11-26 16:02:35,278241.16,278241.159999995
"9278",2018-11-26 16:07:33,-278241.16,-5.355104804039e-09
"9279",2018-11-27 13:30:42,300004.61,300004.609999995
"9280",2018-11-27 13:53:33,-300004.61,-5.355104804039e-09
"9281",2018-11-28 00:41:54,15647.7,15647.6999999946
"9282",2018-11-28 00:41:54,51708.16,67355.8599999946
"9283",2018-11-28 00:50:39,-67355.86,-5.355104804039e-09
"9284",2018-11-28 01:24:46,23415.04,23415.0399999946
"9285",2018-11-28 01:32:33,-23415.04,-5.355104804039e-09
"9286",2018-11-28 01:32:33,33728.29,33728.2899999946
"9287",2018-11-28 01:46:29,30393.52,64121.8099999946
"9288",2018-11-28 01:46:29,-33728.29,30393.5199999946
"9289",2018-11-28 02:23:52,-30393.52,-5.35874278284609e-09
"9290",2018-11-28 03:05:38,42001.75,42001.7499999946
"9291",2018-11-28 03:19:30,-42001.75,-5.355104804039e-09
"9292",2018-11-28 03:19:30,43119.97,43119.9699999946
"9293",2018-11-28 03:42:51,45219.85,88339.8199999947
"9294",2018-11-28 03:42:51,-43119.97,45219.8499999947
"9295",2018-11-28 04:27:04,96834.28,142054.129999995
"9296",2018-11-28 04:27:04,-45219.85,96834.2799999946
"9297",2018-11-28 04:42:55,-96834.28,-5.355104804039e-09
"9298",2018-11-28 06:19:08,15429.44,15429.4399999946
"9299",2018-11-28 06:19:08,37548.02,52977.4599999946
"9300",2018-11-28 06:19:08,43711.49,96688.9499999946
"9301",2018-11-28 06:25:24,154566.19,251255.139999995
"9302",2018-11-28 06:25:24,-96688.95,154566.189999995
"9303",2018-11-28 06:33:54,-154566.19,-5.355104804039e-09
"9304",2018-11-28 06:40:46,96753.13,96753.1299999946
"9305",2018-11-28 06:46:59,-96753.13,-5.355104804039e-09
"9306",2018-11-28 07:19:35,30110.75,30110.7499999946
"9307",2018-11-28 07:24:15,-30110.75,-5.355104804039e-09
"9308",2018-11-28 07:24:15,66635.17,66635.1699999946
"9309",2018-11-28 07:31:00,-66635.17,-5.355104804039e-09
"9310",2018-11-28 08:35:20,40056.81,40056.8099999946
"9311",2018-11-28 08:48:44,11226.35,51283.1599999946
"9312",2018-11-28 08:48:44,48861.34,100144.499999995
"9313",2018-11-28 08:48:44,-40056.81,60087.6899999946
"9314",2018-11-28 08:59:10,-60087.69,-5.355104804039e-09
"9315",2018-11-28 14:36:52,100006.76,100006.759999995
"9316",2018-11-28 14:47:18,-100006.76,-5.355104804039e-09
"9317",2018-11-28 14:47:18,77783.82,77783.8199999947
"9318",2018-11-28 16:03:37,777784.13,855567.949999995
"9319",2018-11-28 16:03:37,-77783.82,777784.129999995
"9320",2018-11-28 16:35:44,-777784.13,-5.47152012586594e-09
"9321",2018-11-28 22:09:52,184378.23,184378.229999995
"9322",2018-11-28 22:24:17,-184378.23,-5.47152012586594e-09
"9323",2018-11-29 09:48:38,377785.77,377785.769999995
"9324",2018-11-29 09:58:59,-377785.77,-5.47152012586594e-09
"9325",2018-11-29 10:30:49,227289.37,227289.369999995
"9326",2018-11-29 11:00:02,-227289.37,-5.47152012586594e-09
"9327",2018-11-29 11:50:44,254068.5,254068.499999995
"9328",2018-11-29 11:56:14,-254068.5,-5.47152012586594e-09
"9329",2018-11-29 17:03:33,377786.33,377786.329999995
"9330",2018-11-29 17:18:05,-377786.33,-5.47152012586594e-09
"9331",2018-11-30 08:06:58,300009.5,300009.499999995
"9332",2018-11-30 08:14:23,-300009.5,-5.47152012586594e-09
"9333",2018-12-07 20:36:43,377784.28,377784.279999995
"9334",2018-12-07 20:41:18,-377784.28,-5.47152012586594e-09
"9335",2018-12-08 05:59:38,777785.3,777785.299999995
"9336",2018-12-08 06:20:04,-777785.3,-5.47152012586594e-09
"9337",2018-12-14 15:29:33,454057.94,454057.939999995
"9338",2018-12-14 15:35:45,-454057.94,-5.47152012586594e-09
"9339",2018-12-14 15:35:45,263700.05,263700.049999995
"9340",2018-12-14 16:09:42,-263700.05,-5.47152012586594e-09
"9341",2018-12-16 11:01:19,395211.1,395211.099999995
"9342",2018-12-16 11:01:19,537529.45,932740.549999994
"9343",2018-12-16 11:11:38,-932740.55,-5.58793544769287e-09
"9344",2018-12-17 17:15:48,327747,327746.999999994
"9345",2018-12-17 17:15:48,596120.73,923867.729999994
"9346",2018-12-17 17:23:04,-923867.73,-5.58793544769287e-09
"9347",2018-12-17 19:06:55,377779.66,377779.659999994
"9348",2018-12-17 19:13:25,-377779.66,-5.58793544769287e-09
"9349",2018-12-17 21:36:43,777780.87,777780.869999994
"9350",2018-12-17 21:41:01,-777780.87,-5.58793544769287e-09
"9351",2018-12-18 09:15:54,377784,377783.999999994
"9352",2018-12-18 09:38:41,-377784,-5.58793544769287e-09
"9353",2018-12-18 18:15:19,777777.54,777777.539999994
"9354",2018-12-18 19:16:51,-777777.54,-5.58793544769287e-09
"9355",2018-12-20 18:05:25,1081662.2,1081662.19999999
"9356",2018-12-20 18:12:28,-1081662.2,-5.58793544769287e-09
"9357",2018-12-21 19:55:38,276266.24,276266.239999994
"9358",2018-12-21 20:00:56,-276266.24,-5.58793544769287e-09
"9359",2018-12-24 00:54:48,166622.02,166622.019999994
"9360",2018-12-24 00:54:48,599991.39,766613.409999994
"9361",2018-12-24 00:58:18,-766613.41,-5.58793544769287e-09
"9362",2018-12-24 00:58:18,87589.44,87589.4399999944
"9363",2018-12-24 01:05:29,58140.02,145729.459999994
"9364",2018-12-24 01:05:29,173092.01,318821.469999994
"9365",2018-12-24 01:05:29,-87589.44,231232.029999994
"9366",2018-12-24 01:15:28,-231232.03,-5.6170392781496e-09
"9367",2018-12-29 21:24:42,407564.12,407564.119999994
"9368",2018-12-29 21:32:30,260672.86,668236.979999994
"9369",2018-12-29 21:32:30,-407564.12,260672.859999994
"9370",2018-12-29 21:48:41,-260672.86,-5.58793544769287e-09
"9371",2018-12-30 00:21:40,602218.61,602218.609999994
"9372",2018-12-30 00:21:40,300092.44,902311.049999994
"9373",2018-12-30 00:35:13,-902311.05,-5.58793544769287e-09
"9374",2019-01-13 17:20:08,338157.04,338157.039999994
"9375",2019-01-13 17:50:37,-338157.04,-5.58793544769287e-09
"9376",2019-01-13 17:50:37,418438.68,418438.679999994
"9377",2019-01-13 18:12:14,-418438.68,-5.58793544769287e-09
"9378",2019-01-14 22:11:37,339209.61,339209.609999994
"9379",2019-01-14 22:34:52,-339209.61,-5.58793544769287e-09
"9380",2019-01-18 23:15:12,194226.51,194226.509999994
"9381",2019-01-18 23:20:50,-194226.51,-5.58793544769287e-09
"9382",2019-01-20 12:26:50,394911.66,394911.659999994
"9383",2019-01-20 12:41:04,-394911.66,-5.58793544769287e-09
"9384",2019-01-20 12:41:04,238468.82,238468.819999994
"9385",2019-01-20 12:45:52,-238468.82,-5.58793544769287e-09
"9386",2019-01-23 14:47:11,3e+05,299999.999999994
"9387",2019-01-23 15:06:41,-3e+05,-5.58793544769287e-09
"9388",2019-01-26 08:27:46,83254.22,83254.2199999944
"9389",2019-01-26 08:34:44,-83254.22,-5.58793544769287e-09
"9390",2019-01-26 14:43:59,97556.74,97556.7399999944
"9391",2019-01-26 15:06:54,-97556.74,-5.58793544769287e-09
"9392",2019-01-26 20:07:36,300003.82,300003.819999994
"9393",2019-01-26 20:12:00,-300003.82,-5.58793544769287e-09
"9394",2019-01-27 09:24:38,200004.15,200004.149999994
"9395",2019-01-27 09:39:14,-200004.15,-5.58793544769287e-09
"9396",2019-01-27 16:19:02,55729.57,55729.5699999944
"9397",2019-01-27 16:19:02,57657.61,113387.179999994
"9398",2019-01-27 16:24:17,-113387.18,-5.58793544769287e-09
"9399",2019-01-27 16:27:23,127999.52,127999.519999994
"9400",2019-01-27 16:27:23,151291.72,279291.239999994
"9401",2019-01-27 16:36:49,-279291.24,-5.58793544769287e-09
"9402",2019-01-28 06:35:13,188892.58,188892.579999994
"9403",2019-01-28 06:39:13,-188892.58,-5.58793544769287e-09
"9404",2019-01-28 16:17:29,88892.75,88892.7499999944
"9405",2019-01-28 16:21:00,-88892.75,-5.58793544769287e-09
"9406",2019-01-28 18:55:01,68846.87,68846.8699999944
"9407",2019-01-28 19:11:03,-68846.87,-5.58793544769287e-09
"9408",2019-01-29 06:14:03,150005.12,150005.119999994
"9409",2019-01-29 06:19:12,-150005.12,-5.58793544769287e-09
"9410",2019-01-29 21:33:26,150005.31,150005.309999994
"9411",2019-01-29 21:38:53,-150005.31,-5.58793544769287e-09
"9412",2019-01-30 07:06:04,86097.47,86097.4699999944
"9413",2019-01-30 07:24:09,-86097.47,-5.58793544769287e-09
"9414",2019-01-30 23:49:36,85309,85308.9999999944
"9415",2019-01-30 23:59:17,-85309,-5.58793544769287e-09
"9416",2019-02-01 07:59:17,72679.63,72679.6299999944
"9417",2019-02-01 08:15:22,-72679.63,-5.58793544769287e-09
"9418",2019-02-02 02:19:49,91784.74,91784.7399999944
"9419",2019-02-02 02:28:55,-91784.74,-5.58793544769287e-09
"9420",2019-02-02 12:18:48,93648.13,93648.1299999944
"9421",2019-02-02 12:25:49,-93648.13,-5.58793544769287e-09
"9422",2019-02-02 17:01:06,87983.34,87983.3399999944
"9423",2019-02-02 17:07:29,-87983.34,-5.58793544769287e-09
"9424",2019-02-03 00:25:23,120485.82,120485.819999994
"9425",2019-02-03 00:42:40,-120485.82,-5.58793544769287e-09
"9426",2019-02-03 22:42:13,80454.13,80454.1299999944
"9427",2019-02-03 23:02:43,-80454.13,-5.58793544769287e-09
"9428",2019-02-06 15:46:38,98240.85,98240.8499999944
"9429",2019-02-06 16:03:14,-98240.85,-5.58793544769287e-09
"9430",2019-02-08 09:27:24,129472.38,129472.379999994
"9431",2019-02-08 09:33:58,-129472.38,-5.58793544769287e-09
"9432",2019-02-08 17:15:58,139064.72,139064.719999994
"9433",2019-02-08 17:24:44,-139064.72,-5.58793544769287e-09
"9434",2019-02-09 14:27:12,102941.85,102941.849999994
"9435",2019-02-09 14:53:40,-102941.85,-5.58793544769287e-09
"9436",2019-02-09 17:56:53,57784.05,57784.0499999944
"9437",2019-02-09 18:00:30,-57784.05,-5.58793544769287e-09
"9438",2019-02-09 22:29:41,100789.34,100789.339999994
"9439",2019-02-09 22:55:14,-100789.34,-5.58793544769287e-09
"9440",2019-02-10 17:37:19,95913.27,95913.2699999944
"9441",2019-02-10 17:40:43,-95913.27,-5.58793544769287e-09
"9442",2019-02-12 10:10:22,83650.05,83650.0499999944
"9443",2019-02-12 10:29:14,-83650.05,-5.58793544769287e-09
"9444",2019-02-25 20:21:53,785.33,785.329999994412
"9445",2019-02-25 20:31:54,-785.33,-5.58793544769287e-09
"9446",2019-03-01 09:33:33,177785.39,177785.389999994
"9447",2019-03-01 09:39:35,-177785.39,-5.58793544769287e-09
"9448",2019-03-01 09:51:21,126071.79,126071.789999994
"9449",2019-03-01 10:17:06,-126071.79,-5.58793544769287e-09
"9450",2019-03-01 11:04:23,127219.68,127219.679999994
"9451",2019-03-01 11:12:34,-127219.68,-5.58793544769287e-09
"9452",2019-03-01 12:56:04,173578.32,173578.319999994
"9453",2019-03-01 13:14:22,-173578.32,-5.58793544769287e-09
"9454",2019-03-01 13:53:56,84074.49,84074.4899999944
"9455",2019-03-01 14:03:33,-84074.49,-5.58793544769287e-09
"9456",2019-03-01 18:26:01,103111.79,103111.789999994
"9457",2019-03-01 18:34:26,-103111.79,-5.58793544769287e-09
"9458",2019-03-01 18:48:01,85729.38,85729.3799999944
"9459",2019-03-01 19:11:02,-85729.38,-5.58793544769287e-09
"9460",2019-03-04 23:13:34,83683.14,83683.1399999944
"9461",2019-03-04 23:39:23,-83683.14,-5.58793544769287e-09
"9462",2019-03-05 08:49:59,173163.25,173163.249999994
"9463",2019-03-05 08:55:22,-173163.25,-5.58793544769287e-09
"9464",2019-03-05 09:21:59,136204.25,136204.249999994
"9465",2019-03-05 09:48:25,-136204.25,-5.58793544769287e-09
"9466",2019-03-05 10:14:24,129676.9,129676.899999994
"9467",2019-03-05 10:22:44,-129676.9,-5.58793544769287e-09
"9468",2019-03-05 13:41:59,190477.76,190477.759999994
"9469",2019-03-05 14:19:36,163356.62,353834.379999994
"9470",2019-03-05 14:19:36,-190477.76,163356.619999994
"9471",2019-03-05 14:33:36,-163356.62,-5.58793544769287e-09
"9472",2019-03-05 15:42:04,115635.37,115635.369999994
"9473",2019-03-05 15:45:43,-115635.37,-5.58793544769287e-09
"9474",2019-03-05 17:41:57,113430.11,113430.109999994
"9475",2019-03-05 17:52:57,-113430.11,-5.58793544769287e-09
"9476",2019-03-14 19:02:28,29265.24,29265.2399999944
"9477",2019-03-14 19:23:29,-29265.24,-5.58793544769287e-09
"9478",2019-04-19 01:23:37,21172.12,21172.1199999944
"9479",2019-04-19 03:09:54,-21172.12,-5.58793544769287e-09
"9480",2019-05-10 22:16:42,30000,29999.9999999944
"9481",2019-05-10 22:33:54,-30000,-5.58793544769287e-09
"9482",2019-05-12 16:35:45,77773,77772.9999999944
"9483",2019-05-12 17:06:56,-77773,-5.58793544769287e-09
"9484",2019-06-07 23:18:50,1136.384,1136.38399999441
"9485",2019-06-07 23:25:10,-1136.384,-5.58793544769287e-09
